eduardo	eduardo
banovina	banovina
odred	squad
učesnik	attendee
učesnik	participant
keith	keith
vera	vera
saznao	learned
najduži	longest
kir	kir
mostova	bridges
vijekovima	centuries
ecb	ecb
dobiva	gets
owen	owen
harris	harris
andrija	andrija
vuka	wolf
ukinuta	lifted
objave	posts
privatna	private
obilježje	landmark
molim	please
zonu	zone
latvija	latvia
podjeli	partition
spreman	ready
formirajući	forming
venecuela	venezuela
kanalu	channel
čvrste	solid
intel	intel
seattle	seattle
sven	sven
transformacije	transformation
transformacije	transformations
zaključio	concluded
ullevaal	ullevaal
arsen	arsenic
bernabéu	bernabéu
aviv	aviv
arapsko	arab
arapsko	arabian
ocinsoutput	ocinsoutput
habsburg	hapsburg
habsburg	habsburg
sportista	athlete
sportista	athletes
sportista	sportsman
festivalima	festivals
leopard	leopard
kriva	guilty
joan	joan
heinz	heinz
kurs	course
luigi	luigi
dale	dale
repa	beet
priznata	recognised
matthew	matthew
ideologije	ideology
ideologije	ideologies
robinson	robinson
regionalni	regional
vino	wine
cos	cos
prosječnom	average
izložbe	exhibitions
izložbe	exhibition
učio	studied
učio	taught
kamera	camera
zlo	evil
skulptura	sculpture
skulptura	sculptures
nizvodno	downstream
australijski	australian
sead	sead
matrica	matrix
zaprešić	zaprešić
hor	choir
hor	chorus
tradicionalna	traditional
posjeta	visit
posjeta	visits
ćelijskog	cellular
planiranje	planning
atmosfera	atmosphere
naslijediti	succeed
naslijediti	inherit
gruzija	georgia
britansko	british
pjevanje	singing
koledž	college
manifestacija	event
gljiva	mushroom
vrhova	peaks
hampden	hampden
barnard	barnard
stvarnost	reality
istine	truths
crijevo	intestine
aes	aes
očigledno	obvious
očigledno	apparently
očigledno	obviously
nacističke	nazi
ugljevik	ugljevik
trek	trek
odbrambene	defensive
gospođa	mrs
pouzdano	reliable
žirafa	giraffe
pravnih	legal
rossi	rossi
bolivija	bolivia
update	update
lazio	lazio
jačine	magnitude
suma	sum
ogleda	reflected
pozitivan	positive
gram	gram
philippe	philippe
bjelorusija	belarus
vijetnam	vietnam
osigurati	ensure
osigurati	secure
pacijent	patient
vidljiva	visible
mina	mina
mina	mines
utvrđenja	forts
prijelaz	crossing
edgar	edgar
ronald	ronald
najavio	announced
spor	slow
spor	dispute
wolfsburg	wolfsburg
samobor	samobor
partner	partner
četvrtog	fourth
castro	castro
partneri	partners
stat	stat
faraona	pharaohs
modifikacije	modifications
komandu	command
ves	wes
ves	ves
stazama	trails
abraham	abraham
temelja	foundations
refleks	reflex
justin	justin
seine	seine
katolički	catholic
rowclass	rowclass
intertoto	intertoto
ekrana	screen
istražuje	investigates
istražuje	explores
kompletan	complete
radije	rather
eddie	eddie
amx	amx
jugoslavenska	yugoslav
preporod	rebirth
preporod	revival
nadbiskup	archbishop
astana	astana
desni	gums
gramatika	grammar
posmatranja	observations
šri	sri
muškarac	man
cezara	caesars
variraju	vary
tipično	typical
krugova	circles
gospodin	gentleman
cis	cis
jules	jules
katolici	catholics
katolici	catholic
postupka	proceedings
uništavanje	destroying
uništavanje	destruction
aristotel	aristotle
pazar	pazar
dominantna	dominant
vjerovali	believed
preostale	remaining
podignut	raised
deacon	deacon
bod	bod
komad	piece
pomogla	helped
tottenham	tottenham
nestao	gone
nestao	missing
nestao	disappeared
mita	bribe
mita	bribes
mita	graft
edmund	edmund
bryan	bryan
brazilski	brazilian
sudbine	fates
formacije	formations
napoleona	napoleon
magazine	magazines
procesor	processor
pearl	pearl
hanibal	hannibal
unuka	granddaughter
obećao	promised
čovječanstva	mankind
zabranjen	restricted
leonard	leonard
düsseldorf	düsseldorf
hrabrost	courage
prenos	transmission
bojan	bojan
craig	craig
nizak	low
nominaciju	nomination
žice	wires
spajanje	merger
spajanje	merge
spajanje	merging
moždine	cord
dominiraju	dominate
dominiraju	dominated
krov	roof
église	église
aus	aus
sedamdesetih	seventies
dalo	granted
omotač	mantle
oblaka	clouds
rekonstrukcija	reconstruction
bint	bint
suha	dry
automat	automaton
klinika	clinic
cook	cook
vukovar	vukovar
zadržala	kept
zadržala	retained
torres	torres
dxc	dxc
mužjak	male
neriješenih	unsolved
vrs	vrs
slaba	weak
sateliti	satellites
sateliti	satellite
duet	duet
jama	pit
jama	jama
izgrađeno	built
nikolaj	nikolai
sumnja	doubt
sumnja	doubts
sumnja	suspected
kanjon	canyon
lične	personal
isus	jesus
dunav	danube
utvrditi	identify
utvrditi	determine
phil	phil
snimke	videos
hlor	chlorine
opsada	siege
wild	wild
mrtav	dead
aparata	appliances
aparata	apparatus
#ff	#ff
dijalog	dialogue
edu	edu
efikasnost	efficiency
predak	ancestor
susan	susan
sjednici	session
sveto	holy
higgins	higgins
gradaščević	gradaščević
lokomotiv	lokomotiv
usne	lips
osa	wasp
adnan	adnan
radeći	working
sektora	sectors
boleyn	boleyn
limfni	lymphatic
pozitivna	positive
preostali	remaining
izračunati	compute
pozvan	invited
leverkusen	leverkusen
plate	salary
plate	pay
plate	payroll
plate	salaries
kontinentalna	continental
definisan	defined
monk	monk
apolon	apollo
mišićima	muscles
ambasador	ambassador
billboard	billboard
paula	paula
povezivanje	networking
povezivanje	connect
vijenac	wreath
gilbert	gilbert
izjava	statement
ishrani	dietary
hrvoje	hrvoje
adrese	addresses
len	len
jedinstveni	unique
raspolaganju	available
yesno	yesno
dream	dream
zlatan	zlatan
završiti	finish
wien	wien
plazme	plasma
obnove	renewal
opena	oppen
ograničene	limited
centrima	centres
vjenčanje	wedding
float	float
cleveland	cleveland
poštovanje	respect
nepoznati	unknown
ranjen	wounded
imperije	empires
osnivači	founders
otpornost	resilience
call	call
dnevni	daily
odabrao	chose
odabrao	choose
derviš	dervish
računari	computers
zaustaviti	stop
gladi	starving
gladi	starvation
brejk	break
mađari	hungarians
nevada	nevada
panorama	panorama
tempel	tempel
getargs	getargs
leon	leon
enzime	enzymes
strateški	strategically
strateški	strategic
medina	medina
emituje	transmitting
emituje	emits
amino	amino
doktorsku	doctoral
murphy	murphy
liu	liu
biljni	herbal
helikopter	helicopter
aparat	apparatus
cska	cska
ropstva	slavery
provela	implemented
prašine	dust
molekuli	molecules
stvoren	created
filipini	philippines
atena	athena
arheološko	archaeological
lišće	leaves
zant	zant
janez	janez
čitluk	čitluk
omar	omar
negativni	negative
matt	matt
kampanju	campaign
trinaest	thirteen
baker	baker
neobično	unusually
neobično	unusual
punu	full
korita	riverbed
simone	simone
dance	danes
zeta	zeta
della	della
alen	allen
alen	alen
baby	baby
migracije	migration
klasifikacije	classifications
rečenice	sentences
izdana	issued
rog	rog
rog	horn
dodijeljen	assigned
prekinuo	interrupted
kanali	channels
sklonište	shelter
smanjen	decreased
uređivanje	edit
tudor	tudor
robertson	robertson
odgovori	answers
plemić	nobleman
izvoz	exports
izvoz	export
organizuje	organizing
organizuje	organizes
prostore	spaces
murat	murad
murat	murat
gljive	fungus
motivi	motives
shvata	realizes
ekspedicije	expeditions
merlin	merlin
zatvoreni	imprisoned
udaraljke	percussion
knin	knin
hidroksid	hydroxide
gregor	gregor
sobu	room
templates	templates
sazviježđa	constellations
patrijarh	patriarch
nikl	nickel
ane	ane
leberecht	leberecht
tone	tonnes
tone	tons
teret	load
teret	burden
danilo	danilo
wikitable	wikitable
uspostavljanje	establish
uspostavljanje	establishing
ubrzanje	acceleration
ubrzanje	torque
parker	parker
vrat	neck
korisnički	user
amonijak	ammonia
konrad	konrad
konrad	conrad
provode	spend
ćelijskih	celiac
sočiju	sochi
zima	winter
relativnosti	relativity
barset	barset
olga	olga
blog	blog
migracija	migration
vezuje	binds
bobby	bobby
leeds	leeds
objašnjenja	explanations
predgrađu	suburb
izbjeglica	refugee
izbjeglica	refugees
stalne	permanent
atene	athens
pripremi	prepare
industrijska	industrial
gledajući	looking
pobjedio	won
tyler	tyler
suđenje	trial
klaus	klaus
radovan	radovan
voyager	voyager
morrison	morrison
lotus	lotus
zakonski	legally
okruzi	districts
takmičari	contestants
takmičari	competitors
molekulska	molecular
fosili	fossil
točak	wheel
kalaj	tin
kanadski	canadian
ontario	ontario
alice	alice
paket	package
andora	andorra
grp	grp
elvis	elvis
odlično	excellent
postojeći	existing
izgubljeni	lost
pažnja	attention
ponavlja	repeats
uzimanje	taking
env	env
oton	otho
pretvaranje	turn
pretvaranje	conversion
optužbe	charges
optužbe	accusations
pokazale	shown
transformacija	transform
transformacija	transformation
zatvara	closes
zatvara	closing
papir	paper
vještački	artificially
složeni	composite
urednika	editors
javor	maple
orbiti	orbit
valentin	valentin
valentin	valentine
izbačen	thrown
stabilna	stable
cxd	cxd
pasa	dogs
bazirana	based
disertaciju	dissertation
loza	vines
namjera	intention
namjera	intent
mohammed	mohammed
poslati	send
patuljak	dwarf
sutjeska	sutjeska
proza	prose
obilježen	marked
sol	sol
sušić	sušić
turistička	tourist
brodovima	ships
smatrajući	viewing
napisano	written
platforme	platform
manjine	minorities
crteža	plots
vještica	witch
neuspjeh	failure
podne	noon
podne	midday
bacio	threw
leipzig	leipzig
izraelski	israeli
gerhard	gerhard
rub	rub
kairo	cairo
sean	sean
slogan	slogan
digitalni	digital
lara	lara
protivnici	opponents
lisa	lisa
pumpe	pumps
uspješne	successful
jusuf	yusuf
jusuf	jusuf
postavši	becoming
oporavak	recover
oporavak	recovery
odabir	select
golf	golf
časti	honor
felipe	felipe
izložba	exhibit
izložba	exhibition
ubice	killers
ulicama	streets
digimon	digimon
trim	trim
rupa	hole
rupa	holes
toro	toro
vels	wales
vels	wells
pozitivni	positive
zenit	zenit
uni	uni
goveda	oxen
hogwarts	hogwarts
tumor	tumor
abba	abba
razmnožavanje	reproduction
kolona	motorcade
niger	niger
beli	beli
beli	whitey
janko	janko
aga	aga
kvadrata	squares
akt	nude
akt	act
rezolucija	resolution
pokrenut	initiated
pokrenut	launched
privlači	attracts
privlači	attracting
laugardalsvöllur	laugardalsvöllur
pljevlja	pljevlja
tvrdeći	arguing
tvrdeći	claiming
duhana	tobacco
fenotip	phenotype
vraćen	returned
prilikama	occasions
počev	starting
slabi	weak
pat	stalemate
pat	pat
malmö	malmö
sekundarna	secondary
pedeset	fifty
podvrsta	subspecies
terapije	therapies
bloka	bloc
setu	set
najniži	lowest
anderlecht	anderlecht
bremen	bremen
zidine	walls
jedu	eat
ćelijska	cellular
uživa	enjoys
uživa	enjoying
navijači	fans
navijači	supporters
potencijalno	potentially
proširena	expanded
proširena	augmented
graditi	build
ogledala	mirrors
drveće	trees
sanu	sanu
odmor	vacation
povezati	connect
čuvar	keeper
najduža	longest
antun	antun
genetičko	genetic
sobe	room
sobe	rooms
dodjele	awarding
broz	broz
ferhatović	ferhatović
spolni	sexual
kobilica	carina
slabost	weakness
brza	fast
čeka	waiting
čeka	awaits
scenariju	scenario
boys	boys
preuzimanje	downloading
preuzimanje	grabbing
preuzimanje	download
kimi	kimi
dvorište	courtyard
najjači	strongest
pretpostavka	assumption
pretpostavka	premise
benfica	benfica
zaključka	conclusion
sastojak	ingredient
solna	solna
uši	ears
strujanja	currents
spartak	spartacus
spartak	spartak
universal	universal
sestara	nurses
slavenska	slav
slavenska	slavic
donald	donald
apsolutni	absolute
ronnie	ronnie
bitaka	battles
dešavanja	events
dešavanja	developments
jugozapadnom	southwest
vojislav	vojislav
mačka	cat
skokova	jumps
neophodna	necessary
ravne	flat
luca	luca
colin	colin
izvođač	performer
vijećnica	hall
zadrži	keep
monroe	monroe
bara	bara
rama	rama
gudački	string
mirno	peacefully
građevinski	construction
diskovi	disks
aspekt	aspect
spušta	descends
addclass	addclass
čulo	sense
zvijeri	beast
zvijeri	beasts
odražava	reflecting
odražava	reflects
prođe	passes
moral	morale
moral	morals
moral	morality
boban	boban
dovoljan	enough
dovoljan	sufficient
antonije	antony
prefiks	prefix
česti	frequent
zvan	referred
namjeru	intention
ers	ers
prikupljanje	collect
maya	maya
odredbe	provisions
bis	bis
zločini	crimes
stalna	permanent
dlaka	hair
prijateljstvo	friendship
raja	raja
hansen	hansen
antropologija	anthropology
svečano	ceremony
svečano	solemn
napoli	napoli
koalicija	coalition
ricardo	ricardo
dobrovoljno	voluntarily
dobrovoljno	volunteer
rtb	rtb
markt	markt
povjerenje	confidence
povjerenje	trust
oblak	cloud
auf	auf
škoda	skoda
škoda	škoda
žica	wire
folk	folk
korisno	useful
mentalno	mental
mentalno	mentally
skala	scale
ruševine	ruins
donesena	taken
stevens	stevens
proglašenja	proclamation
proglašenja	declaring
patuljasta	dwarf
sličnost	resemblance
trgovac	trader
jennifer	jennifer
preuzimanja	takeover
jonas	jonas
mom	my
senad	senad
prunus	prunus
away	away
odbijeni	repelled
svjedok	witness
stiče	acquires
partnera	partner
troškovi	expenses
troškovi	costs
bosanci	bosnians
rpm	rpm
višak	surplus
višak	excess
nob	nob
prazan	empty
mayer	mayer
zabranjena	banned
intelektualaca	intellectuals
dimitrije	dmitry
ukidanje	abolishing
krive	blame
tačna	precise
tačna	true
mex}}	mex}}
zavise	depend
räikkönen	räikkönen
rick	rick
sive	grey
bilje	herbs
kopno	mainland
živote	lives
vojvodina	vojvodina
neophodan	necessary
okus	taste
konjanika	horsemen
orbitalni	orbital
darije	darius
ubila	murdered
ubila	killed
brine	worries
opremljena	equipped
bitan	important
prihvati	embrace
prihvati	accept
stafa	stafa
ruta	route
bilten	newsletter
nina	nina
nsdap	nsdap
mahala	mahala
sima	sima
invazija	invasion
gosti	guests
povukla	withdrew
smještaj	accommodations
malezija	malaysia
afričkih	african
kovanica	coins
droga	drugs
droga	drug
efikasno	efficient
efikasno	effective
efikasno	efficiently
istraživača	explorers
vrbas	vrbas
kontroli	control
testovi	tests
kontinent	continent
obnova	renewal
obnova	reconstruction
pristalica	supporter
pristalica	supporters
pristalica	booster
stoney	stoney
pregovori	negotiation
pregovori	talks
pregovori	negotiations
rizika	risks
dnf	dnf
tumačenje	interpretation
prijeti	threatening
plaća	salary
stranim	foreign
remek	masterpiece
kal	kal
kal	khal
platiti	pay
emma	emma
dobara	goods
dobara	goodies
ekologija	ecology
izbjeći	avoid
referendum	referendum
izazvala	caused
odjednom	suddenly
pašić	pašić
jin	jin
grofica	countess
made	made
muzičari	musicians
odredi	determine
vlasnici	owners
qemal	qemal
angažman	engagement
punom	full
klement	clement
oslanja	relies
mon	mon
metak	bullet
rupe	holes
hemijsku	pen
osiguranja	insurance
futsal	futsal
ivanov	ivanov
gana	ghana
express	express
sane	sane
pozicijama	positions
divlji	wild
polazi	leaves
skali	scully
litara	litres
bratstvo	fraternity
bratstvo	brotherhood
depresije	depressions
plamen	flame
sna	dream
bafta	bafta
jarac	capricorn
čudo	miracle
krk	krk
doyle	doyle
dobit	profit
jadrana	adriatic
rommel	rommel
rastvara	dissolving
simbolizira	symbolises
napadača	attackers
duboka	deep
weber	weber
ustavni	constitutional
thomson	thomson
režnja	lobes
zatvaranje	closure
zatvaranje	closing
zaštitnik	protector
étienne	étienne
profesionalna	professional
mjuzikl	musical
mačke	cats
campbell	campbell
azijski	asian
romeo	romeo
dometa	range
sirija	syria
egipatska	egyptian
pijeska	sand
wta	wta
ward	ward
arhipelag	archipelago
coli	coli
pozadina	background
razdvaja	separating
pogubljen	executed
razdvajanje	separation
razdvajanje	splitting
pečat	stamp
pečat	seal
programima	programmes
programima	programs
franco	franco
celtic	celtic
grešku	mistake
inspiracija	inspiration
odobrenje	approval
odobrenje	clearance
palata	palaces
palata	palace
koristan	useful
najraniji	earliest
primati	primates
fleming	fleming
izborni	elective
mol	mole
mol	mol
staklo	glass
povreda	injury
sisari	mammals
sisari	mammal
labin	labin
barthel	barthel
uređajima	devices
specifičan	distinct
posthumno	posthumous
posthumno	posthumously
automobili	cars
maksimir	maksimir
distribuciju	distribution
obilježena	marked
brennan	brennan
resursi	resources
davies	davies
zastupnik	representative
vezir	vizier
bonus	bonus
plaža	beach
lucy	lucy
fadil	fadil
lokacijama	locations
lokacijama	venues
anatomski	anatomically
specijalno	specially
specijalno	special
ateizam	atheism
drevne	ancient
parma	parma
rejting	rating
rejting	ratings
lipa	lipa
konji	horses
babić	babic
babić	babić
mhz	mhz
peći	ovens
peći	stove
peći	furnaces
phillips	phillips
lars	lars
donijeti	bring
peto	fifth
označeni	tagged
lazar	lazar
kupiti	buy
foto	photo
minimum	minimum
shu	shu
nadzor	surveillance
kora	bark
kora	crust
kora	cora
norma	norma
norma	norm
kuka	hook
hana	hannah
hana	hana
paralelne	parallel
uspona	ups
piero	piero
hitchcock	hitchcock
crkava	churches
tokio	tokyo
gibson	gibson
himne	anthem
kraća	shorter
zakletvu	sworn
kepler	kepler
primaju	receive
ole	ole
vjerovatnoća	probability
concat	concat
krilima	wings
lakši	easier
uništava	destroys
vozi	drive
rado	gladly
rado	rado
disney	disney
meti	targeted
tehnološki	technological
poglavlja	chapters
geobox	geobox
slo	slo
napulj	naples
napetosti	accumulation
bonaparte	bonaparte
ahmet	ahmet
prijem	admission
prijem	reception
rekli	said
gilles	gilles
blato	mud
stavi	put
pravna	legal
postanu	become
radoslav	radoslav
detektiv	detective
italia	italia
norme	norm
obnovljen	renewed
administrator	administrator
javier	javier
proizvoditi	produce
povod	occasion
društava	societies
bek	beck
bek	bek
aljehin	alekhine
depresija	depression
uzorka	sample
senna	senna
nih	nih
španci	spaniards
maksimum	maximum
mok	mok
dec	dec
pješak	pedestrian
pješak	pawn
hronološki	chronological
imajući	bearing
imajući	keeping
nou	nou
zubi	teeth
ted	ted
formirane	formed
opticaju	circulation
brad	brad
obroncima	slopes
tunela	tunnels
posmatra	observing
posmatra	watches
posmatra	watching
laurie	laurie
zabrana	ban
suárez	suárez
komunistička	communist
srb	srb
ukr	ukr
znamenitosti	landmarks
markus	markus
nezadovoljstvo	discontent
nezadovoljstvo	displeasure
nezadovoljstvo	dissatisfaction
talas	wave
sierra	sierra
bush	bush
upada	raid
pjevao	sang
slab	weak
hitovi	hits
alexis	alexis
almir	almir
banda	gang
krista	krista
jelo	dish
pilota	pilots
hiv	hiv
medrese	medrese
koplja	spears
koplja	javelin
bra	bra
lakers	lakers
pušenje	smoking
ilirska	illyrian
churchill	churchill
direktan	direct
betula	betula
siciliji	sicilia
mergedrow	mergedrow
okoliša	environmental
allahu	allahu
allahu	god
théâtre	théâtre
boli	hurts
sdp	sdp
otkrije	reveal
otkrije	discover
jakih	strengths
kum	godfather
operativnu	operative
papua	papua
kriterij	criterion
hamza	hamza
stepa	steppe
pijanist	pianist
misty	misty
iznose	amounts
administracija	administration
čarobnjak	wizard
suđenja	trials
tragovima	clues
tragovima	footsteps
upravljaju	governed
theodor	theodor
udp	udp
paz	paz
ikona	icon
glad	famine
glad	hunger
francuza	frenchman
parc	parc
planirana	planned
access	access
emitira	broadcasts
stalnih	persistent
stalnih	nonstop
proizlazi	arises
principi	principles
izgubi	loses
izgubi	lose
homer	homer
republikanska	republican
gan	gunn
bruto	gross
classic	classic
alel	allele
gandhi	gandhi
jednaki	equal
ljiljana	ljiljana
izdavanje	issuing
izdavanje	issuance
hubble	hubble
einstein	einstein
civilna	civil
civilna	civilian
teritorijalna	territorial
schalke	schalke
mine	mines
stabilan	stable
emily	emily
ferenc	ferenc
nosača	carrier
kuna	kuna
dođu	come
attr	attr
operacijama	operations
drina	drina
hepburn	hepburn
ribolov	fishing
naboj	charge
siva	gray
siva	grey
kane	kane
šupljina	cavity
pokrivaju	cover
osmi	eighth
hamlet	hamlet
bekr	bakr
wimbledon	wimbledon
udata	married
skladištenje	storage
idejama	ideas
obnovio	renewed
ponuda	offer
ekspedicija	expedition
rumunski	romanian
dugogodišnji	longtime
dugogodišnji	longstanding
tvorac	creator
puteve	pathways
studijama	studies
upravnik	warden
budizam	buddhism
čovječnosti	humanity
potpuna	complete
kasiopeja	cassiopeia
logos	logos
princeton	princeton
izdavačke	publishing
arheološka	archaeological
levi	levi
mečeva	matches
brz	fast
javi	javi
leslie	leslie
uzorak	sample
melbourne	melbourne
vjerskim	religious
govornika	speakers
odabran	selected
srijemska	srijem
uporište	foothold
izvrši	execute
izloženi	exposed
basic	basic
prijelaza	crossings
wallis	wallis
držala	held
ograničeni	confined
gómez	gómez
kornjača	turtle
čeljusti	claws
jabuke	apples
jedinstveno	uniquely
jedinstveno	unique
uzimajući	taking
tajno	secretly
ravnoteža	equilibrium
jutro	morning
ostvaruju	pursue
roosevelt	roosevelt
arg	arg
pokrenuta	launched
deutsche	deutsche
auguste	auguste
roberts	roberts
vista	vista
lociran	located
kontinentalno	inland
jednakost	equality
advokat	attorney
advokat	lawyer
shell	shell
mehanika	mechanics
fer	fer
fer	fair
prolaza	aisle
ltd	ltd
gradonačelnika	mayoral
carlsen	carlsen
naizgled	seemingly
nazvane	named
svjestan	aware
objavljivanje	publication
virovitica	virovitica
sony	sony
avanture	adventures
bros	brooch
bros	bros
organska	organic
trend	trend
bogovima	gods
pažljivo	carefully
uništenja	destruction
ramos	ramos
baka	baka
baka	grandma
josy	josy
vjerska	religious
utvrđenje	fort
zagradi	brackets
dominantni	dominant
logika	logic
wesley	wesley
proizvedena	manufactured
ubijena	murdered
ubijena	killed
vene	veins
rastao	grew
moldavija	moldova
ogromna	enormous
relacija	equivalence
gota	gota
misle	think
olympique	olympique
motivima	motifs
vlažnost	humidity
šalju	send
alge	algae
hebrejski	hebrew
rect	rect
augustin	augustin
pivo	beer
enciklopedije	encyclopaedia
granate	shells
šerif	sheriff
smallville	smallville
ograničenje	limit
boško	bosko
kukuruz	maize
iupac	iupac
turner	turner
psihologija	psychology
geometrija	geometry
pravno	legally
alfons	alfonso
kut	kut
libija	libya
klarinet	clarinet
pagename	pagename
prebačen	transferred
zadatke	assignments
ostavi	leave
einar	einar
nog	nog
pazin	pazin
srđan	srdjan
vuković	vukovic
sistematski	systematically
jamie	jamie
izložena	exposed
specifičnosti	characteristics
nafta	petroleum
nafta	nafta
željeznički	rail
željeznički	railway
luz	luz
orbitala	hybridisation
šesnaest	sixteen
stanković	stankovic
sarađivao	cooperated
sarađivao	cooperate
bomba	bomb
lloyd	lloyd
stop	stop
kuba	cuba
elektronska	electronic
hrv	hrv
dole	down
dole	downstairs
instrumente	instruments
navare	viana
zapošljava	employs
poručnik	lieutenant
iure	jure
zaustavlja	stop
nestala	missing
odsustvo	absence
tragova	footprints
slobodi	loose
okružena	surrounded
spomenut	mentioned
ponedjeljak	monday
arhitektonski	architectural
izet	izet
zvonimir	zvonimir
px}}	px}}
ofanziva	offensive
geometrijski	geometric
postotak	percentage
panama	panama
spriječi	prevent
datumi	dates
interese	interests
tajvan	taiwan
panzer	panzer
organskim	organics
izložen	exposed
kenneth	kenneth
izdavača	publishers
carska	imperial
tame	darkness
tame	tame
počast	honour
počast	tribute
ozbiljne	serious
vice	vice
franaka	francs
nuklearni	nuclear
prisiljeni	forced
hronika	chronicles
hronika	chronicle
prezentacija	presentation
metan	methane
dubai	dubai
friends	friends
kancelar	chancellor
britannica	britannica
born	born
poplave	flooding
ukrajinci	ukrainians
vezivanje	tying
demokratija	democracy
vivo	vivo
schmidt	schmidt
reforma	reform
usmjeren	directed
profesionalne	professional
andersson	andersson
doors	doors
znajući	knowing
talasi	waves
jože	jože
pobunjenika	rebels
pobunjenika	rebel
hronologija	timeline
lane	lane
nowrap	nowrap
sljedbenici	followers
zalihe	supplies
baterije	batteries
delfin	dolphin
crtež	sketch
crtež	drawing
grah	bean
grah	beans
plata	plata
darwin	darwin
oklopnih	armoured
inteligencija	intelligence
hassan	hassan
memorija	memory
dizel	diesel
izgubiti	lose
strategije	strategies
koalicije	coalitions
noviji	newer
trave	grass
sirius	sirius
karbonat	carbonate
unix	unix
romi	roma
ključanja	boiling
planova	scheming
planova	plans
dem	dem
laboratorija	labs
laboratorija	laboratory
laboratorija	lab
doza	doses
doza	dose
robovi	slaves
din	din
din	dean
svuda	everywhere
predaja	sayings
predaja	surrender
obnovu	renewal
obnovu	restoration
obnovu	rehabilitation
ključa	keys
senegal	senegal
receptore	receptors
chase	chase
predviđa	predicts
nadh	nadh
sergei	sergei
otrov	venom
otrov	poison
sutra	tomorrow
pogodan	fitting
pogodan	suitable
konzul	consul
autorska	copyright
diane	diane
zahtjevi	requests
zahtjevi	requirements
zahtjevi	demands
mostovi	bridges
opremljen	equipped
povuče	withdraw
bon	bon
počeci	beginnings
nasilje	violence
povećane	increased
nekako	kind
nekako	somehow
tooltip	tooltip
poljaci	poles
tehnička	technical
beskonačno	infinite
beskonačno	endlessly
ljubomir	ljubomir
everton	everton
adp	adp
wells	wells
fran	fran
dalmacija	dalmatia
legio	legio
fragmenti	fragments
završenog	completing
kate	kate
abo	abo
procjenu	assessment
mirsad	mirsad
move	move
baterija	battery
socijalno	socially
blogs	blogs
kuvajt	kuwait
puk	regiment
spontano	spontaneous
spontano	spontaneously
uništi	destroy
sveukupno	overall
promocija	promotion
ispunjava	fills
mil	mil
gvatemala	guatemala
individualne	individual
sfere	spheres
oštećenje	damage
palo	palo
stanislav	stanislav
uspješnu	successful
arterije	arteries
afrička	african
slavni	famous
samir	samir
rum	rum
moderno	fashionable
antigeni	antigens
baražu	barrage
marx	marx
oktavijan	octavian
deklaracija	declaration
alpsko	alpine
honduras	honduras
vole	vole
eriksson	eriksson
spasi	save
fan	fan
glagola	verbs
ppm	ppm
ein	ein
muller	muller
hrom	chrome
hrom	chromium
violine	violins
caroline	caroline
svile	silk
izbornom	electoral
drive	drive
barij	barium
direktni	direct
instalacija	installation
instalacija	install
primirje	truce
poteškoće	woes
poteškoće	difficulties
stojanović	stojanovic
služiti	serve
uran	uranus
dell	dell
adis	addis
adis	adis
vođen	guided
mrtvi	dead
reaktora	reactors
krleža	krleža
stepenu	degree
šok	shocking
šok	shock
dijalekt	dialect
čudovišta	monsters
julian	julian
novaković	novakovic
koper	koper
meša	mesa
take	take
abdullah	abdullah
cvjeta	flourish
oksidacije	oxidation
neill	neill
slavio	celebrating
veli	veli
utisak	impression
infrastruktura	infrastructure
serravalle	serravalle
vukčić	vukčić
helij	helium
građanin	citizen
niš	niš
čitava	whole
dodajte	add
rft	rft
sizedefault	sizedefault
camille	camille
giorgio	giorgio
mašinski	mechanical
pčela	bee
cole	cole
siemens	siemens
aspx	aspx
zagorje	zagorje
izmir	izmir
parkovi	parks
kolonijalne	colonial
vilnius	vilnius
selby	selby
formata	format
angelo	angelo
neslaganja	disagreements
imuni	immune
neda	ned
neda	neda
lorenzo	lorenzo
trovanja	poisoning
izumio	invented
sihr	sorcery
sihr	magic
postizanje	achieving
plivanju	swimming
masi	crowd
razvijao	developing
razvijao	developed
biblije	bibles
inicijativa	initiative
urbana	urban
žiri	jury
ragbi	rugby
havaji	hawaii
federalni	federal
prepreka	obstacles
prepreka	obstacle
prepreka	hurdle
preglednik	browser
baptiste	baptiste
sinj	sinj
lancaster	lancaster
birmingham	birmingham
xvii	xvii
mogućnostima	possibilities
proton	proton
commons	commons
protoka	flow
gradec	gradec
takmičar	contestant
takmičar	contender
takmičar	competitor
detalje	details
soko	falcon
soko	hawk
vega	vega
hunter	hunter
louvre	louvre
vlasništva	ownership
ujedinjena	united
erectus	erectus
srednjim	medium
bacač	pitcher
nordijska	norse
nordijska	nordic
fokus	focus
ratko	ratko
sapna	sapna
emisiju	show
kasparov	kasparov
wide	wide
prost	prost
mama	mama
mama	mommy
mama	mom
