tunesien	tunisie
habs	tricolore
diagnose	diagnostic
verstärkung	renfort
verstärkung	renforts
npov	npov
justin	justin
räumlichkeiten	locaux
ingo	ingo
rebellen	rebelles
saur	saur
konzil	concile
tochtergesellschaft	filiale
maurer	maçon
extreme	extreme
ostern	pâques
saga	saga
ravensburg	ravensburg
frist	délai
schienen	rails
terminal	terminal
spring	spring
fähig	capable
trend	tendance
währung	devise
umgestaltung	retouche
telefon	téléphone
ligen	ligues
feinde	ennemis
fiat	fiat
fragmente	fragments
opus	opus
command	command
hong	hong
kostet	coûte
adressen	adresses
nevada	nevada
niedrig	bas
rogers	rogers
kapellen	chapelles
konstant	constante
tee	thé
probe	échantillon
merkel	merkel
kontroverse	controverse
angehört	écouté
storm	storm
gymnasien	lycées
landsberg	landsberg
npd	npd
klarinette	clarinette
stolberg	stolberg
kapitulation	reddition
kapitulation	capitulation
rhythmus	rythme
wilhelmshaven	wilhelmshaven
monatlich	mensuel
johns	johns
liu	liu
stabilität	stabilité
bewiesen	prouvé
giorgio	giorgio
clarke	clarke
göteborg	göteborg
doc	doc
erzherzog	archiduc
lizenzen	licences
peace	peace
organischen	organiques
kult	culte
synonyme	synonymes
cat	cat
stevens	stevens
aaron	aaron
desc	desc
staatsanwalt	procureur
bangkok	bangkok
kempten	kempten
leibniz	leibniz
variablen	variables
sub	sub
iata	iata
resonanz	résonance
swiss	swiss
tales	tales
angestellter	employé
mass	mass
armenien	arménie
murphy	murphy
rick	rick
elo	elo
überrascht	surpris
zhang	zhang
vers	verset
verlagsgesellschaft	verlagsgesellschaft
catholic	catholic
rob	rob
full	full
stalin	staline
habsburg	habsburg
selbstmord	suicide
flur	couloir
proteste	protestations
braut	mariée
buffalo	buffalo
verhaftung	arrestation
poesie	poésie
vorläufig	provisoire
pilz	champignon
gottlob	gottlob
jesuiten	jésuites
demnächst	prochainement
geradezu	carrément
linde	linde
vorort	banlieue
ankara	ankara
discovery	discovery
sektor	secteur
ted	ted
isoliert	isolé
wilhelmine	wilhelmine
seid	soyez
platzieren	placer
chan	chan
ignorieren	ignorer
anno	anno
iron	iron
lane	lane
raupen	chenilles
rückgang	déclin
kürzlich	récemment
delhi	delhi
zusammengestellt	compilé
beleuchtung	éclairage
beleuchtung	eclairage
zivilisten	civils
getauft	baptisé
delle	delle
solothurn	soleure
garantiert	garanti
gelsenkirchen	gelsenkirchen
germain	germain
henrik	henrik
aktiviert	activé
spontan	spontané
spontan	spontanée
spezial	spécial
heavy	heavy
key	key
abständen	intervalles
scheidung	divorce
einschränkung	restriction
einschränkung	limitation
psychotherapie	psychothérapie
afrikanische	africaine
reclam	reclam
rauch	fumée
taxon	taxon
portale	portails
treue	fidélité
bird	bird
boxen	boxe
playstation	playstation
trocken	sèche
lena	lena
rex	rex
rückstand	résidu
word	word
springs	springs
woanders	ailleurs
alma	alma
identifizieren	identifier
complete	complete
nagel	clou
nagel	ongle
grundsätze	principes
joão	joão
mandate	mandats
semester	semestre
geführte	guidé
geführte	guidée
stollen	crampons
move	move
xxx	xxx
marne	marne
ökonom	économiste
fliegt	vole
lópez	lópez
ausgeliehen	emprunté
teuer	cher
ballett	ballet
vorfall	incident
fernández	fernández
triumph	triumph
mongolei	mongolie
fließen	couler
vilnius	vilnius
turn	turn
rodríguez	rodríguez
chirurgie	chirurgie
weißrussland	biélorussie
challenger	challenger
then	then
werkstätten	garagistes
freedom	freedom
solingen	solingen
paradies	paradis
they	they
nest	nid
kaplan	kaplan
streiten	disputer
frucht	fruit
petersen	petersen
gunther	gunther
luftfahrt	aéronautique
common	common
förderer	commanditaire
ricardo	ricardo
schnittstelle	interface
feststellung	constatation
feststellung	constat
wismar	wismar
christa	christa
gelblich	jaunâtre
isle	isle
stecken	coincé
hubschrauber	hélicoptères
verzeichnen	énumèrent
verzicht	renonciation
verzicht	déni
laz	laz
kopien	copies
schrittweise	progressif
schrittweise	progressive
lächerlich	ridicule
cultural	cultural
steinbach	steinbach
gültigkeit	validité
gefährlich	dangereux
integrieren	intégrer
garnison	garnison
fortuna	fortuna
wandern	randonnée
hmm	hmm
investitionen	investissements
meyers	meyers
baumann	baumann
panama	panama
gläubigen	croyants
bestrebungen	aspirations
hypothese	hypothèse
fink	fink
frédéric	frédéric
eugène	eugène
arndt	arndt
bibliothekar	bibliothécaire
spirit	spirit
symphony	symphony
aufständischen	insurgés
vienna	vienna
bein	jambe
carsten	carsten
usb	usb
verfügten	disposaient
erklärungen	explications
oberbayern	oberbayern
raimund	raimund
verbreiten	propager
verbreiten	diffuser
has	has
frey	frey
pyramide	pyramide
seitlichen	latéraux
seitlichen	latéral
detmold	detmold
mäßig	modérée
nebraska	nebraska
anpassen	personnaliser
steuermann	timonier
yang	yang
diskriminierung	discrimination
merseburg	merseburg
welten	mondes
advanced	advanced
aviv	aviv
ing	ing
mütter	mères
hildegard	hildegard
reutlingen	reutlingen
graubünden	grisons
leslie	leslie
kasten	encadré
piraten	pirates
abgestimmt	voté
abgestimmt	votés
käse	fromage
käme	viendrait
kontrollieren	contrôler
lotus	lotus
ziegler	ziegler
cohen	cohen
ausschluss	exclusion
kameras	caméras
wikis	wikis
gärtner	jardinier
karibik	caraïbes
again	again
kuppel	dôme
individuell	individuel
gloria	gloria
orléans	orléans
kiss	kiss
sean	sean
achte	huitième
dreizehn	treize
luke	luke
platziert	placé
platziert	placés
granit	granit
phillips	phillips
reife	maturité
kunstverlag	kunstverlag
böhm	böhm
mallorca	majorque
dankbar	reconnaissants
dankbar	reconnaissant
triathlon	triathlon
warnung	avertissement
parlamentarischen	parlementaire
formalen	formel
verlagsanstalt	verlagsanstalt
neumarkt	neumarkt
bert	bert
überwinden	surmonter
diesel	diesel
ingeborg	ingeborg
biography	biography
intro	intro
made	made
legal	légal
unglück	malheur
schuldig	coupable
verteidigt	défendu
verteidigt	défend
variationen	variations
kohl	chou
kohl	choux
curt	curt
grammy	grammy
hughes	hughes
herford	herford
claudius	claudius
verschwörung	conspiration
rechtfertigt	justifie
bettina	bettina
zar	tsar
kennzeichnung	marquage
füße	pieds
inge	inge
schmal	étroit
rica	rica
alphabet	alphabet
baustelle	chantier
eugene	eugene
geschieden	divorcé
jutta	jutta
harvey	harvey
kompetenzen	compétences
autorität	autorité
apotheker	pharmacien
banner	bannières
banner	bannière
nerven	nerfs
anonym	anonyme
siena	sienne
maya	maya
zoologe	zoologiste
wiederholung	répétition
beschwerden	plaintes
gleichgewicht	équilibre
ehrendoktorwürde	honorifiques
vermarktet	commercialisé
bourbon	bourbon
gebrochen	brisé
karsten	karsten
fahrrad	vélo
komponente	composant
terra	terra
küsten	côtes
tänzer	danseur
ireland	ireland
andrei	andrei
manuell	manuelle
möller	möller
verb	verbe
rheinische	rheinische
mathematical	mathematical
ana	ana
gleiches	allumette
bomber	bombardiers
bertelsmann	bertelsmann
trilogie	trilogie
polizeiruf	polizeiruf
gemüse	légumes
balkan	balkans
befestigung	fixation
metzler	metzler
botanischen	botanique
kurier	messager
optimal	optimal
ästhetik	esthétique
strategische	stratégique
nintendo	nintendo
grafiken	graphiques
montenegro	monténégro
bernstein	ambre
bunker	bunker
she	she
wings	wings
giacomo	giacomo
astronomische	astronomique
hertha	hertha
adenauer	adenauer
auvergne	auvergne
odenwald	odenwald
versprechen	promesse
lenz	lenz
vernichtung	destruction
jensen	jensen
richmond	richmond
myspace	myspace
palace	palace
demonstration	démonstration
kamerun	cameroun
hunt	hunt
choice	choice
träume	rêves
gest	gest
rassismus	racisme
itf	itf
through	through
hobby	hobby
abel	abel
sara	sara
weinheim	weinheim
beatles	beatles
bomben	bombes
marquis	marquis
alexei	alexei
erobern	conquérir
ökologie	écologie
sánchez	sánchez
europäer	européens
esslingen	esslingen
schwimmer	nageur
ottawa	ottawa
jahrzehnt	décennie
ceo	pdg
faschismus	fascisme
kuhn	kuhn
owen	owen
roosevelt	roosevelt
nebenflüsse	affluents
clan	clan
reims	reims
fängt	attrape
blei	plomb
geologische	géologique
geologische	géologiques
wasserburg	wasserburg
sprachliche	linguistique
relative	relatif
relative	relative
franchise	franchise
walk	walk
panik	panique
angelika	angelika
cameron	cameron
schmetterling	papillon
jupiter	jupiter
verona	vérone
kastilien	castille
verursachen	causer
emmanuel	emmanuel
lachen	rire
claire	claire
genus	genus
rätsel	énigmes
rätsel	devinette
leeren	vider
hardcore	hardcore
nicola	nicola
diener	serviteurs
diener	valet
daily	daily
charakterisiert	caractérisée
charakterisiert	caractérisé
friends	friends
pflichten	obligations
salt	salt
maritime	maritime
katzen	chats
gestört	dérangé
basic	basic
versicherung	assurance
patricia	patricia
vollständigkeit	exhaustivité
heritage	heritage
zweifelhaft	douteux
neigung	penchant
neigung	inclinaison
fabian	fabian
orlando	orlando
una	una
versorgen	alimenter
versorgen	approvisionner
ausgeübt	exercé
ausgeübt	exercée
quo	quo
madagaskar	madagascar
kanäle	canaux
krim	crimée
einseitig	unilatéral
einseitig	unilatérale
impulse	impulsions
sullivan	sullivan
anweisung	instruction
anmeldung	inscription
köpfe	têtes
berührt	touché
pat	pat
massen	masses
siebte	septième
verleiht	confère
bang	bang
horizontal	horizontal
horizontal	horizontale
stabil	stable
kreuzberg	kreuzberg
heiner	heiner
ahmad	ahmad
geschenk	cadeau
optik	optique
dreißig	trente
verurteilung	condamnation
unterschrift	signature
tragödie	tragédie
missionar	missionnaire
niger	niger
laser	laser
fbi	fbi
ausüben	exercer
obst	fruits
maske	masque
padua	padoue
drachen	dragons
aha	aha
geschmückt	parée
got	got
elberfeld	elberfeld
zeugnis	témoignage
gewebe	tissus
moin	moin
maxim	maxim
hendrik	hendrik
jet	jet
unerwünscht	indésirable
mare	mare
arg	arg
kenia	kenya
legenden	légendes
verbrannt	brûlé
lanka	lanka
mendelssohn	mendelssohn
zweibrücken	zweibrücken
robertson	robertson
pedal	pédale
wiley	wiley
css	css
schaffhausen	schaffhouse
navigation	navigation
komponistin	compositrice
flughäfen	aéroports
eingabe	saisie
drucker	imprimantes
apotheke	pharmacie
uniform	uniforme
animation	animation
verwandelt	transforme
verwandelt	transformé
sic	sic
won	won
pérez	pérez
kommentiert	commente
daimler	daimler
wirtschaftswissenschaftler	économiste
pascha	pacha
klingen	lames
sweet	sweet
rap	rap
weitergeleitet	transmise
weitergeleitet	redirigé
clinton	clinton
filmemacher	cinéastes
stapel	pile
zealand	zealand
mentor	mentor
dialekte	dialectes
einwanderer	immigrants
einwanderer	immigrés
tastatur	clavier
verleihen	prêter
rebellion	rébellion
kahl	chauve
joel	joel
saturn	saturn
saturn	saturne
herausforderung	défi
initiativen	initiatives
seat	seat
realisierung	réalisation
gun	gun
asche	cendres
porta	porta
binden	lier
late	late
kontrast	contraste
wittgenstein	wittgenstein
next	next
karel	karel
boulevard	boulevard
palmer	palmer
regionaler	régional
rolling	rolling
droste	droste
schwächen	faiblesses
neuburg	neuburg
realismus	réalisme
reichenbach	reichenbach
hansa	hansa
donnerstag	jeudi
gras	herbe
schätze	trésors
reliefs	reliefs
interpretationen	interprétations
maas	meuse
strauß	bouquet
spree	spree
malcolm	malcolm
eduardo	eduardo
brunner	brunner
sidney	sidney
mantel	manteau
arsenal	arsenal
karen	karen
intel	intel
thieme	thieme
entry	entry
melchior	melchior
delegierter	délégué
modernisiert	modernisé
executive	executive
libyen	libye
krupp	krupp
musikwissenschaftler	musicologue
käufer	acheteur
vampir	vampire
moderatorin	présentatrice
pfeil	flèche
ähneln	ressemblent
cent	cents
geographic	geographic
töne	sons
technologien	technologies
living	living
toledo	toledo
widersprechen	contredire
pfeiffer	pfeiffer
foster	foster
industrial	industrial
angola	angola
argumentieren	argumenter
eiche	chêne
blödsinn	conneries
kath	kath
wünschenswert	souhaitable
léon	léon
scholz	scholz
pseudo	pseudo
reichtum	richesse
ewige	éternel
unregelmäßig	irrégulier
gesetzgebung	législation
geformt	moulé
briefmarken	timbres
engelbert	engelbert
radikal	radical
guinea	guinée
ahl	ahl
anderswo	ailleurs
curtis	curtis
pete	pete
halberstadt	halberstadt
steel	steel
amberg	amberg
rhön	rhön
modul	module
greg	greg
price	price
konfrontiert	confronté
einwände	objections
sojus	soyouz
schlafen	dormir
weine	vins
lions	lions
kräftig	vigoureux
luc	luc
rupert	rupert
wasserstoff	hydrogène
nielsen	nielsen
physics	physics
taz	taz
rapid	rapid
gaius	gaius
erleichtert	facilite
shaw	shaw
überwacht	surveillé
überwacht	surveillant
dtv	dtv
rachel	rachel
census	census
behinderung	handicap
mythen	mythes
vulkan	volcan
release	release
ionen	ions
erlitten	subi
schalke	schalke
kleist	kleist
carol	carol
dreier	trio
jesse	jesse
auslöser	déclenchements
gekrönt	couronné
passend	convenable
vorderseite	recto
leopoldina	leopoldina
propheten	prophètes
grove	grove
pisa	pise
speed	speed
valle	valle
eder	eder
artur	artur
intervention	intervention
zweige	branches
verfall	déchéance
rötlich	rougeâtre
benno	benno
paraguay	paraguay
privilegien	privilèges
chirurg	chirurgien
autonomie	autonomie
petri	petri
läufer	coureur
läufer	coureurs
nizza	nice
würzburger	würzburger
glaubte	croyait
mason	mason
hunger	faim
reuter	reuter
illustration	illustration
ried	ried
strenge	rigueur
sardinien	sardaigne
amerikanisch	américain
staub	poussière
airways	airways
schütz	schütz
biennale	biennale
gif	gif
wurzel	racine
fleck	tache
einordnen	classer
bryan	bryan
bennett	bennett
empfehlungen	recommandations
lie	lie
ungewöhnliche	insolite
bildschirm	écran
swing	swing
bombe	bombe
bestraft	punis
vereinfacht	simplifié
anthropologie	anthropologie
vandalen	vandales
columbus	columbus
radar	radar
bonaparte	bonaparte
anspielung	allusion
eur	eur
arbeite	travaille
juri	youri
xavier	xavier
trompete	trompette
imperial	impérial
imperial	imperial
schweinfurt	schweinfurt
haller	haller
masuren	mazurie
ableitung	dérivation
kaliber	calibre
ahmed	ahmed
vierzehn	quatorze
fünfzehn	quinze
ain	ain
russ	russ
wartet	attend
frequenzen	fréquences
leichen	cadavres
documenta	documenta
kirchberg	kirchberg
vandenhoeck	vandenhoeck
montgomery	montgomery
yves	yves
fragment	fragment
interstate	interstate
soko	soko
hofer	hofer
bart	bart
horror	horreur
hey	hey
gruber	gruber
number	number
pflegen	toilettage
aufzählung	énumération
sergio	sergio
absteiger	relégué
string	string
cornelia	cornelia
aserbaidschan	azerbaïdjan
sul	sul
iihf	iihf
scientific	scientific
ruhm	gloire
midi	midi
heaven	heaven
klassifikation	classification
schlaf	sommeil
schreibweisen	orthographes
iss	mange
segment	segment
ermland	varmie
napoleonischen	napoléonienne
critics	critics
tree	tree
platin	platine
cello	violoncelle
toskana	toscane
gemalt	peint
plauen	plauen
reparatur	réparation
leder	cuir
konstruktiv	constructif
konstruktiv	constructive
dokumentieren	documenter
ute	ute
mafia	mafia
mitarbeiterin	collaboratrice
lès	lès
landwehr	landwehr
drive	drive
import	import
col	col
psychiater	psychiatre
beleidigungen	insultes
where	where
ital	ital
archäologen	archéologues
anden	andes
badische	badische
lagern	camps
torsten	torsten
leber	foie
prototypen	prototypes
leidet	souffre
cold	cold
zero	zero
dmitri	dmitri
stile	styles
cool	cool
wei	wei
wells	wells
fürstenberg	fürstenberg
experimentelle	expérimental
experimentelle	expérimentale
wetzlar	wetzlar
eingehalten	respecté
wüsste	connaîtrait
reed	reed
leningrad	leningrad
brooks	brooks
corpus	corpus
anglo	anglo
prüfungen	examens
prüfungen	essais
nickel	nickel
pension	pension
linear	linéaire
percy	percy
betten	lits
dominik	dominik
gebet	prière
verse	versets
cum	cum
palm	palm
landet	atterrit
anker	ancre
triest	trieste
jin	jin
wallis	valais
sibirien	sibérie
chip	puce
limousine	limousine
ausführen	exécuter
begleiter	compagnon
bezirksliga	bezirksliga
alberta	alberta
domenico	domenico
patient	patient
child	child
genießen	apprécier
genießen	profitez
protestanten	protestants
nietzsche	nietzsche
kid	kid
investiert	investit
investiert	investi
elke	elke
illegal	illégal
mill	mill
helmuth	helmuth
teheran	téhéran
ausläufer	contreforts
transparenz	transparence
operette	opérette
kalkstein	calcaire
wat	wat
luca	luca
derby	derby
zerfall	désintégration
trinidad	trinidad
cole	cole
widerlegt	réfuté
philipps	philipps
morton	morton
spiegelt	reflète
andersen	andersen
körner	grains
präzise	précis
logistik	logistique
zorn	colère
heilbronner	heilbronner
geograph	géographe
ausdrücken	exprimez
verknüpfung	raccourci
false	false
saône	saône
vista	vista
späte	tardive
blütenstand	inflorescence
alpine	alpine
kreta	crète
fakt	fait
betty	betty
voice	voice
naumburg	naumburg
bildnis	effigie
annäherung	rapprochement
ger	ger
ghetto	ghetto
wing	wing
optional	facultatif
gps	gps
sbb	cff
tags	balises
tags	tags
skandinavien	scandinavie
mauerwerk	maçonnerie
calgary	calgary
bertram	bertram
minsk	minsk
bedürfnisse	besoins
genauigkeit	précision
wohlstand	prospérité
literature	literature
jamie	jamie
bradley	bradley
theodore	theodore
glenn	glenn
kaukasus	caucase
ellis	ellis
verdiente	méritait
friedberg	friedberg
peerage	peerage
absichtlich	exprès
absichtlich	intentionnellement
than	than
rocky	rocky
straubing	straubing
märkte	marchés
lech	lech
hannah	hannah
originale	originaux
sachs	sachs
wolken	nuages
proben	échantillons
schaumburg	schaumbourg
aargau	argovie
schuhe	chaussures
gérard	gérard
wiedergabe	lecture
cricket	cricket
ibrahim	ibrahim
goldmann	goldmann
autobahnen	autoroutes
trans	trans
antenne	antenne
faber	faber
aircraft	aircraft
annie	annie
vernünftig	raisonnable
parma	parme
gift	poison
durchgang	passage
betrachtete	regardait
senden	envoyer
antarktis	antarctique
nicolaus	nicolaus
betrachter	afficheur
katja	katja
heidi	heidi
glanz	brillance
glanz	lustre
populationen	populations
rudolstadt	rudolstadt
versailles	versailles
kapellmeister	kapellmeister
waffenstillstand	armistice
paz	paz
stop	stop
medici	médicis
augenblick	instant
krater	cratère
julien	julien
variable	variable
voigt	voigt
tschechoslowakischen	tchécoslovaque
kingdom	kingdom
verraten	trahi
guardian	guardian
mechanismus	mécanisme
steyr	steyr
lille	lille
birds	birds
brenner	brûleur
brenner	graveur
arrangeur	arrangeur
enrico	enrico
marino	marino
powell	powell
kompliziert	compliqué
verbandsliga	verbandsliga
nicolai	nicolai
haven	haven
rain	rain
fisher	fisher
hoffen	espérer
vorbereitungen	préparatifs
helligkeit	luminosité
toleranz	tolérance
amy	amy
lose	vrac
gau	gau
hbf	hbf
kenny	kenny
blume	fleur
wimbledon	wimbledon
immobilien	immobilier
beyond	beyond
lauenburg	lauenbourg
spvgg	spvgg
tolle	superbes
lehrt	enseigne
keltischen	celtique
app	app
todd	todd
without	without
blitz	foudre
peinlich	gênant
peinlich	embarrassant
begleiten	accompagner
kühn	audacieux
dominique	dominique
davies	davies
empfiehlt	recommande
karlheinz	karlheinz
tipps	conseils
airbus	airbus
rassen	races
flying	flying
schlange	serpent
wave	wave
aids	sida
niederschlag	précipitation
niederschlag	précipitations
bloch	bloch
fröhlich	joyeux
fröhlich	joyeuse
symbolisiert	symbolise
heise	heise
garmisch	garmisch
sorgfältig	soigneusement
churchill	churchill
canyon	canyon
nationalität	nationalité
schwarzenberg	schwarzenberg
pearl	pearl
anita	anita
syntax	syntaxe
eyes	eyes
strophe	couplet
zonen	zones
municipal	municipal
money	money
acta	acta
krönung	couronnement
besetzen	pourvoir
kids	kids
entziehen	soustraire
sklaverei	esclavage
gate	gate
freilassung	libération
darwin	darwin
duncan	duncan
philosophy	philosophy
knie	genou
initiator	initiateur
recklinghausen	recklinghausen
schulte	schulte
unzulässig	inadmissible
unzulässig	irrecevable
sechster	sixième
jessica	jessica
benny	benny
schlimmer	pire
centro	centro
insassen	détenus
sulzbach	sulzbach
proteine	protéines
variieren	varient
variieren	varier
reprint	reprint
vergrößerung	agrandissement
bekämpfen	combattre
gmünd	gmünd
nissan	nissan
kehrten	retournèrent
sparta	sparte
bachmann	bachmann
neo	neo
neo	néo
infektion	infection
battista	battista
neunkirchen	neunkirchen
émile	émile
ukrainisch	ukrainien
bsp	pnb
exportiert	exporte
deckt	couvre
leone	leone
verkleidet	déguisé
bekanntgegeben	signalé
electronic	electronic
memmingen	memmingen
fabriken	usines
buchenwald	buchenwald
atlantis	atlantis
berechnen	calculer
programmierung	programmation
delaware	delaware
physiologie	physiologie
lindau	lindau
lob	louange
youth	youth
klicken	cliquer
pforzheim	pforzheim
schätzungen	estimations
geschwindigkeiten	vitesses
brest	brest
beschlüsse	décisions
beschlüsse	ordonnances
face	face
dynamik	dynamique
martínez	martínez
simpson	simpson
crawford	crawford
rhode	rhode
biblischen	biblique
tours	tours
schleuse	écluse
bey	bey
klee	trèfle
isabel	isabel
gent	gand
coa	coa
rau	rugueux
rau	rau
kostüme	costumes
meißner	meißner
another	another
nepal	népal
gräben	fossés
gräben	tranchées
berührung	toucher
gitarren	guitares
stadien	stades
lemberg	lemberg
formeln	formules
würdigung	appréciation
transparent	transparent
schwiegersohn	gendre
claudio	claudio
überzogen	revêtus
sen	sen
pauline	pauline
korruption	corruption
franke	franke
beate	beate
tanzen	danse
denver	denver
schrader	schrader
lucy	lucy
richards	richards
musica	musica
porter	porter
mills	mills
ole	ole
flüge	vols
fsv	fsv
newcastle	newcastle
strategien	stratégies
esther	esther
zeugnisse	témoignages
regiert	gouverné
regiert	règne
regiert	gouverne
atom	atome
mathematics	mathematics
synode	synode
häufigkeit	fréquence
staatsangehörigkeit	nationalité
soest	soest
schwarzburg	schwarzburg
away	away
vila	vila
protestantische	protestante
weisheit	sagesse
nächster	suivant
sehnsucht	nostalgie
arne	arne
pixel	pixels
memphis	memphis
illustriert	illustré
dumm	stupide
codes	codes
henderson	henderson
alfonso	alfonso
klinge	lame
gibson	gibson
kalk	chaux
emily	emily
mad	mad
said	saïd
satire	satire
osmanen	ottomans
print	print
hass	haine
mazedonien	macédoine
para	para
diamond	diamond
homer	homer
stan	stan
initiiert	initié
alphabetisch	alphabétique
flaggen	drapeaux
chi	chi
led	led
flammen	flammes
kapitalismus	capitalisme
niederlassungen	succursales
sascha	sacha
ssr	ssr
federico	federico
socken	chaussettes
lieferung	livraison
serben	serbes
done	done
giro	giro
testen	tester
horizont	horizon
nische	niche
dekret	décret
absurd	absurde
harper	harper
martín	martín
journalismus	journalisme
einrichten	configurer
verstöße	infractions
sysop	sysop
defa	defa
hausen	hausen
sylvia	sylvia
derek	derek
cups	cups
umbenennen	renommer
federn	ressorts
tessin	tessin
übungen	exercices
blake	blake
transportieren	transporter
lou	lou
einbeziehung	inclusion
crystal	crystal
beyer	beyer
barra	barra
schultz	schultz
spandau	spandau
motion	motion
akteure	acteurs
javier	javier
gefolge	cortège
unterirdischen	souterrain
unterirdischen	souterraine
sauerland	sauerland
penguin	penguin
anja	anja
bytes	octets
schwangerschaft	grossesse
planen	planifier
pohl	pohl
lucky	lucky
zahn	dent
nat	nat
landsmann	compatriote
schuh	chaussure
transfermarkt	transfermarkt
sexualität	sexualité
recordings	recordings
zusammenhängen	contextes
batman	batman
räder	roues
escudo	escudo
absturz	crash
inflation	inflation
nordische	nordique
folter	torture
richardson	richardson
phänomene	phénomènes
berufe	professions
eye	eye
athletic	athletic
bertrand	bertrand
creative	creative
stumpf	moignon
vergehen	délit
milton	milton
prädikat	prédicat
burton	burton
nordhausen	nordhausen
geoffrey	geoffrey
franziskaner	franciscain
urteile	arrêts
dawn	dawn
wartung	entretien
wartung	maintenance
teresa	teresa
nuclear	nuclear
akzeptanz	acceptation
bravo	bravo
exchange	exchange
enttäuscht	déçu
siegmund	siegmund
tauchte	surgit
kombinationen	combinaisons
maximum	maximum
ocean	ocean
underground	underground
nichte	nièce
genealogie	généalogie
check	check
zusammenfluss	confluent
profile	profils
katrin	katrin
ingenieure	ingénieurs
ausfall	panne
trompeter	trompettiste
flight	flight
finanzieren	financer
torres	torres
genossenschaft	coopérative
cox	cox
trail	trail
bauernhof	ferme
indianapolis	indianapolis
vieh	bétail
ähnlichkeiten	similitudes
atlético	atlético
yards	yards
hohenlohe	hohenlohe
cotta	cotta
paket	paquet
mittwoch	mercredi
neuwied	neuwied
eagle	eagle
beeindruckt	impressionné
amiga	amiga
ehc	ehc
miniserie	minisérie
far	far
bregenz	bregenz
ghost	ghost
bundesarchiv	bundesarchiv
kreuzzug	croisade
unglücklich	malheureux
liberty	liberty
förderverein	freunde
too	too
elena	elena
wellington	wellington
referenzen	références
arbeitslosigkeit	chômage
ira	ira
gilles	gilles
klammer	parenthèse
horse	horse
spitzname	surnom
salem	salem
abfrage	requête
gerüchte	rumeurs
partenkirchen	partenkirchen
#ffffff	#ffffff
schrott	débris
lucia	lucia
hess	hess
brühl	brühl
konstante	constante
suzuki	suzuki
reverts	reverts
bögen	arcs
regentschaft	régence
enrique	enrique
geister	fantômes
revolutionäre	révolutionnaires
leiste	aine
tank	réservoir
krank	malade
diözesen	diocèses
möbel	meubles
eden	eden
lancaster	lancaster
sonja	sonja
zeugt	témoigne
verschont	épargné
aurich	aurich
olympic	olympic
republic	republic
weißenburg	weißenburg
academia	academia
gambia	gambie
mais	maïs
bella	bella
sarajevo	sarajevo
dagmar	dagmar
steinkohle	houille
bonifatius	boniface
riesen	géants
riesen	géant
intensität	intensité
epochen	époques
plaza	plaza
tyler	tyler
markieren	marquer
lugano	lugano
xml	xml
erasmus	erasmus
spaltung	scission
visual	visual
akzeptabel	acceptable
fish	fish
sing	sing
fakultäten	facultés
gelaufen	couru
erstaunlich	étonnant
nebenrollen	figurations
urs	urs
bamberger	bamberger
ethnische	ethnique
ethnische	ethniques
lücken	lacunes
vicente	vicente
sendet	envoie
tendenzen	tendances
tina	tina
stella	stella
eth	eth
leeds	leeds
spezialisten	spécialistes
büste	buste
feierlich	solennel
feierlich	solennellement
kickers	kickers
woods	woods
core	core
herne	herne
sts	sts
torpedo	torpille
stehend	debout
beschlagnahmt	saisis
senatoren	sénateurs
jahrtausend	millénaire
angels	angels
radikale	radicaux
welcome	welcome
alfredo	alfredo
rey	rey
bailey	bailey
tan	tan
rich	rich
lügen	mensonges
montpellier	montpellier
chelsea	chelsea
mali	mali
navarra	navarre
sportlich	sportif
krems	krems
gruppierung	groupement
andrews	andrews
branch	branch
tödliche	mortelle
hübner	hübner
nva	nva
verden	verden
xbox	xbox
size	size
medikamente	médicaments
aborigines	aborigènes
chemical	chemical
demonstranten	manifestants
