der	le
die	les
und	et
von	par
von	de
des	du
mit	avec
ist	est
für	pour
auf	sur
ein	un
ein	une
eine	une
auch	également
auch	aussi
sich	se
nicht	pas
nach	après
nach	selon
war	war
war	était
bei	chez
sie	vous
sie	elle
ich	je
ich	moi
werden	seront
werden	devenir
sind	sont
oder	ou
wird	sera
durch	par
score	score
einen	un
dass	que
aber	mais
wie	comme
wie	comment
nur	uniquement
nur	seulement
unter	sous
artikel	articles
man	man
vor	avant
diese	cette
diese	ces
vom	du
kann	peut
hier	ici
diskussion	discussion
seine	ses
seit	depuis
dieser	cette
dieser	ce
jahr	année
wenn	si
dann	ensuite
dann	alors
dann	puis
zwei	deux
jahre	années
mai	mai
isbn	isbn
was	quoi
hatte	avait
zwischen	entre
gegen	contre
keine	néant
keine	aucune
waren	marchandises
zeit	temps
stadt	ville
wieder	encore
schon	déjà
haben	ont
gibt	donne
seed	seed
siehe	voir
drei	trois
teil	partie
berlin	berlin
habe	ai
alle	tous
während	pendant
ihre	votre
ihre	vos
bereits	déjà
dieses	cette
dieses	ce
können	peuvent
jan	jan
sehr	très
ihr	votre
gemeinde	commune
erste	première
erste	premier
august	august
august	août
ohne	sans
sollte	devrait
deutschland	allemagne
ihm	lui
ende	fin
märz	mars
aug	aug
deutsche	allemands
band	bande
januar	janvier
oktober	octobre
immer	toujours
also	donc
nov	nov
wikipedia	wikipédia
jun	jun
jul	jul
juni	juin
konnte	pouvait
april	avril
september	septembre
selbst	même
juli	juillet
okt	oct
feb	fév
geschichte	histoire
apr	apr
jpg	jpg
dezember	décembre
dez	déc
universität	université
platz	place
sep	sep
november	novembre
liste	liste
kam	vint
wir	nous
jahrhundert	siècle
dies	ceci
dies	cela
vier	quatre
seite	page
februar	février
zusammen	ensemble
film	film
wäre	serait
neue	nouvelle
leben	vie
new	new
namen	noms
relevanz	pertinence
muss	doit
einige	certains
einige	quelques
mitglied	membre
text	texte
münchen	munich
löschen	supprimer
bekannt	connue
bekannt	connu
zurück	retour
ort	lieu
geht	va
jetzt	maintenant
friedrich	friedrich
stand	stand
würde	dignité
politiker	politiciens
personen	personnes
titel	titre
karl	karl
gut	bien
gut	bon
familie	famille
weiter	continuer
sohn	fils
hans	hans
erl	erl
gehört	entendu
bild	image
nichts	rien
wien	vienne
bezeichnet	désigne
gelöscht	supprimé
denn	car
peter	peter
sei	sois
fall	cas
wilhelm	wilhelm
englisch	anglais
davon	dont
fünf	cinq
könig	roi
welche	quels
welche	quelle
welche	quel
mehrere	plusieurs
form	forme
meter	mètre
schloss	château
gruppe	groupe
finden	trouver
nahm	prit
heinrich	heinrich
neu	nouveau
john	john
könnte	pourrait
machen	faire
beispiel	exemple
recht	droit
bin	bin
york	york
paul	paul
frage	question
insgesamt	total
eher	plutôt
kurz	court
unternehmen	entreprises
verwendet	utilisé
straße	route
straße	rue
rund	rond
einfach	facile
einfach	simple
datei	fichier
frau	femme
lassen	laisser
land	pays
fast	presque
hatten	eurent
hatten	avaient
tod	décès
tod	mort
arbeit	travail
macht	puissance
paris	paris
alles	tout
kategorie	catégorie
bedeutung	signification
bereich	secteur
bereich	domaine
welt	monde
anfang	début
viel	beaucoup
quelle	source
haus	maison
michael	michael
region	région
lang	lang
allen	allen
hamburg	hambourg
besonders	particulièrement
deutsch	francais
deutsch	allemand
franz	franz
lange	lange
begriff	terme
gegründet	fondé
gegründet	fondée
gegründet	basé
gesellschaft	société
folge	épisode
align	align
will	will
georg	georg
erhalten	obtenir
einwohner	habitants
führt	mène
führt	conduit
führt	exécute
studierte	étudié
london	londres
alten	anciens
alten	ancien
kinder	enfants
gerade	juste
österreich	autriche
mitte	milieu
sechs	six
album	album
museum	musée
musik	musique
gebäude	bâtiment
begründung	justification
wenig	peu
kreis	cercle
frankreich	france
pro	pro
thomas	thomas
grund	raison
möglich	possible
thema	thème
rolle	rouleau
rolle	rôle
musste	fallait
gewünscht	souhaité
entwicklung	développement
meine	mon
frankfurt	francfort
stuttgart	stuttgart
benutzer	utilisateurs
maria	marie
vater	père
frauen	femmes
buch	livre
provinz	province
dir	toi
quellen	sources
bleibt	reste
kilometer	kilomètres
stunden	heures
martin	martin
ernst	ernst
schule	école
leipzig	leipzig
https	https
ludwig	ludwig
archivierung	archivage
dorf	village
robert	robert
mannschaft	équipe
gesperrt	verrouillé
stark	stark
gewählt	élu
gewählt	élus
spielen	jouer
iii	iii
weiß	blanc
bar	bar
amt	amt
sogar	même
seiten	pages
richtung	direction
köln	cologne
partei	parti
wer	qui
kleine	petite
http	http
version	version
international	international
tage	jours
rahmen	cadre
werke	œuvres
werke	oeuvres
offizielle	officielle
offizielle	officiel
kommen	venir
weniger	moins
autor	auteur
müssen	doivent
wirklich	vraiment
preis	prix
ddr	rda
genau	exactement
spiel	jeu
teilweise	partiellement
burg	château
schweiz	suisse
serie	série
arbeiten	travaux
arbeiten	travailler
tag	jour
norden	nord
sollten	devraient
literatur	littérature
millionen	millions
krieg	guerre
besser	mieux
sprache	langue
lemma	lemme
zeigt	affiche
danke	merci
pdf	pdf
schauspieler	acteur
hätte	aurait
auswahl	sélection
spieler	joueurs
spieler	joueur
links	liens
warum	pourquoi
otto	otto
from	from
konnten	pouvaient
beschreibung	description
direkt	directement
direkt	direct
schriftsteller	écrivain
alter	age
alter	âge
klasse	classe
gemeinden	communes
bischof	évêque
höhe	hauteur
reihe	série
häufig	fréquent
häufig	fréquents
süden	sud
gruß	salutation
gemacht	fait
gehören	appartiennent
ließ	laissait
christian	christian
johannes	jean
erwähnt	mentionné
chr	chr
letzte	dernière
bezeichnung	dénomination
meister	maître
zuvor	auparavant
zuvor	précédemment
sicher	sûr
insel	île
klar	clair
joseph	joseph
veröffentlicht	publié
regierung	gouvernement
carl	carl
sieben	sept
bevölkerung	population
van	van
gleich	égal
alte	vieille
problem	problème
bayern	bavière
westen	ouest
lage	situation
mitglieder	membres
national	national
graf	comte
david	david
präsident	président
baden	baignade
kaiser	empereur
arten	espèces
geboren	né
richard	richard
sitz	siège
hermann	hermann
berliner	berliner
san	san
karriere	carrière
zehn	dix
center	center
system	système
bilder	images
vermutlich	probablement
erreicht	atteinte
erreicht	atteint
enthält	contient
mutter	mère
west	west
acht	huit
scheint	semble
ziel	objectif
ziel	cible
grüße	salutations
roman	roman
liga	ligue
spiele	jeux
sachsen	saxe
wolfgang	wolfgang
folgen	suivre
folgen	suivez
walter	walter
leider	malheureusement
uhr	montre
uhr	horloge
benannt	nommée
benannt	nommé
geben	donner
kultur	culture
gestellt	posée
gestellt	posé
alexander	alexander
trotz	malgré
projekt	projet
maler	peintre
paar	couple
max	max
sommer	été
runde	ronde
william	william
institut	institut
raum	espace
armee	armée
tun	faire
strecke	parcours
regel	règle
gefunden	trouvé
daten	données
welches	quel
theater	théâtre
wollte	voulait
person	personne
mein	mon
com	com
hilfe	aide
gegeben	donné
reich	riche
dich	toi
schnell	rapide
einzelnen	individuels
world	world
josef	josef
gmbh	sarl
google	google
besten	meilleurs
italien	italie
fragen	questions
hälfte	moitié
euro	euro
verbindung	connexion
nähe	proximité
anders	anders
vertrag	traité
vertrag	contrat
sonst	sinon
james	james
top	top
bruder	frère
künstler	artiste
england	angleterre
erfolg	succès
früher	autrefois
wissen	savoir
länge	longueur
groß	grand
geschrieben	écrit
beiträge	cotisations
abschnitt	section
trainer	entraîneur
gerne	volontiers
see	lac
spielt	joue
zeitschrift	revue
führen	guider
studium	etudes
ausbildung	formation
park	parc
george	george
wappen	armoiries
zürich	zurich
wort	mot
komponist	compositeur
zahl	nombre
internationale	internationale
dresden	dresde
schreiben	ecrire
schreiben	écrire
rudolf	rudolf
wahl	choix
männer	hommes
schauspielerin	actrice
hannover	hanovre
werde	deviens
werde	vais
dar	dar
spd	spd
schlacht	bataille
akademie	académie
gehen	aller
anzahl	nombre
anzahl	nbre
olympischen	olympique
stil	style
sagen	dire
charles	charles
american	american
funktion	fonction
wahrscheinlich	probablement
till	till
herzog	duc
jede	chaque
liebe	amour
rom	rome
umfasst	comprend
nachfolger	successeur
grenze	frontière
truppen	troupes
mitarbeiter	collaborateurs
werner	werner
verwendung	utilisation
sieg	victoire
entwickelt	développé
china	chine
besitzt	possède
leicht	facilement
besitz	possession
bald	bientôt
autoren	auteurs
tiefe	profondeur
press	press
gattung	genre
allein	seul
allein	seule
bürgermeister	maire
polen	pologne
link	lien
verheiratet	marié
ernannt	nommés
km²	km²
produktion	production
herrschaft	domination
berg	montagne
sla	sla
alt	vieux
punkt	point
andreas	andreas
stiftung	fondation
aktiv	actif
gute	bonne
punkte	points
minuten	minutes
bleiben	rester
frühen	précoce
her	her
rang	rang
diente	servit
ähnlich	similaire
ähnlich	semblable
finale	finale
verfahren	procédure
tour	tour
wollen	vouloir
ergebnis	résultat
mark	mark
württemberg	wurtemberg
falsch	faux
weise	sage
heiligen	sainte
möglichkeit	possibilité
leiter	chef
rennen	courses
del	del
union	union
japan	japon
fläche	superficie
müller	müller
albert	albert
fest	fête
kanton	canton
düsseldorf	düsseldorf
versucht	essayé
erkennen	détecter
erkennen	reconnaître
politik	politique
anna	anna
right	right
position	position
dennoch	néanmoins
schwer	lourd
ausschließlich	exclusivement
gruppen	groupes
satz	théorème
satz	phrase
ersetzt	remplacé
ersetzt	remplace
geführt	guidé
engl	engl
wert	valeur
späteren	ultérieur
frei	libre
frank	frank
klaus	klaus
inhalt	contenu
heinz	heinz
beteiligt	participe
beteiligt	impliqué
wochen	semaines
fritz	fritz
kategorien	catégories
louis	louis
records	records
selten	rare
schüler	élèves
fluss	rivière
vollständig	complètement
vollständig	entièrement
admin	admin
club	club
bremen	brême
relativ	relativement
jungen	garçons
erklärt	expliqué
erklärt	explique
fort	fort
musiker	musicien
musiker	musiciens
gesehen	vu
nimmt	prend
adolf	adolf
fußball	football
bedeutet	signifie
vertreter	représentants
hochgeladen	téléchargé
hessen	hesse
organisation	organisation
halten	garder
hand	main
sammlung	collection
lexikon	lexique
www	www
meisterschaft	championnat
nehmen	prendre
erbaut	construit
sinn	sens
bilden	composent
westfalen	westphalie
hoch	haut
herren	messieurs
probleme	problèmes
alfred	alfred
erscheint	apparaîtra
erscheint	apparaît
hallo	bonjour
vergleich	comparaison
php	php
nummer	numéro
hof	cour
halle	halle
basis	base
dient	sert
anton	anton
neun	neuf
wirtschaft	économie
markt	marché
städte	villes
kapelle	chapelle
verloren	perdu
ausgezeichnet	excellent
russland	russie
bonn	bonn
jugend	jeunesse
spanien	espagne
post	post
entweder	soit
soldaten	soldats
lebt	vit
zeigen	montrer
umgebung	environs
bücher	livres
medien	médias
jedes	chaque
entscheidung	décision
einfluss	influence
anlage	annexe
beschrieben	décrit
schutz	protection
lied	chanson
geworden	devenu
cdu	cdu
rechte	droits
color	color
erkennbar	reconnaissable
stück	pièce
stück	morceau
programm	programme
live	live
jazz	jazz
papst	pape
themen	thèmes
sache	chose
gerhard	gerhard
regelmäßig	régulièrement
erschienen	paru
junge	garçon
eltern	parents
sprachen	langues
internet	internet
größe	taille
start	démarrer
spricht	parle
hauptstadt	capitale
regisseur	réalisateur
philosophie	philosophie
friedhof	cimetière
philipp	philipp
lehrer	enseignants
lehrer	enseignant
würden	seraient
betrug	fraude
betrug	escroquerie
kopf	tête
zusammenarbeit	coopération
nein	non
denke	pense
brücke	pont
überwiegend	principalement
überwiegend	majoritairement
zerstört	détruit
bundesliga	bundesliga
teilen	partager
nacht	nuit
versionen	versions
lesen	lire
daniel	daniel
idee	idée
rot	rouge
eindeutig	clairement
bestimmt	détermine
bestimmt	déterminé
zweiter	deuxième
lebte	vécu
klein	petit
interesse	intérêt
genug	assez
enzyklopädie	encyclopédie
mussten	devaient
kind	enfant
münster	münster
svg	svg
studien	etudes
studien	études
direktor	directeur
römischen	romain
ost	ost
marie	marie
gustav	gustav
freiburg	fribourg
fehlt	manque
fehlt	manquant
modell	modèle
bildung	éducation
setzt	suspend
washington	washington
kurze	brève
kurze	courts
island	islande
you	you
kampf	combat
vertreten	représenté
abteilung	département
beginnt	commence
schwarz	noir
with	with
ulrich	ulrich
kurt	kurt
verband	bandage
single	célibataire
regeln	règles
wald	forêt
ferdinand	ferdinand
joachim	joachim
löschung	effacement
dollar	dollar
music	music
jürgen	jürgen
sänger	chanteur
heidelberg	heidelberg
fischer	pêcheurs
schweden	suède
ergebnisse	résultats
verkauft	vendu
vandalismus	vandalisme
zwölf	douze
juden	juifs
border	border
henry	henry
elisabeth	elisabeth
brandenburg	brandebourg
verliehen	décerné
suche	recherche
breite	largeur
royal	royal
festival	festival
übersetzung	traduction
versuch	tentative
pfalz	palatinat
state	state
rhein	rhin
bewegung	mouvement
opfer	victime
bayerischen	bavarois
erde	terre
angegeben	spécifié
technik	technique
typ	type
united	united
mag	mag
open	open
mainz	mayence
boden	sol
radio	radio
entdeckt	découvert
bernhard	bernhard
vorschlag	proposition
erzbischof	archevêque
halt	halte
ungarn	hongrie
historiker	historien
pierre	pierre
software	logiciels
status	statut
rock	rock
aufstieg	ascension
verwaltung	gestion
wiki	wiki
bank	banque
rein	pur
mannschaften	equipes
tor	tor
herbst	automne
schulen	écoles
ebene	niveau
ebene	plaine
seitdem	depuis
schmidt	schmidt
gehörten	appartenaient
göttingen	göttingen
richter	juges
richter	juge
ausstellung	exposition
aufgabe	tâche
kirchen	églises
kirchen	eglises
lösung	solution
north	north
tiere	animaux
rheinland	rhénanie
werbung	publicité
winter	hiver
unterschied	différence
familien	familles
inseln	îles
offensichtlich	évidemment
objekte	objets
anteil	part
society	society
house	house
nürnberg	nuremberg
herr	monsieur
silber	argent
französisch	français
theorie	théorie
air	air
jährlich	annuel
manchmal	parfois
unterstützt	soutenu
allgemein	général
arbeitet	travaille
architekt	architecte
jurist	juriste
fällt	tombe
eingeführt	introduits
eingeführt	introduit
ortschaft	localité
south	south
existiert	existe
führung	leadership
herbert	herbert
star	star
zeichen	caractères
komplett	complètement
komplett	complet
braunschweig	braunschweig
verhalten	comportement
herkunft	origine
herkunft	origines
sport	sport
mittel	crédits
verbreitung	diffusion
theodor	theodor
sofort	immédiatement
wissenschaft	science
gesetz	loi
journalist	journaliste
moskau	moscou
edit	edit
stimme	voix
qualität	qualité
veröffentlichung	publication
zahlen	chiffres
galerie	galerie
verlassen	quitter
black	black
aufgaben	tâches
title	title
fehler	erreur
filme	films
stadion	stade
basel	bâle
org	org
wichtig	important
leistung	puissance
handbuch	manuel
gespielt	joué
motor	moteur
offiziell	officiellement
texte	textes
gott	dieu
villa	villa
dichter	poète
helmut	helmut
nationalen	nationaux
beschäftigt	occupé
hergestellt	fabriqué
tal	vallée
fotos	photos
sagt	dit
gewinnen	gagner
woche	semaine
erich	erich
fernsehen	télévision
schleswig	schleswig
preußen	prusse
wettbewerb	concours
mio	mio
natur	nature
gleichnamigen	homonyme
kosten	coût
teilnehmer	participants
archiv	archives
chor	chœur
stefan	stefan
zustand	état
bach	bach
polizei	police
jakob	jakob
schön	beau
html	html
super	super
australien	australie
left	left
flughafen	aéroport
kreuz	croix
png	png
zukunft	futur
änderungen	modifications
änderungen	changements
bern	berne
revolution	révolution
tradition	tradition
kanada	canada
straßen	routes
architektur	architecture
umbenannt	renommé
umbenannt	rebaptisé
arzt	médecin
arzt	medecin
parallel	parallèle
medizin	médecine
praxis	pratique
zählen	compter
bibliothek	bibliothèque
konrad	konrad
druck	pression
freund	ami
antwort	réponse
geschlossen	fermé
love	love
landwirtschaft	agriculture
auflösung	résolution
salzburg	salzbourg
fahrzeuge	véhicules
portal	portail
erstellt	créé
schwester	soeur
augen	yeux
min	min
beispiele	exemples
gezeigt	montré
theologe	théologien
notwendig	nécessaire
simon	simon
don	don
präsidenten	présidents
julius	julius
nominiert	nominé
anwendung	application
formel	formule
santa	santa
label	label
red	red
geburtstag	anniversaire
regiment	régiment
niederlage	défaite
chicago	chicago
institute	instituts
formen	moules
formen	formes
orgel	orgue
video	vidéo
wolf	loup
elf	onze
elf	elfe
elf	elf
aufgelöst	dissous
übersetzt	traduit
mädchen	fille
glaube	croyance
trug	portait
architekten	architectes
foto	photo
eduard	eduard
herausgeber	éditeur
einheit	unité
ritter	chevalier
hersteller	fabricant
darmstadt	darmstadt
bringt	apporte
ausbau	soutènement
verantwortlich	responsable
angeles	angeles
zeitraum	période
tom	tom
menge	quantité
zentimeter	centimètres
besitzen	posséder
versuchte	essayé
tübingen	tübingen
breit	large
parteien	partis
energie	énergie
wesentlichen	essentiel
bürger	citoyens
arthur	arthur
life	life
leistungen	prestations
holstein	holstein
auszeichnungen	récompenses
teilnahme	participation
besuch	visite
definition	définition
original	original
prag	prague
modernen	modernes
bot	bot
teams	équipes
verstehen	comprendre
ehefrau	épouse
indien	inde
beschreibt	décrit
josé	josé
schlecht	mal
schlecht	mauvais
häuser	maisons
admins	admins
leser	lecteurs
turnier	tournoi
körper	corps
chemie	chimie
bildhauer	sculpteur
bericht	rapport
angriff	attaque
sängerin	chanteuse
sprechen	parler
gewonnen	gagné
fakultät	faculté
verhältnis	ratio
bist	es
diskutiert	discuté
mexiko	mexique
kommission	commission
vereine	clubs
erhält	reçoit
erhält	obtient
mehrheit	majorité
datum	date
british	british
marine	marine
variante	variante
kalifornien	californie
sicherheit	sécurité
kassel	kassel
meer	mer
theologie	théologie
gast	invité
nächste	prochain
nächste	prochains
nächste	prochaine
konzept	concept
türkei	turquie
bronze	bronze
setzen	miser
begonnen	commencé
begonnen	commencée
lieder	chansons
persönlich	personnellement
herausgegeben	édité
verwenden	utiliser
grenzen	limites
oper	opéra
smith	smith
fenster	fenêtres
fenster	fenêtre
unterscheiden	distinguer
farbe	couleur
commons	commons
poly	poly
matthias	matthias
rede	discours
geändert	modifié
russisch	russe
horst	horst
zugeordnet	attribué
unternehmer	entrepreneur
unternehmer	entrepreneurs
karten	cartes
prinzip	principe
struktur	structure
grafschaft	comté
beruf	profession
alben	albums
aktuell	actualité
szene	scène
parlament	parlement
licht	lumière
ausdruck	expression
oxford	oxford
ungefähr	environ
verschoben	déplacé
verschoben	décalé
erwähnung	mention
argumente	arguments
spitze	dentelle
spitze	pointe
hugo	hugo
morgen	demain
holz	bois
qualifikation	qualification
industrie	industrie
material	matériel
king	king
angesehen	regardé
manfred	manfred
edward	edward
one	one
best	best
elemente	eléments
existieren	exister
abitur	baccalauréat
bistum	diocèse
anhalt	anhalt
ansicht	vue
inneren	intérieurs
adam	adam
unbekannt	inconnu
feld	champ
dänemark	danemark
jüdische	juive
würzburg	würzburg
imho	imho
kriterien	critères
standard	standard
pflanzen	plantes
landtag	landtag
änderung	changement
infanterie	infanterie
brüder	frères
albrecht	albrecht
kiel	kiel
interview	interview
spiegel	miroir
mecklenburg	mecklembourg
zug	train
verlegt	égaré
verlegt	transféré
königin	reine
geplant	planifié
lizenz	licence
veranstaltungen	événements
schrift	ecriture
ändern	changer
high	high
diskussionen	discussions
erinnert	rappelle
verstanden	compris
nationalsozialismus	nazisme
talk	talk
argument	argument
zentrale	central
abgeschlossen	terminé
wiesbaden	wiesbaden
verkehr	transports
show	spectacle
landschaft	paysage
gegner	adversaires
gegner	adversaire
gekommen	venu
blau	bleu
persönliche	personnelle
stern	étoile
abs	abs
herstellung	fabrication
ausreichend	suffisant
ausreichend	suffisante
hockey	hockey
antonio	antonio
lee	lee
bestätigt	confirmé
einheiten	unités
israel	israël
sperren	verrouiller
brasilien	brésil
klavier	piano
durchmesser	diamètre
gericht	tribunal
ältere	anciens
barbara	barbara
orchester	orchestre
augsburg	augsburg
kennt	connaît
unsere	notre
unsere	nos
abgeordneter	député
group	group
früh	précoce
früh	tôt
physik	physique
einträge	entrées
metal	metal
gouverneur	gouverneur
belgien	belgique
ähnliche	similaires
cambridge	cambridge
auto	voiture
graz	graz
magazin	magazine
francisco	francisco
vergangenheit	passé
presse	presse
gegenwart	présent
wann	quand
definiert	défini
religion	religion
jena	jena
linien	lignes
fallen	pièges
besetzung	occupation
methode	méthode
hektar	hectare
gelesen	lu
gründer	fondateur
farben	couleurs
texas	texas
meyer	meyer
entscheiden	décider
erklärung	déclaration
erklärung	explication
handel	commerce
ausland	etranger
monat	mois
studenten	étudiants
studenten	etudiants
windows	windows
funktionen	fonctions
funktionen	fonctionnalités
listen	listes
solid	solid
lübeck	lübeck
eigenschaften	propriétés
günter	günter
fließt	coule
versuchen	essayer
widerstand	résistance
design	design
entschieden	décidé
offizier	officier
erklären	expliquer
kongress	congrès
volk	peupler
white	white
universitäten	universités
nachgewiesen	démontré
günther	günther
gottfried	gottfried
code	code
beziehung	relation
karlsruhe	karlsruhe
grad	degrés
grad	degré
mathematik	mathématiques
bund	bund
amsterdam	amsterdam
verbessern	améliorer
nsdap	nsdap
geschützt	protégé
profil	profil
glauben	croire
wikimedia	wikimedia
las	las
millimeter	millimètre
dvd	dvd
fuß	pied
züge	trains
portugal	portugal
begriffe	termes
vergeben	pardonner
besetzt	occupé
tabelle	tableau
zuschauer	spectateurs
arnold	arnold
reaktion	réaction
wahlen	élections
ausgestattet	équipée
ausgestattet	équipé
automatisch	automatiquement
automatisch	automatique
harry	harry
eingetragen	enregistrée
regionen	régions
außen	extérieur
verfassung	maquillage
getrennt	séparé
entfernung	distance
gefahr	danger
minister	ministre
speziell	spécialement
leopold	leopold
interessant	intéressant
generation	génération
wunsch	désir
wunsch	souhait
oblast	oblast
verurteilt	condamné
waffen	armes
dietrich	dietrich
mfg	mfg
schneider	tailleur
entwurf	brouillon
gemeinschaft	communauté
zugang	accès
garten	jardin
weisen	sages
thüringen	thuringe
tonnen	tonnes
afrika	afrique
wagner	wagner
hafen	port
ermöglicht	permet
kontrolle	contrôle
rathaus	mairie
emil	emil
langsam	lentement
norwegen	norvège
angeblich	prétendument
sebastian	sebastian
sebastian	sébastien
initiative	initiative
maßnahmen	mesures
aktivitäten	activités
oscar	oscar
medaille	médaille
dritter	troisième
dritter	tiers
freiheit	liberté
baron	baron
verschieben	déplacer
projekte	projets
felix	felix
kamera	caméra
priester	prêtre
charakter	caractère
charakter	personnage
big	big
street	street
ausgeführt	exécuté
organisationen	organisations
ziehen	glisser
fahrer	chauffeur
fahrer	conducteur
magdeburg	magdeburg
kommentar	commentaire
küste	côte
time	time
debüt	débuts
gedichte	poèmes
produkte	produits
möglichkeiten	possibilités
möglichkeiten	opportunités
donau	danube
spielten	jouaient
mission	mission
kombination	combinaison
first	first
prinz	prince
endgültig	définitif
endgültig	définitivement
kapitel	chapitre
juan	juan
drehbuch	scénario
versuche	tentatives
ortschaften	localités
alternative	alternative
infrastruktur	infrastructure
praktisch	pratiquement
jacques	jacques
biografie	biographie
gründe	raisons
phase	phase
junioren	juniors
françois	françois
korrekt	correcte
korrekt	correct
behandlung	traitement
verändert	changé
erstellen	créer
unterscheidet	distingue
user	user
meisterschaften	championnats
eng	eng
bauten	constructions
jack	jack
handeln	agir
mary	mary
freunde	amis
frieden	paix
stub	stub
ruf	réputation
herz	cœur
herz	coeur
pov	pov
eröffnung	ouverture
ägypten	égypte
european	european
studio	studio
spanisch	espagnol
kollegen	collègues
not	not
hill	hill
bruno	bruno
regensburg	regensburg
dortmund	dortmund
aktion	action
gemälde	peintures
mannheim	mannheim
griechenland	grèce
neustadt	neustadt
leo	leo
ufer	rive
ufer	rivage
anspruch	revendication
angebot	offre
zweifel	doutes
reine	pure
reine	pur
produzent	producteur
township	township
beck	beck
jones	jones
blue	blue
umgeben	entouré
kat	kat
nachweis	détection
net	net
wirkt	agit
hitler	hitler
springer	springer
wiederholt	répète
wiederholt	répété
rainer	rainer
brand	brand
mathematiker	mathématicien
überarbeitet	révisé
operation	opération
publikationen	publications
studie	etude
schließen	fermer
patienten	patients
bernd	bernd
anlagen	equipement
flucht	évasion
abt	abbé
maschinen	machines
verbesserung	amélioration
eventuell	eventuellement
michel	michel
vorkommen	occurrence
sonne	soleil
verboten	interdit
erweiterung	élargissement
virginia	virginie
geschichten	histoires
brown	brown
statistik	statistiques
fälle	cas
weimar	weimar
endlich	enfin
abend	soirée
anne	anne
erfahrungen	expériences
stellvertretender	adjoint
schwere	lourd
schwere	gravité
falle	piège
bay	bay
grab	tombeau
markus	markus
weber	weber
earl	earl
verbindet	lie
getötet	tué
samuel	samuel
methoden	méthodes
williams	williams
ukraine	ukraine
engagement	engagement
mühle	moulin
rolf	rolf
rostock	rostock
bauern	paysans
bauern	fermiers
linz	linz
funktioniert	fonctionne
festung	forteresse
joe	joe
rumänien	roumanie
plätze	places
computer	ordinateur
computer	ordinateurs
grün	vert
marburg	marburg
east	east
einleitung	introduction
nachrichten	nouvelles
kanal	canal
werte	valeurs
entlassen	licencié
damen	dames
oberliga	oberliga
sprach	parlé
sprach	parlait
zitat	citation
krankenhaus	hôpital
publikum	public
dame	dame
diskutieren	discuter
ring	anneau
bestehende	existants
andré	andré
mail	mail
dynastie	dynastie
militär	militaire
militär	militaires
bekommt	obtient
innsbruck	innsbruck
gesang	chant
existenz	existence
braun	brun
giovanni	giovanni
zählte	comptait
ziele	objectifs
anerkennung	reconnaissance
städtischen	urbain
konflikt	conflit
fahrzeug	véhicule
young	young
kandidaten	candidats
kandidaten	candidat
rio	rio
vielzahl	variété
gewalt	violence
interessiert	intéressé
hören	écouter
dokumentation	documentation
krone	couronne
format	format
voll	plein
front	front
gewinn	bénéfice
befördert	promu
umgebaut	reconstruit
merkmale	caractéristiques
abstand	espacement
boston	boston
major	major
beschäftigte	salariés
stephan	stephan
jacob	jacob
bereit	prêt
persönlichkeiten	personnalités
langer	langer
youtube	youtube
venedig	venise
mündung	embouchure
mündung	estuaire
rollen	rôles
beteiligung	participation
alpen	alpes
logo	logo
creek	creek
trier	trèves
träger	porteur
madrid	madrid
halbinsel	péninsule
carolina	carolina
sekunden	secondes
episode	épisode
unterschiedlich	différent
blätter	feuilles
lokalen	locaux
volkszählung	recensement
infos	infos
ton	argile
scott	scott
dach	toit
athen	athènes
bgcolor	bgcolor
sitze	sièges
potsdam	potsdam
besucher	visiteurs
mailand	milan
schritt	étape
arbeiter	ouvriers
real	real
kardinal	cardinal
führer	guide
oberfläche	surface
analyse	analyse
organisiert	organisé
organisiert	organisée
streit	querelle
streit	dispute
koch	cuisinier
ausstellungen	expositions
roger	roger
tempel	temple
bearbeitung	usinage
erfahrung	expérience
carlos	carlos
denken	penser
breslau	wrocław
abgelehnt	refusé
laufen	courir
dörfer	villages
bill	bill
brief	lettre
ben	ben
ermöglichen	permettre
forum	forum
fahren	conduire
physiker	physicien
preise	prix
preise	tarifs
philosoph	philosophe
goldenen	doré
times	times
oliver	oliver
diplomat	diplomate
wissenschaftler	scientifiques
malerei	peinture
gewicht	poids
erhöht	augmente
absolut	absolument
who	oms
glück	bonheur
gitarre	guitare
series	series
patrick	patrick
rechtsanwalt	avocat
umwelt	environnement
ingenieur	ingénieur
manager	gestionnaire
manager	manager
senat	sénat
reisen	voyage
rundfunk	radiodiffusion
hoffmann	hoffmann
zugänglich	accessible
reinhard	reinhard
din	din
erinnerung	souvenir
urteil	verdict
urteil	jugement
botschafter	ambassadeur
drehbuchautor	scénariste
eingefügt	inséré
marx	marx
moritz	moritz
fdp	fdp
road	road
media	media
üblichen	habituel
üblichen	habituels
bauen	construire
filmografie	filmographie
that	that
auge	oeil
katharina	catherine
geburt	naissance
systeme	systèmes
america	america
rose	rose
feuer	feu
prüfung	essai
vergessen	oublié
vergessen	oublier
distrikt	district
iso	iso
bestanden	insisté
gedreht	tourné
behauptet	prétend
irland	irlande
pennsylvania	pennsylvanie
eugen	eugen
kunden	clients
himmel	ciel
hundert	cent
mike	mike
adresse	adresse
eingang	entrée
eva	eva
western	western
green	green
anhänger	remorque
columbia	columbia
betreibt	exploite
kontext	contexte
sichtbar	visible
blues	blues
details	détails
info	info
herrscher	souverains
planung	planification
wirtschaftlichen	économique
komponisten	compositeurs
victor	victor
anscheinend	apparemment
hängt	dépend
henri	henri
partner	partenaires
zustimmung	consentement
jörg	jörg
masse	masse
chris	chris
nationen	nations
test	test
harald	harald
unterstützen	soutenir
francis	francis
bundeswehr	bundeswehr
anforderungen	exigences
schützen	protéger
verhaftet	arrêté
web	web
übernahme	rachat
florida	floride
ausgaben	dépenses
kommunikation	communication
gebrauch	utilisation
gebrauch	utilisations
dauer	durée
bewusst	consciemment
bewusst	délibérément
roland	roland
geist	esprit
della	della
katalog	catalogue
vii	vii
argentinien	argentine
episoden	épisodes
siegfried	siegfried
gezogen	tiré
verkauf	ventes
verkauf	vente
play	play
positiv	positif
positiv	positifs
wohnung	appartement
bass	basse
bass	bass
schreib	ecris
herzogtum	duché
erfurt	erfurt
goethe	goethe
master	master
posten	poste
ideen	idées
gedanken	pensées
bergen	bergen
veranstaltung	événement
ließen	laissaient
hinten	arrière
verletzt	blessé
krankheit	maladie
unser	notre
jung	jeune
johnson	johnson
jesus	jésus
via	via
königsberg	königsberg
getragen	portés
getragen	porté
transport	transport
flügel	ailes
rezeption	réception
baum	arbre
abhängig	dépendant
steve	steve
ohio	ohio
maximilian	maximilien
mario	mario
wahrheit	vérité
istanbul	istanbul
uwe	uwe
bildeten	formaient
unabhängigkeit	indépendance
gipfel	sommets
pop	pop
beeinflusst	influencé
vermeiden	éviter
vermeiden	eviter
bauer	bauer
rosa	rosa
bundes	fédéral
verständnis	compréhension
luxemburg	luxembourg
abgerissen	arraché
extrem	extrême
extrem	extrêmement
ford	ford
begleitet	accompagné
viertel	quartier
pläne	plans
victoria	victoria
unklar	imprécis
erworben	acquis
fakten	faits
trennung	séparation
budapest	budapest
charlotte	charlotte
uss	uss
aufmerksam	attentif
kommando	commandement
little	little
vorteil	avantage
schöne	belle
oldenburg	oldenburg
geblieben	resté
geblieben	restée
gerät	appareil
gerät	périphérique
berge	montagnes
wilson	wilson
einstellung	recrutement
varianten	variantes
bielefeld	bielefeld
verbessert	améliore
altar	autel
tief	profond
california	california
utc	utc
zeitschriften	périodiques
illinois	illinois
chronik	chronique
fach	cloison
enzyklopädische	encyclopédique
identisch	identique
aussehen	apparence
gefängnis	prison
gesucht	recherché
regionalliga	regionalliga
drama	drame
marc	marc
beigesetzt	inhumé
maschine	machine
highway	highway
renaissance	renaissance
sturm	tempête
bord	bord
umstritten	controversé
prinzessin	princesse
geschwindigkeit	vitesse
bob	bob
exemplare	spécimens
davis	davis
ausgestrahlt	diffusé
bernard	bernard
jerusalem	jérusalem
kino	cinéma
übergang	transition
ball	ball
ball	ballon
woiwodschaft	voïvodie
lernen	apprendre
tunnel	tunnel
tunnel	tunnels
provinzen	provinces
marcus	marcus
minute	minute
verteilt	distribué
effekt	effet
gefallen	tombé
massachusetts	massachusetts
griechisch	grec
ausstattung	equipements
great	great
stockholm	stockholm
gelegen	situé
produkt	produit
porträt	portrait
vorgänger	prédécesseur
autobahn	autoroute
chemiker	chimiste
gestern	hier
umgewandelt	converti
ansatz	approche
taylor	taylor
vorlagen	modèles
flagge	drapeau
italienisch	italien
schottland	écosse
leipziger	leipziger
verteidigung	défense
finnland	finlande
mauer	mur
redaktion	rédaction
strukturen	structures
überall	partout
gelb	jaune
nachfolge	succession
absatz	paragraphe
arrondissement	arrondissement
feuerwehr	pompiers
leichtathletik	athlétisme
golden	golden
integriert	intégrée
integriert	intégré
spuren	traces
schwierig	difficile
benjamin	benjamin
angeschlossen	branché
konzert	concert
verfügte	disposait
milliarden	milliards
beobachtet	observée
beobachtet	observé
gang	gang
last	charge
last	last
runs	runs
tirol	tyrol
eingeweiht	inauguré
verhandlungen	négociations
beinhaltet	comprend
beinhaltet	inclut
claude	claude
zdf	zdf
tony	tony
schaden	dommages
schaden	dégâts
iran	iran
seen	lacs
feste	fêtes
kabinett	cabinet
vorpommern	vorpommern
normalerweise	habituellement
normalerweise	normalement
assistent	assistant
warten	attendre
andrew	andrew
data	data
douglas	douglas
beginnen	commencer
koblenz	coblence
becker	becker
flotte	flotte
flugzeug	avion
server	serveurs
server	serveur
kritisiert	critiqué
angst	peur
angst	anxiété
konzerte	concerts
zweites	deuxième
erwin	erwin
bochum	bochum
bearbeiten	édition
ausdrücklich	expressément
legende	légende
box	boîte
preußische	prussienne
besatzung	équipage
game	game
botschaft	ambassade
leisten	moulures
technisch	techniquement
uni	uni
typische	typiques
flora	flore
sätze	phrases
paderborn	paderborn
night	night
museen	musées
indischen	indien
symbol	symbole
symbol	icône
eric	eric
verfügbar	disponible
brüssel	bruxelles
verlängerung	prolongation
ermordet	assassiné
parameter	paramètre
reduziert	réduit
gegenstand	objet
wollten	voulaient
unterschiede	différences
engel	ange
angepasst	adapté
lokomotiven	locomotives
stationen	stations
auftritte	apparitions
warschau	varsovie
fertig	fini
haltung	attitude
phil	phil
höhepunkt	apogée
nhl	nhl
nachkommen	descendants
liter	litres
liter	litre
andrea	andrea
vorgeschlagen	suggéré
kindheit	enfance
erhebung	enquête
wind	vent
bundesstraße	bundesstraße
weiler	weiler
gezählt	comptés
wächst	pousse
chile	chili
lewis	lewis
out	out
synagoge	synagogue
ausgeschlossen	exclu
wild	wild
wild	sauvage
jackson	jackson
unterteilt	subdivisé
analog	analogique
lokale	local
aufgegeben	abandonné
long	long
szenen	scènes
böhmen	bohême
islam	islam
oberst	colonel
nation	nation
präsentiert	présente
präsentiert	présenté
haut	peau
modern	moderne
ray	ray
schwierigkeiten	difficultés
eigentümer	propriétaires
eigentümer	propriétaire
bedingt	conditionnel
gefördert	promu
gabriel	gabriel
beschädigt	endommagé
neutral	neutre
pommern	poméranie
schwerin	schwerin
christen	chrétiens
saale	saale
gearbeitet	travaillé
hoffnung	espoir
stephen	stephen
class	class
lösen	résoudre
ausgebildet	formés
ausgebildet	formé
valign	valign
erbe	patrimoine
plötzlich	soudain
regional	regional
nassau	nassau
ecke	coin
ruhestand	retraite
sophie	sophie
buchstaben	lettres
brauchen	besoin
sonntag	dimanche
arena	arena
christus	christ
verlust	perte
verlängert	prolonge
verlängert	prolongé
heilbronn	heilbronn
null	zéro
law	law
bezeichnungen	dénominations
entsprechen	correspondent
entsprechen	correspondre
uefa	uefa
gräfin	comtesse
duisburg	duisburg
singles	célibataires
blut	sang
ersetzen	remplacer
erzählung	récit
pseudonym	pseudonyme
lat	lat
bremer	bremer
ausführung	exécution
mord	meurtre
power	power
jäger	chasseur
berichte	rapports
ruhr	ruhr
carlo	carlo
oskar	oskar
tourismus	tourisme
vogel	oiseau
fassade	façade
sprint	sprint
norbert	norbert
lady	lady
abtei	abbaye
saarbrücken	sarrebruck
adler	aigle
ursache	cause
zerstörung	destruction
beschreiben	décrire
kathedrale	cathédrale
luis	luis
stahl	acier
rené	rené
entscheidungen	décisions
besucht	visité
zugelassen	agréé
zugelassen	admis
wuppertal	wuppertal
georges	georges
horn	corne
horn	cor
mount	mont
institutionen	institutions
konsens	consensus
sydney	sydney
geräte	appareils
geräte	périphériques
schnitt	coupe
ali	ali
klassen	classes
ibn	ibn
partien	lots
nrw	nrw
geleitet	dirigé
abstieg	descente
ämter	offices
space	space
umgekehrt	inversé
anthony	anthony
brian	brian
asien	asie
pianist	pianiste
country	country
old	old
blatt	feuille
urkunde	acte
hildesheim	hildesheim
geschlagen	battu
bekanntheit	notoriété
programme	programmes
free	free
marathon	marathon
demokratie	démocratie
geschlecht	sexe
town	town
gießen	verser
aufgeteilt	réparti
kopenhagen	copenhague
rücktritt	démission
summe	somme
rektor	recteur
ändert	change
jersey	jersey
solo	solo
osnabrück	osnabrück
antworten	réponses
witwe	veuve
hart	dur
hart	hart
zeichnungen	dessins
gerd	gerd
reserve	réserve
kräfte	forces
kim	kim
year	year
bewertung	évaluation
jugendliche	jeunes
genf	genève
verdacht	soupçons
verdacht	suspicion
tokio	tokyo
hügel	colline
junior	junior
materialien	matériaux
schau	regarde
obersten	suprême
onkel	tonton
onkel	oncle
end	end
abstimmung	vote
wein	vin
business	business
richtlinien	directives
element	élément
kapitän	capitaine
natürlichen	naturel
fortsetzung	suite
natürliche	naturel
natürliche	naturelle
auseinandersetzungen	affrontements
gewinnt	gagne
ulm	ulm
ard	ard
diplom	diplôme
verfolgung	persécution
motiv	motif
usd	usd
kandidat	candidat
gray	gray
jura	jura
kaiserlichen	impériale
gezwungen	forcé
gezwungen	obligé
abstammung	filiation
berichten	rapporter
johanna	johanna
versorgung	approvisionnement
straßburg	strasbourg
alan	alan
may	may
temperatur	température
komödie	comédie
fans	fans
costa	costa
cm³	cm³
wiederaufbau	reconstruction
hollywood	hollywood
toronto	toronto
aufstand	révolte
ernennung	nomination
engagiert	engagé
bulgarien	bulgarie
gesetze	lois
vorsitzende	présidente
christopher	christopher
philadelphia	philadelphie
verbot	interdiction
vollständige	complète
landgemeinde	gmina
werkstatt	atelier
zellen	cellules
walther	walther
identität	identité
mach	fais
mach	mach
hagen	hagen
fotograf	photographe
stars	stars
dicht	dense
hit	hit
can	can
elbe	elbe
enzyklopädischen	encyclopédiques
champions	champions
kinos	cinémas
miller	miller
alex	alex
verhindert	empêché
brigade	brigade
sed	sed
gitarrist	guitariste
flugzeuge	avions
michigan	michigan
howard	howard
viii	viii
steiermark	styrie
gewinner	gagnants
amerikaner	américain
amerikaner	américains
verzeichnet	énuméré
gesundheit	santé
premiere	premiere
niemals	jamais
marco	marco
lorenz	lorenz
polnisch	polonais
sonstige	autres
unabhängige	indépendant
unabhängige	indépendants
herum	autour
bestimmen	déterminer
hamilton	hamilton
sorgen	soucis
fertigstellung	finalisation
fertigstellung	achèvement
flug	vol
schatten	ombre
dan	dan
project	project
minnesota	minnesota
übersetzer	traducteur
ausgestellt	délivré
ersatz	remplacement
erkennt	détecte
jagd	chasse
volker	volker
typisch	typique
betriebe	exploitations
parks	parcs
argumentation	raisonnement
straßenbahn	tramway
christine	christine
verordnung	règlement
abgeleitet	dérivé
ministerium	ministère
anti	anti
zurückgezogen	retirée
zurückgezogen	retiré
express	express
begriffsklärung	homonymie
german	french
jim	jim
disziplin	discipline
dokumente	documents
lust	envie
einsätze	inserts
orchestra	orchestra
vorname	prénom
florenz	florence
konferenz	conférence
sound	sound
bamberg	bamberg
dokumentiert	documenté
vergleichbar	comparable
lothar	lothar
ausgewählt	sélectionnée
ausgewählt	sélectionné
wille	volonté
clemens	clemens
grafik	graphisme
death	death
tschechoslowakei	tchécoslovaquie
are	are
julia	julia
model	mannequin
sun	sun
datiert	daté
francesco	francesco
motoren	moteurs
klinik	clinique
lippe	lèvre
konstanz	constance
organisierte	organisé
organisierte	organisée
digital	digital
behauptung	allégation
behauptung	affirmation
schicksal	destin
act	act
bibel	bible
verschiebung	décalage
schwestern	sœurs
jahrzehnte	décennies
hubert	hubert
inklusive	incluant
inklusive	inclus
inklusive	compris
harvard	harvard
mengen	quantités
nick	nick
sam	sam
reihenfolge	ordre
conrad	conrad
romane	romans
romane	romane
jap	jap
fusion	fusion
austria	austria
traditionell	traditionnel
integration	intégration
besonderheit	particularité
ips	ips
pedro	pedro
schade	dommage
wiederherstellung	restauration
tim	tim
schlesien	silésie
ablauf	déroulement
ablauf	expiration
news	nouvelles
zimmer	chambres
landrat	landrat
wahrnehmung	perception
abgebrochen	annulé
contra	contra
vereinen	unir
schlagzeuger	batteur
anwendungen	applications
bundestag	bundestag
women	women
dick	dick
ehemann	époux
ehemann	mari
wachsen	grandir
dienten	servaient
eis	glace
griff	poignée
erfinder	inventeur
erfinder	inventeurs
samt	velours
präfektur	préfecture
lehrstuhl	chaire
archäologie	archéologie
freundin	amie
stamm	tribu
stamm	souche
willi	willi
berater	conseiller
qualifiziert	qualifié
jury	jury
formal	formellement
holland	hollande
beruht	repose
geteilt	partagé
gesicht	visage
unfall	accident
atlas	atlas
sterben	mourir
abschnitte	sections
zitiert	cité
einspruch	objection
platte	plaque
eroberung	conquête
sand	sable
scheinen	semblent
index	index
ruine	ruine
championship	championship
ereignis	evénement
monte	monte
wesen	wesen
brauerei	brasserie
zeugen	témoins
roth	roth
gefahren	dangers
philip	philip
dateien	fichiers
slowakei	slovaquie
luther	luther
dfb	dfb
gefärbt	teints
nachtrag	addendum
aufwand	tracas
aufwand	effort
formulierung	formulation
vögel	oiseaux
ursula	ursula
willy	willy
alice	alice
pflanze	plante
hund	chien
hütte	cabane
nachruf	nécrologie
ding	ding
scheinbar	apparemment
jahrgang	millésime
angeordnet	ordonné
exil	exil
soldat	soldat
eigentum	propriété
leer	vide
neapel	naples
entdeckung	découverte
fuchs	renard
verdient	mérite
block	bloc
dokumentarfilm	documentaire
sammeln	recueillir
dauerhaft	permanent
angriffe	attaques
jens	jens
hell	hell
zufällig	aléatoire
ausgewiesen	expulsé
wörterbuch	dictionnaire
nebenfluss	affluent
abgeordnete	députés
aktionen	actions
ralf	ralf
gordon	gordon
niederlagen	défaites
papier	papier
stift	stylo
maurice	maurice
kpd	kpd
wahr	vrai
überzeugt	convaincu
überzeugt	convaincus
missouri	missouri
freundschaft	amitié
stärke	amidon
office	office
elizabeth	elizabeth
sekretär	secrétaire
fred	fred
beenden	quitter
johnny	johnny
testament	testament
dei	dei
abgrenzung	délimitation
arm	bras
samen	graines
kontakte	contacts
glocken	cloches
unterscheidung	distinction
unesco	unesco
peking	pékin
journalisten	journalistes
florian	florian
pflege	soins
durchbruch	percée
gewidmet	dédié
hanau	hanau
corporation	corporation
bene	bene
hochzeit	mariage
kapazität	capacité
formuliert	formulé
kolonie	colonie
studios	studios
hms	hms
ltd	ltd
bbc	bbc
personal	personnel
wissenschaftlich	scientifiquement
netzwerk	réseau
vorwurf	reproche
reihen	séries
neumann	neumann
festschrift	commémorative
technologie	technologie
#aaa	#aaa
wittenberg	wittenberg
nachricht	message
bmw	bmw
ansichten	vues
gefangen	capturé
gefangen	capturés
gregor	grégoire
übernimmt	assume
ausgesprochen	prononcé
statue	statue
extra	extra
gruss	gruss
mythologie	mythologie
axel	axel
abraham	abraham
gestalten	façonner
verzeichnis	répertoire
inhaber	titulaire
therapie	thérapie
synonym	synonyme
historic	historic
demokratische	démocratique
kommentare	commentaires
hahn	coq
hahn	hahn
hahn	robinet
überflüssig	superflu
quasi	quasi
meinungen	opinions
meinungen	avis
flüsse	rivières
kämpfe	combats
million	million
global	global
abenteuer	aventure
haft	détention
jugoslawien	yougoslavie
könige	rois
nato	otan
verkaufen	vendre
beherbergt	abrite
beherbergt	héberge
kreise	cercles
kroatien	croatie
teilnehmen	participer
giuseppe	giuseppe
territorium	territoire
zulassung	agrément
zulassung	immatriculation
kärnten	carinthie
wurzeln	racines
sammlungen	collections
thailand	thaïlande
steine	pierres
racing	racing
entscheidend	crucial
entscheidend	décisif
markiert	marqué
neckar	neckar
gemessen	mesuré
gemessen	mesurée
instrumente	instruments
bischöfe	évêques
verluste	pertes
schwach	faible
two	two
clark	clark
sterne	étoiles
gallen	gallen
vorstellen	imaginer
breisgau	breisgau
benedikt	benoît
erik	erik
einzeln	individuellement
sportler	sportifs
marcel	marcel
ergänzung	complément
enthielt	contenait
erkannt	reconnu
erkannt	détecté
berger	berger
völker	peuples
philippe	philippe
microsoft	microsoft
konkret	concret
konkret	concrètement
fabrik	usine
jahrhunderte	siècles
anmerkung	remarque
qualifizierte	qualifiés
produktionen	productions
linux	linux
tausend	mille
duke	duke
training	entraînement
thüringer	thüringer
orange	orange
tür	porte
syndrom	syndrome
sultan	sultan
zusammensetzung	composition
fliegen	voler
gedicht	poème
fame	fame
mitbegründer	cofondateur
soziologie	sociologie
jimmy	jimmy
schild	bouclier
hartmann	hartmann
explizit	explicitement
explizit	explicite
römer	romains
übertragung	transfert
biologie	biologie
wisconsin	wisconsin
aires	aires
indiana	indiana
anordnung	disposition
anordnung	agencement
glas	verre
mayer	mayer
wladimir	vladimir
kauf	achat
anderson	anderson
atp	atp
these	thèse
prozesse	processus
gelöst	résolu
buenos	buenos
geschätzt	estimée
geschätzt	estimé
waffe	arme
gemeldet	signalé
trugen	portaient
dance	dance
beurteilen	juger
val	val
ice	ice
charlie	charlie
negativ	négatif
senator	sénateur
entworfen	conçu
down	down
turin	turin
verwandt	apparenté
literarische	littéraire
typen	types
adams	adams
begraben	enterré
betreiber	exploitant
betreiber	opérateur
louise	louise
stanley	stanley
url	url
taucht	plonge
nahrung	nourriture
ärzte	médecins
sichern	sauvegarder
hängen	pendre
hängen	accrocher
doktor	docteur
fulda	fulda
verbrechen	crimes
debatte	débat
eisen	fer
seele	âme
becken	bassin
wdr	wdr
realisiert	réalisé
bit	bit
missbrauch	abus
bogen	voûte
bogen	arc
ehrlich	honnête
csu	csu
knoten	nœud
realität	réalité
mercedes	mercedes
campus	campus
wörter	mots
stellvertreter	suppléant
bäume	arbres
napoleon	napoléon
liefern	livrer
what	what
brücken	ponts
wars	wars
unmöglich	impossible
bridge	bridge
dauert	dure
nicolas	nicolas
pferd	cheval
vergleiche	comparaisons
vincent	vincent
lebensraum	habitat
queen	queen
chemnitz	chemnitz
wählen	choisir
intensiv	intensif
intensiv	intense
hinzugefügt	ajouté
övp	övp
hände	mains
akademischen	universitaire
akademischen	académique
beweis	preuve
duo	duo
udssr	urss
graben	creuser
bus	bus
bataillon	bataillon
sarah	sarah
ausschuss	comité
powiat	powiat
winkel	angle
erneuert	renouvelé
ausgerichtet	alignés
ausgerichtet	aligné
bewegt	déplace
nacional	nacional
pferde	chevaux
erinnerungen	souvenirs
steiner	steiner
vorschläge	suggestions
kriterium	critère
lüneburg	lüneburg
admiral	amiral
edgar	edgar
helsinki	helsinki
sabine	sabine
alois	alois
vergleichsweise	comparativement
sportliche	sportive
greifswald	greifswald
wiesen	prairies
edmund	edmund
boris	boris
sag	dis
höhle	grotte
bruce	bruce
palast	palais
wahrscheinlichkeit	probabilité
lyon	lyon
ausrichtung	alignement
magnus	magnus
freiwillige	volontaires
böse	méchant
böse	méchante
manchester	manchester
back	back
serbien	serbie
ontario	ontario
messen	foires
taschenbuch	broché
dirk	dirk
badminton	badminton
geöffnet	ouvert
veränderung	variation
schröder	schröder
zeichner	dessinateur
benz	benz
stirbt	meurt
dasselbe	pareil
spö	spö
grundstück	terrain
modus	mode
schuld	culpabilité
diego	diego
panzer	chars
panzer	tanks
rekord	record
kevin	kevin
ausgesetzt	suspendu
restaurant	restaurant
kurfürst	electeur
fotografie	photographie
luzern	lucerne
restauriert	restauré
jane	jane
theorien	théories
ruth	ruth
cross	cross
his	his
good	good
htm	htm
grau	gris
moore	moore
motive	motifs
krise	crise
billy	billy
pause	pause
glocke	cloche
entsprach	correspondait
schottischen	écossais
perspektive	perspective
lissabon	lisbonne
lokal	local
forscher	chercheurs
forscher	chercheur
phänomen	phénomène
einkommen	revenu
mandat	mandat
bedeckt	couvert
erzbistum	archidiocèse
kansas	kansas
opposition	opposition
dunkel	sombre
verbesserte	amélioré
logik	logique
aufhebung	abrogation
partie	lot
mischung	mélange
stammten	provenaient
streng	strict
streng	stricte
inc	inc
claus	claus
katholisch	catholique
colorado	colorado
botaniker	botaniste
übersetzungen	traductions
kompositionen	compositions
gotha	gotha
vandale	vandale
opera	opera
dichte	densité
verursacht	causé
male	male
gnu	gnu
kopie	copie
verzichtet	renonce
encyclopedia	encyclopedia
danzig	gdansk
experten	experts
ralph	ralph
liberalen	libéraux
normal	normale
normal	normal
besuchen	visiter
alternativ	alternativement
vorübergehend	temporairement
reform	réforme
institution	institution
paulo	paulo
mond	lune
gas	gaz
verwaltet	géré
autos	voitures
austausch	échange
finanzierung	financement
dringend	urgent
überzeugen	convaincre
kommandant	commandant
century	century
stone	stone
töten	tuer
raymond	raymond
gesammelt	collecté
dna	adn
angebaut	cultivé
hammer	marteau
unterbrochen	interrompu
tournee	tournée
takt	tact
glaubt	croit
genehmigung	homologation
ausführlich	détaillé
ausnahmen	exceptions
administrator	administrateur
entwicklungen	développements
verletzung	blessure
roy	roy
gottlieb	gottlieb
girl	girl
spektrum	spectre
erben	héritiers
offiziere	officiers
viktor	viktor
installiert	installé
vorrunde	éliminatoires
marketing	marketing
people	people
wikipedianer	wikipédiens
archäologischen	archéologiques
donald	donald
regelmäßige	régulière
humboldt	humboldt
eier	œufs
eier	oeufs
oslo	oslo
eingeladen	invité
angrenzenden	adjacent
list	list
publizist	publiciste
english	english
pädagoge	pédagogue
light	light
ross	ross
thai	thai
antrieb	propulsion
urban	urban
men	men
jonathan	jonathan
memorial	memorial
gegangen	allé
gestartet	démarré
nelson	nelson
speyer	spire
iowa	iowa
komplex	complexe
bayerischer	bayerischer
australian	australian
finanziert	financé
überraschend	surprenant
zürcher	zurichois
konservativen	conservateurs
schichten	couches
ten	rte
ten	ten
khan	khan
tsv	tsv
regen	pluie
mac	mac
fox	fox
boxer	boxeur
violine	violon
río	río
bell	bell
diss	diss
denis	denis
litauen	lituanie
einfügen	insertion
verbinden	connecter
rtl	rtl
planeten	planètes
platzierung	placement
just	just
verteidiger	défenseur
artillerie	artillerie
family	family
steuern	fiscalité
wolff	wolff
welle	vague
versammlung	assemblée
richtlinie	directive
range	range
sizilien	sicile
fifa	fifa
roma	roma
ablehnung	rejet
zimmermann	zimmermann
kriege	guerres
antragsteller	demandeur
melden	signaler
grafiker	graphiste
nikolai	nikolaï
stock	bâton
mississippi	mississippi
orf	orf
mitgliedschaft	adhésion
insekten	insectes
feat	feat
schulz	schulz
übernahmen	acquisitions
übernahmen	rachats
claudia	claudia
spaß	rigolo
spaß	amusement
vorläufer	précurseur
verlässt	quitte
tennessee	tennessee
gen	gène
gen	gen
widerspruch	contradiction
bedenken	préoccupations
bedenken	inquiétudes
aufenthalt	séjour
komponenten	composants
walker	walker
privat	privé
begegnung	rencontre
erschossen	abattu
var	var
empire	empire
eingezogen	emménagé
hotels	hôtels
susanne	susanne
robin	robin
haushalte	ménages
vertrauen	confiance
bier	bière
baby	bébé
worms	worms
spur	piste
gefeiert	célébré
lieben	aimer
lösungen	solutions
wetter	météo
freitag	vendredi
akzeptiert	accepté
geraten	conseillé
irak	irak
jordan	jordan
ian	ian
überprüfen	vérifier
evolution	evolution
dead	dead
absolute	absolue
absolute	absolute
schwaben	souabe
ausgrabungen	fouilles
kaufen	acheter
forderungen	créances
informatik	informatique
grube	fosse
zeile	ligne
ausgerüstet	équipée
ausgerüstet	équipé
antoine	antoine
arte	arte
zusammenfassung	résumé
gelistet	listé
risiko	risque
zuordnung	affectation
veröffentlichen	publier
standards	standards
cover	pochette
auguste	auguste
philippinen	philippines
lawrence	lawrence
metall	métal
lothringen	lorraine
residenz	résidence
borussia	borussia
geliefert	livré
russell	russell
konstantin	constantin
dialog	dialogue
ann	ann
reinhold	reinhold
gefühl	sensation
montreal	montréal
flugplatz	aérodrome
wachstum	croissance
gäste	invités
passau	passau
qualifizieren	qualifier
vorteile	avantages
ungewöhnlich	inhabituel
gärten	jardins
wolle	laine
berechnung	calcul
videos	vidéos
landgericht	landgericht
kulturen	cultures
platten	plaques
way	way
konflikte	conflits
municipio	municipio
verweisen	renvoyer
haag	haye
helden	héros
öffnen	ouvrir
arbeitgeber	employeur
arbeitgeber	employeurs
jochen	jochen
entscheidet	décide
massiv	massif
australia	australia
schlägt	frappe
pastor	pasteur
erwähnen	mentionner
besonderheiten	particularités
bedeutete	signifiait
mdl	mdl
syrien	syrie
dark	dark
zwanzig	vingt
nasa	nasa
geschäfte	magasins
temperaturen	températures
finnischen	finlandais
fake	fake
bayer	bayer
agnes	agnès
fleisch	viandes
fleisch	viande
moschee	mosquée
zeichnet	dessine
verliert	perd
handball	handball
slalom	slalom
orientiert	orienté
erweitern	élargir
osmanischen	ottoman
limburg	limbourg
human	human
bestellt	commandé
wahrgenommen	perçu
frederick	frederick
beliebt	populaire
fernando	fernando
bayreuth	bayreuth
stuart	stuart
siedler	colons
hot	hot
over	over
inn	dci
gehandelt	agi
anteile	parts
bewohnt	habité
bewohnt	habitée
laden	charger
laden	chargement
bewertet	évalué
weser	weser
kirchlichen	ecclésiastique
guy	guy
nova	nova
zweig	branche
felder	champs
spannung	tension
medium	médium
dave	dave
height	height
achse	essieu
achse	axe
fan	fan
bewegungen	mouvements
christentum	christianisme
fürstentum	principauté
verteidigen	défendre
verletzungen	blessures
triebwagen	automotrices
reaktionen	réactions
schmid	schmid
tobias	tobias
lutz	lutz
continental	continental
facebook	facebook
bedroht	menacé
tisch	table
korrigiert	corrigé
angegriffen	attaqué
huber	huber
reagiert	réagit
body	body
vfl	vfl
faktoren	facteurs
skulpturen	sculptures
sea	sea
banken	banques
coburg	cobourg
geographie	géographie
zeichnung	dessin
kai	kai
kentucky	kentucky
gekauft	acheté
loch	trou
tower	tower
bürgerlichen	civique
busch	buisson
matt	matt
kaserne	caserne
boy	boy
beweisen	prouver
verständlich	compréhensible
pacific	pacific
königliche	royale
langhaus	longère
indianer	indiens
bemerkt	remarqué
ferrari	ferrari
maus	souris
signal	signal
vertrieb	distribution
vertrieb	ventes
edinburgh	edimbourg
peru	pérou
heart	heart
verliebt	amoureux
bibliotheken	bibliothèques
kuba	cuba
stört	gêne
stört	dérange
unnötig	inutile
leichte	légère
organist	organiste
lloyd	lloyd
bruch	rupture
like	like
miss	miss
erhöhen	augmenter
kavallerie	cavalerie
norm	norme
notwendigkeit	nécessité
zulässig	autorisé
engen	serrés
zählten	comptaient
caspar	caspar
leonhard	leonhard
miguel	miguel
verstoß	infraction
half	half
wall	wall
afghanistan	afghanistan
moderator	modérateur
rückgängig	annuler
vereinigt	réunit
vereinigt	unie
adel	noblesse
vize	vice
bat	bat
hubraum	cylindrée
gary	gary
stewart	stewart
ursachen	causes
befreiung	exonération
befreiung	libération
zoll	douanes
hingerichtet	exécuté
hingerichtet	exécutés
zeigten	montraient
about	about
wunder	miracle
wunder	merveilles
bottom	bottom
finger	doigt
sanierung	assainissement
geheimnis	secret
andy	andy
lost	lost
fellow	fellow
java	java
ebenen	niveaux
mountain	mountain
versteckt	caché
schlüssel	clés
schlüssel	clé
katholiken	catholiques
reichstag	reichstag
anbieter	fournisseur
strafe	pénalité
brust	poitrine
zeilen	lignes
gulden	florin
lisa	lisa
angekündigt	annoncé
planet	planète
mozart	mozart
angewandte	appliquée
einflüsse	influences
vorsitz	présidence
traum	rêve
allianz	alliance
pietro	pietro
barock	baroque
universal	universal
cruz	cruz
verstorben	décédé
geologie	géologie
melbourne	melbourne
kolonien	colonies
lausanne	lausanne
klammern	parenthèses
verwandte	connexes
québec	québec
kampagne	campagne
nba	nba
beobachtung	observation
detail	détail
felsen	rochers
arme	pauvre
airlines	airlines
kalender	calendrier
blog	blog
wiederwahl	réélection
erfindung	invention
xii	xii
reichweite	portée
hals	cou
maría	maría
schlösser	châteaux
olympia	olympia
bemühungen	efforts
johan	johan
margaret	margaret
arizona	arizona
franklin	franklin
bde	bde
flüchtlinge	réfugiés
koalition	coalition
comic	comic
skulptur	sculpture
interpretiert	interprété
vermittlung	médiation
seminar	séminaire
substanz	substance
harris	harris
generationen	générations
janeiro	janeiro
vancouver	vancouver
ausrüstung	équipement
ausrüstung	equipement
dreharbeiten	tournage
saal	salle
ronald	ronald
minderheit	minorité
peters	peters
niederländisch	néerlandais
klagenfurt	klagenfurt
kupfer	cuivre
lincoln	lincoln
sandstein	grès
bedeuten	signifier
field	field
marken	marques
studieren	étudier
lasse	lasse
fische	poissons
schiller	schiller
vierter	quatrième
sven	sven
auszug	extrait
kleidung	vêtements
erlaubnis	permission
eingeschränkt	restreint
unterhält	maintient
unterhält	entretient
norman	norman
player	lecteur
atmosphäre	atmosphère
siemens	siemens
mini	mini
ernest	ernest
geprüft	vérifié
kreuzer	croiseur
besaßen	possédaient
son	son
feier	célébration
schäfer	schäfer
rückseite	dos
lokomotive	locomotive
vermutung	conjecture
propaganda	propagande
spalte	colonne
southern	southern
oswald	oswald
report	report
lkw	camions
lkw	camion
verschwinden	disparition
magdalena	magdalena
spenden	dons
earth	earth
boys	boys
mdr	mdr
monarchie	monarchie
bestätigen	confirmer
scharf	épicé
frisch	frais
kelly	kelly
alabama	alabama
dokument	document
loire	loire
audio	audio
schicht	couche
justiz	justice
alberto	alberto
mittelmeer	méditerranée
base	base
faktor	facteur
ermordung	assassinat
connecticut	connecticut
persönlichkeit	personnalité
kaliningrad	kaliningrad
guido	guido
leutnant	lieutenant
xvi	xvi
abbau	démontage
abbau	dégradation
abbau	déplacement
vietnam	vietnam
strategie	stratégie
uruguay	uruguay
einheimischen	autochtones
gruyter	gruyter
liechtenstein	liechtenstein
holocaust	holocauste
siegel	sceau
hamm	hamm
auschwitz	auschwitz
zeitgenössische	contemporain
emma	emma
ernsthaft	sérieusement
krankheiten	maladies
bukarest	bucarest
mans	mans
denkmäler	monuments
maine	maine
entlassung	licenciement
kongo	congo
stämme	tribus
siebten	septième
grob	grossièrement
dialekt	dialecte
philologie	philologie
hofmann	hofmann
grimm	grimm
merkmal	caractéristique
anr	anr
orthodoxen	orthodoxe
orthodoxen	orthodoxes
epoche	époque
rechnung	facture
browser	navigateur
verwiesen	référencé
konsul	consul
stab	barre
draft	draft
rad	roue
götter	dieux
vfb	vfb
lass	laisse
harz	résine
lars	lars
lucas	lucas
schiedsrichter	arbitre
dünn	maigre
dünn	mince
bestimmungen	dispositions
mauern	murs
berechnet	calculé
verlieren	perdre
gefangenschaft	captivité
henning	henning
comics	comics
moon	moon
teufel	diable
leinwand	toile
rugby	rugby
verarbeitet	ouvré
verarbeitet	transformé
riga	riga
kameramann	caméraman
madonna	madonna
roberto	roberto
vorfahren	ancêtres
ressourcen	ressources
laura	laura
zeichnen	dessiner
marianne	marianne
mathias	mathias
rumpf	coque
lyrik	lyrique
belgrad	belgrade
maryland	maryland
abhängigkeit	dépendance
ankunft	arrivée
gerichte	tribunaux
mörder	tueur
mörder	assassin
sofia	sofia
abu	abu
africa	africa
glasgow	glasgow
stürmer	attaquant
heller	heller
emanuel	emanuel
kohle	charbon
graham	graham
caroline	caroline
marokko	maroc
nordischen	nordiques
wrestling	wrestling
ryan	ryan
manga	manga
demo	démo
renault	renault
turner	turner
renoviert	rénové
suhrkamp	suhrkamp
nett	sympa
kreuzung	carrefour
gilbert	gilbert
verschwunden	disparu
ausgang	sortie
estland	estonie
startet	démarre
clara	clara
nad	nad
forest	forest
meißen	meissen
trennen	séparer
sogn	sogn
stralsund	stralsund
spezialisiert	spécialisé
transportiert	transporté
kennedy	kennedy
karin	karin
händler	revendeurs
mönchengladbach	mönchengladbach
durchschnitt	moyenne
singen	chanter
camp	camp
minden	minden
campbell	campbell
mind	mind
beine	jambes
techniken	techniques
asteroiden	astéroïdes
franco	franco
betrachtung	visionnement
überprüfung	vérification
böden	sols
option	option
ägyptischen	égyptien
lukas	lukas
morgan	morgan
ständigen	permanent
porsche	porsche
flecken	taches
japanisch	japonais
sat	sat
fliehen	fuir
fraglich	discutable
steven	steven
parker	parker
empfangen	reçus
empfangen	recevoir
diff	diff
talent	talent
fire	fire
türkisch	turc
nummern	numéros
passagiere	passagers
wusste	savait
theologische	théologique
hanns	hanns
thompson	thompson
konstantinopel	constantinople
henriette	henriette
dichtung	joint
theoretisch	théoriquement
robinson	robinson
decken	couvertures
decken	plafonds
hop	hop
legend	legend
wünsche	souhaits
dennis	dennis
nachbarn	voisins
ernährung	nutrition
ernährung	alimentation
bologna	bologne
vergleichen	comparer
björn	björn
kolumbien	colombie
dublin	dublin
gabriele	gabriele
planck	planck
fantasy	fantasy
springen	saut
aktivität	activité
luigi	luigi
genügt	suffit
gedruckt	imprimé
abteilungen	divisions
abteilungen	départements
störungen	désordres
ken	ken
halbe	demi
louisiana	louisiane
erläutert	expliqué
nachweisbar	indétectable
taiwan	taïwan
sturz	chute
aufzeichnungen	enregistrements
amazon	amazon
teilgenommen	participé
shakespeare	shakespeare
löscht	efface
beantwortet	répondu
labor	laboratoire
samstag	samedi
lehmann	lehmann
classic	classic
med	med
berühmt	célèbre
geehrt	honoré
jonas	jonas
umzug	déménagement
erhöhung	poussée
wüste	désert
adolph	adolph
polizisten	policiers
mhz	mhz
uci	uci
carter	carter
princeton	princeton
latein	latin
atlanta	atlanta
hip	hip
antwerpen	anvers
kaiserslautern	kaiserslautern
invasion	invasion
muhammad	muhammad
northern	northern
julian	julian
nil	nil
selbständige	indépendants
alternativen	alternatives
sant	sant
altenburg	altenburg
abc	abc
schaffung	création
bestritten	contesté
kiew	kiev
hard	hard
faust	poing
vita	vita
unverändert	inchangé
evans	evans
holding	holding
apple	apple
schwanz	queue
fisch	poisson
thron	trône
rapper	rappeur
ozean	océan
konservatorium	conservatoire
redundanz	redondance
senior	senior
more	more
cooper	cooper
rechner	calculatrice
rechner	calculateur
ulmer	ulmer
schubert	schubert
brigitte	brigitte
fränkischen	franconie
barry	barry
neuauflage	réédition
patent	brevet
knochen	os
ack	ack
veb	veb
posen	poznań
rechtlich	juridiquement
wenzel	wenzel
pionier	pionnier
metz	metz
harold	harold
tests	tests
ausgehen	sortir
lebenslauf	cv
alkohol	alcool
gene	gene
gene	gènes
trasse	sillon
silva	silva
bemerkenswert	remarquable
produzieren	produire
study	study
ehre	honneur
vorwort	préface
vergrößert	agrandi
tropischen	tropicale
miami	miami
shanghai	shanghai
vertretung	représentation
protokoll	protocole
athleten	athlètes
lahn	lahn
baker	baker
wendet	applique
copa	copa
udo	udo
natural	natural
prinzipien	principes
dienstleistungen	services
hansen	hansen
standorte	lieux
standorte	sites
philologe	philologue
erwachsene	adultes
erfunden	inventé
philosophen	philosophes
dicke	épaisseur
han	han
vielfalt	diversité
wettbewerbe	concours
rowohlt	rowohlt
murray	murray
archäologe	archéologue
austin	austin
zelle	cellule
wälder	forêts
schließung	fermeture
indian	indian
echo	echo
kunsthalle	kunsthalle
rüdiger	rüdiger
geschmack	goût
porto	porto
konzentration	concentration
interviews	interviews
wiedervereinigung	retrouvailles
kabel	câbles
have	have
berner	bernois
keramik	céramique
bismarck	bismarck
monika	monika
flensburg	flensburg
pakistan	pakistan
grant	grant
angemeldet	connecté
brasilianischen	brésilienne
löwe	lion
gerechtfertigt	justifié
pädagogik	pédagogie
melodie	mélodie
beratung	conseil
african	african
boeing	boeing
beschäftigung	emploi
externe	externe
orientierung	orientation
mängel	défauts
challenge	challenge
elektronischen	électronique
salvador	salvador
saarland	sarre
dakota	dakota
rache	vengeance
dutzend	douzaines
dutzend	douzaine
egon	egon
utrecht	utrecht
kategorisierung	catégorisation
tiger	tigre
finanziell	financièrement
beamter	fonctionnaire
tiroler	tyrolien
allgemeines	généralités
lichtenberg	lichtenberg
wang	wang
liverpool	liverpool
ringer	lutteur
behauptungen	allégations
behauptungen	affirmations
roll	roll
broadway	broadway
jason	jason
alaska	alaska
aufsteiger	déménageurs
soul	soul
matthew	matthew
plant	plant
floh	puce
helene	hélène
relief	relief
vogt	vogt
angela	angela
syn	syn
ruprecht	ruprecht
religionen	religions
freigegeben	libéré
head	head
leonard	leonard
disney	disney
ruinen	ruines
offenbach	offenbach
sky	sky
köhler	köhler
vision	vision
jorge	jorge
kilogramm	kilogrammes
kilogramm	kilogramme
messung	mesure
bassist	bassiste
schwert	épée
elsass	alsace
schlagen	battre
schlagen	frapper
phoenix	phoenix
italia	italia
eisenach	eisenach
gewerkschaft	syndicat
touristen	touristes
oregon	oregon
christina	christina
rks	rks
normen	normes
erkrankungen	affections
agentur	agence
iwan	ivan
schreiber	schreiber
blüte	floraison
punk	punk
dell	dell
digitalen	numérique
joan	joan
bremerhaven	bremerhaven
tabellen	tableaux
überprüft	vérifié
wls	wls
wahlperiode	législature
einladung	invitation
slowenien	slovénie
gesungen	chanté
jerry	jerry
türken	turcs
hawaii	hawaii
jules	jules
akademische	académique
mine	mine
überleben	survie
gelassen	laissé
stimmung	humeur
plante	prévoyait
anpassung	personnalisation
anpassung	adaptation
flach	plat
entwickler	développeur
entwickler	développeurs
schwedisch	suédois
kostenlos	gratuit
under	under
language	language
freude	joie
prototyp	prototype
rotterdam	rotterdam
effekte	effets
gletscher	glacier
offs	offs
erzähler	narrateur
operationen	opérations
homburg	homburg
montana	montana
wayne	wayne
dessau	dessau
erobert	conquis
klöster	monastères
anfänge	débuts
kaiserin	impératrice
meier	meier
morris	morris
größen	tailles
dnb	dnb
petra	petra
geometrie	géométrie
bosnien	bosnie
now	now
zerstörer	destructeur
wright	wright
movie	movie
independent	independent
alpha	alpha
studiert	étudié
berkeley	berkeley
illustrationen	illustrations
richtungen	directions
schnee	neige
gerald	gerald
realschule	realschule
angel	angel
funk	funk
herrmann	herrmann
troll	troll
mythos	mythe
schumacher	schumacher
tenor	ténor
sin	sin
begangen	commis
ansätze	approches
designer	designer
wirft	jette
wirft	soulève
möge	puisse
fühlt	ressent
türen	portes
valentin	valentin
begegnungen	rencontres
brandt	brandt
oklahoma	oklahoma
gerettet	sauvé
ignoriert	ignoré
überwachung	surveillance
chinesisch	chinois
gerechtigkeit	justice
bett	lit
vorarlberg	vorarlberg
dynamo	dynamo
drehen	tourner
angeben	préciser
angeben	spécifier
venezuela	venezuela
astronom	astronome
nina	nina
theoretische	théorique
ingrid	ingrid
industriellen	industriel
krüger	krüger
umwandlung	conversion
rosenberg	rosenberg
chaos	chaos
xaver	xaver
regelmäßigen	régulier
zoo	zoo
bezahlt	payé
cornelius	cornelius
bobby	bobby
interne	internes
interne	interne
imo	omi
käfer	coccinelle
gem	gem
weihnachten	noël
dekan	doyen
häftlinge	détenus
russen	russes
basilika	basilique
zyklus	cycle
konzepte	concepts
ndr	ndr
heiliger	saint
tendenz	tendance
garcía	garcía
orleans	orleans
österreicher	autrichiens
eddie	eddie
vorbereitet	préparé
landschaften	paysages
years	years
baltimore	baltimore
kannte	connaissait
fotografen	photographes
mund	bouche
inkl	inc
berthold	berthold
löst	résout
xiv	xiv
reformen	réformes
sklaven	esclaves
weinbau	viticulture
griechen	grecs
fair	fair
scheitern	échec
spitzen	bouts
spitzen	extrémités
mohammed	mohammed
arkansas	arkansas
indonesien	indonésie
reagieren	réagir
bedingung	condition
paolo	paolo
ethik	éthique
britisch	britannique
entdecken	découvrir
gestapo	gestapo
badischen	badoise
marshall	marshall
handwerk	artisanat
most	most
gütersloh	gütersloh
houston	houston
adrian	adrian
reichlich	abondant
kaffee	café
gedenkstätte	mémorial
agent	agent
zagreb	zagreb
fokus	focus
verbesserungen	améliorations
schien	semblait
grey	grey
krakau	cracovie
gesendet	envoyé
zypern	chypre
jeff	jeff
geezer	geezer
zwang	contrainte
germania	germania
komplexe	complexes
our	our
truppe	troupe
hut	chapeau
milch	lait
kommerziellen	commercial
jon	jon
schmitt	schmitt
hills	hills
baptist	baptist
beeinflussen	influencer
bug	bug
india	india
meilen	miles
wta	wta
freizeit	loisirs
gera	gera
motorrad	moto
lutherische	luthérienne
peer	peer
wellen	vagues
maßstab	échelle
philosophische	philosophique
burgund	bourgogne
partnerschaft	partenariat
erfordert	nécessite
pauli	pauli
brot	pain
xiii	xiii
marseille	marseille
hugh	hugh
chen	chen
leon	leon
duden	duden
beethoven	beethoven
mönche	moines
krefeld	krefeld
tommy	tommy
ungarisch	hongrois
rgb	rvb
rgb	rgb
görlitz	görlitz
glatt	lisse
beauftragte	déléguée
erwerb	acquisition
run	run
anime	anime
olaf	olaf
bewusstsein	conscience
berufliche	professionnelle
apostolischen	apostolique
porträts	portraits
avenue	avenue
let	let
kunstverein	kunstverein
small	small
schumann	schumann
remix	remix
trikot	maillot
lorenzo	lorenzo
gescheitert	échec
renate	renate
masters	masters
tschechisch	tchèque
angebote	offres
zugewiesen	attribué
zugewiesen	assigné
reifen	pneus
wolfram	tungstène
roberts	roberts
hirsch	cerf
augsburger	augsburger
speicher	mémoire
nancy	nancy
verwechseln	confondre
hunter	hunter
get	get
krieger	guerrier
umstände	circonstances
systematisch	systématiquement
eichstätt	eichstätt
eastern	eastern
selbstverlag	selbstverlag
delta	delta
armin	armin
brockhaus	brockhaus
ivan	ivan
erwünscht	souhaitée
konzentriert	concentré
edwin	edwin
kent	kent
matthäus	matthieu
bond	bond
aluminium	aluminium
dimension	dimension
schönheit	beauté
sauerstoff	oxygène
mitchell	mitchell
marion	marion
rasse	race
ingolstadt	ingolstadt
geäußert	exprimé
zähne	dents
cottbus	cottbus
gültig	valide
gültig	valable
sri	sri
systematische	systématique
denkbar	concevable
denkbar	imaginable
satelliten	satellites
umgehen	contourner
symbole	symboles
symbole	icônes
germanischen	germanique
theo	theo
medaillen	médailles
abbruch	démolition
spannungen	tensions
bricht	casse
sony	sony
sechste	sixième
empfohlen	recommandé
bundesautobahn	bundesautobahn
five	five
frühling	printemps
romanischen	romane
raf	raf
akzeptieren	accepter
gräber	tombes
ansbach	ansbach
renovierung	rénovation
collins	collins
übersehen	négligé
terry	terry
gleichung	équation
sockel	socle
schulze	schulze
traditionen	traditions
dehio	dehio
behauptete	revendiquée
flag	flag
hunde	chiens
krebs	cancer
energy	energy
unit	unit
fett	graisse
anzeigen	afficher
anzeigen	annonces
alain	alain
blättern	défilement
angetrieben	actionné
wiederholen	répéter
astronomie	astronomie
decke	plafond
achim	achim
wohnt	habite
schritte	étapes
dominiert	dominé
geschafft	réussi
michail	mikhaïl
linden	linden
ulrike	ulrike
nicholas	nicholas
palästina	palestine
wilfried	wilfried
eingeleitet	initié
beobachter	observateur
beobachter	observateurs
bilanz	bilan
medical	medical
fürth	fürth
indirekt	indirect
indirekt	indirectement
mtv	mtv
alias	alias
bestätigung	confirmation
mühlen	moulins
wiederherstellen	restaurer
massaker	massacre
suffix	suffixe
rudolph	rudolph
woman	woman
matrix	matrice
ähnlichkeit	similitude
ähnlichkeit	ressemblance
empfehlung	recommandation
bedrohung	menace
vollendet	accomplie
landung	atterrissage
vornamen	prénoms
dallas	dallas
offensive	offensive
fein	finement
pole	pole
herman	herman
besiegt	vaincu
krause	krause
entwürfe	brouillons
schwimmen	natation
early	early
abkürzungen	abréviations
protest	protestation
messina	messine
kosovo	kosovo
delegation	délégation
färbung	coloration
water	water
pest	peste
genehmigt	approuvé
universum	univers
biathlon	biathlon
wärme	chaleur
ordentlichen	ordinaire
korrigieren	corriger
moor	moor
erfüllung	accomplissement
schach	échecs
ward	ward
breitengrad	latitude
commonwealth	commonwealth
hohenzollern	hohenzollern
malta	malte
sitzung	réunion
bolivien	bolivie
nrhp	nrhp
wood	wood
seoul	séoul
verpflichtung	engagement
leiche	cadavre
warner	warner
verträge	contrats
abschied	adieux
perfekt	parfait
kommunisten	communistes
ngc	ngc
definieren	définir
augustin	augustin
gotischen	gothique
organ	organe
konto	compte
inhaftiert	emprisonné
busse	autobus
mineral	minéral
work	work
holger	holger
dream	dream
aktien	actions
grammatik	grammaire
lustig	drôle
landshut	landshut
silver	silver
upper	upper
filter	filtres
hölle	enfer
beat	beat
meta	meta
geh	va
mönch	moine
befreien	libérer
umgestaltet	transformant
ausgeschieden	éliminés
popularität	popularité
oberhausen	oberhausen
laurent	laurent
wolfenbüttel	wolfenbüttel
konsequenzen	conséquences
rechtsprechung	jurisprudence
bakterien	bactéries
martha	martha
pan	pan
übersetzen	traduire
erhard	erhard
hunderte	centaines
börse	bourse
kings	kings
taunus	taunus
genua	gênes
hours	hours
cook	cook
juristen	juristes
rum	rhum
sekunde	seconde
warren	warren
erzählen	raconter
nigeria	nigeria
its	its
orient	orient
gespeichert	stocké
christiane	christiane
paare	couples
blood	blood
set	set
protagonisten	protagonistes
störung	désordre
administratoren	administrateurs
gelernt	appris
gefüllt	rempli
auslegung	interprétation
haushalt	ménage
haushalt	budget
marschall	maréchal
installation	installation
kaspar	kaspar
ecken	coins
speichern	enregistrer
schuss	tir
freundlich	sympathique
freundlich	amical
zylinder	cylindre
vorschlagen	suggérer
portugiesisch	portugais
wähler	électeurs
wähler	électeur
reduzieren	réduire
fotografien	photographies
days	days
nachteil	inconvénient
gramm	gramme
gramm	grammes
abgekürzt	abrégé
begleitung	accompagnement
wiederholte	répété
chancen	opportunités
gastgeber	hôte
kämpfer	combattant
charlottenburg	charlottenburg
blumen	fleurs
wünschen	souhaiter
venus	venus
venus	vénus
schema	schéma
alexandra	alexandra
split	split
unruhen	émeutes
rosen	roses
keith	keith
beigetragen	contribué
fis	fis
renommierten	prestigieux
tante	tatie
einstellungen	paramètres
einstellungen	préférences
meisterin	championne
nazi	nazi
pfarrhaus	presbytère
hudson	hudson
fdl	fdl
diktatur	dictature
nase	nez
ebert	ebert
finanzen	finances
jungfrau	vierge
fresken	fresques
brooklyn	brooklyn
tel	tél
herder	herder
eiförmig	ovoïde
heine	heine
teilchen	particules
kong	kong
achtung	attention
buddhismus	bouddhisme
zufall	hasard
zufall	coïncidence
jay	jay
massive	massive
salz	sel
monaco	monaco
guillaume	guillaume
export	export
export	exportation
kollege	collègue
naval	naval
helen	helen
bretagne	bretagne
railroad	railroad
normandie	normandie
larry	larry
ghana	ghana
yale	yale
administrativ	administrativement
there	there
regierungen	gouvernements
besserung	rétablissement
deep	deep
manhattan	manhattan
friedrichs	friedrichs
urlaub	vacances
neffe	neveu
plural	pluriel
baptiste	baptiste
julie	julie
oldid	oldid
inspiriert	inspiré
rafael	rafael
regina	regina
feind	ennemi
niedergang	déclin
schauspielhaus	schauspielhaus
fortschritt	progrès
teich	étang
untersuchte	examiné
track	track
dachau	dachau
sms	sms
anatomie	anatomie
strauss	strauss
raketen	missiles
steuer	impôt
bull	bull
irene	irene
irene	irène
aussterben	extinction
aussprache	prononciation
perry	perry
aufgeben	abandonner
synthese	synthèse
vermieden	évité
montag	lundi
kurve	courbe
rettung	sauvetage
fotografiert	photographié
ems	ems
empfänger	destinataire
iucn	uicn
edith	edith
gewerkschaften	syndicats
beton	béton
santo	santo
playoffs	playoffs
jünger	disciples
glücklich	heureux
demokraten	démocrates
rakete	fusée
rakete	missile
ausgleich	compensation
wallace	wallace
kapital	capitaux
kapital	capital
unverständlich	incompréhensible
abschaffung	abolition
helena	helena
increment	increment
moses	moïse
champion	champion
singapur	singapour
pablo	pablo
mülheim	mülheim
toulouse	toulouse
muslime	musulmans
heyne	heyne
tatsächlichen	effectif
miles	miles
christlich	chrétien
ellen	ellen
zitate	citations
arno	arno
namensgeber	éponyme
bemerkungen	remarques
cleveland	cleveland
santos	santos
gefangene	prisonniers
geiger	violoniste
freud	freud
minor	minor
god	god
situationen	situations
piper	piper
algerien	algérie
kanzler	chancelier
kanzler	greffier
provence	provence
jülich	juliers
kanonen	canons
verwaltungsgemeinschaft	verwaltungsgemeinschaft
streitigkeiten	litiges
kenneth	kenneth
asia	asia
passagen	passages
franziska	franziska
newton	newton
aufführungen	spectacles
katastrophe	catastrophe
mdb	mdb
formulierungen	formulations
charaktere	personnages
summer	summer
lords	lords
neutralität	neutralité
after	after
ignaz	ignaz
true	true
quartett	quatuor
flandern	flandre
viola	viola
bristol	bristol
waldeck	waldeck
namibia	namibie
political	political
verteilen	distribuer
univ	univ
salomon	salomon
litt	litt
erika	erika
konvention	convention
haase	haase
atlantik	atlantique
zusammenbruch	effondrement
gewählte	élus
marina	marina
sauber	propre
when	when
flöte	flûte
düren	düren
forstwirtschaft	sylviculture
ideologie	idéologie
herzogin	duchesse
metropolitan	metropolitan
harrison	harrison
diana	diana
nazis	nazis
ron	ron
landwirt	agriculteur
heilig	sacré
malaysia	malaisie
augustus	augustus
strahlung	rayonnement
vera	vera
substanzen	substances
internen	internes
internen	interne
alexandria	alexandrie
ergänzungen	compléments
ergänzungen	suppléments
psychiatrie	psychiatrie
ohren	oreilles
labour	labour
labour	travailliste
labour	travaillistes
ruft	appelle
bösen	méchants
trennt	sépare
bush	bush
variiert	varie
vorherige	précédente
vorherige	précédent
bordeaux	bordeaux
erscheinungsbild	apparence
elite	élite
ostfriesland	ostfriesland
elias	elias
astronomen	astronomes
vertraut	familier
abwesenheit	absence
bibliographie	bibliographie
rallye	rallye
willkommen	bienvenue
kraus	kraus
bezahlen	payer
einstein	einstein
motivation	motivation
faz	faz
ungeeignet	inapte
apostel	apôtre
amphoe	amphoe
mrs	mrs
islamische	islamique
spalten	colonnes
wolfsburg	wolfsburg
singer	singer
widmen	consacrer
widmen	dédier
aufsicht	supervision
middle	middle
ancient	ancient
feder	plume
ausgegeben	dépensé
eurovision	eurovision
prima	prima
winkler	winkler
match	match
repräsentiert	représente
erneuerung	renouvellement
firefox	firefox
colin	colin
phasen	phases
kombiniert	combiné
kombiniert	combinés
brecht	brecht
olga	olga
reichsbahn	reichsbahn
het	het
gezeichnet	dessiné
gefühle	sentiments
atlantic	atlantic
steffen	steffen
anhang	annexe
schulden	dette
barth	barth
naturforscher	naturaliste
nebel	brouillard
carmen	carmen
ffffff	ffffff
codex	codex
turniere	tournois
endgültigen	définitif
endgültigen	définitifs
león	león
caesar	caesar
caesar	césar
hedwig	edwige
susan	susan
exemplar	exemplaire
veit	veit
analysen	analyses
treppe	escalier
winterthur	winterthur
oberpfalz	oberpfalz
holmes	holmes
dramatiker	dramaturge
ware	marchandise
antisemitismus	antisémitisme
kantone	cantons
heck	heck
stolz	fier
stolz	fierté
leverkusen	leverkusen
göttin	déesse
electric	electric
stärken	atouts
schweigen	silence
elektronik	electronique
revision	révision
helga	helga
instanz	instance
geologe	géologue
witz	blague
munition	munitions
aschaffenburg	aschaffenburg
vegas	vegas
neil	neil
kramer	kramer
utah	utah
trek	trek
brett	planche
unterhaltung	divertissement
allan	allan
gutenberg	gutenberg
kosmos	cosmos
kontinent	continent
castro	castro
götz	götz
happy	happy
föderation	fédération
reg	reg
haas	haas
symptome	symptômes
hopkins	hopkins
unwahrscheinlich	improbable
jahn	jahn
nfl	nfl
rohr	tube
danny	danny
maier	maier
dean	dean
ringe	bagues
ringe	anneaux
gross	gross
albanien	albanie
angreifer	attaquant
valencia	valence
unterzeichnet	signé
toni	toni
emden	emden
schlachten	batailles
marmor	marbre
kant	kant
katze	chat
brd	rfa
judith	judith
erweiterungen	extensions
adalbert	adalbert
bedeutungen	significations
teatro	teatro
lok	lok
justus	justus
monster	monstre
call	call
landau	landau
statistiken	statistiques
works	works
pos	pos
sorten	variétés
liberal	libéral
march	march
paula	paula
alb	alb
cape	cape
hampshire	hampshire
landen	atterrir
stanford	stanford
historia	historia
senioren	seniors
imdb	imdb
fußballer	footballeur
rudi	rudi
nah	proche
ludwigshafen	ludwigshafen
limited	limited
höhlen	grottes
äthiopien	ethiopie
harten	dures
birmingham	birmingham
kopieren	copier
waldemar	basile
heidelberger	heidelberger
hob	ramassé
gestanden	avoué
alba	alba
verstärkte	renforcée
zucker	sucre
ida	ida
winfried	winfried
anregung	suggestion
byzantinischen	byzantine
singt	chante
gisela	gisela
short	short
sigmund	sigmund
gelebt	vécu
haare	cheveux
battle	battle
nicole	nicole
transkription	transcription
lucius	lucius
abzug	déduction
verziert	décoré
circle	circle
präsentation	présentation
zwickau	zwickau
getreide	céréales
sigismund	sigismond
fpö	fpö
sozialismus	socialisme
temple	temple
doris	doris
fehlte	manquait
madison	madison
magic	magic
respekt	respect
zentren	centres
tambon	tambon
büros	bureaux
deportiert	déportés
rundschau	rundschau
angekommen	arrivé
erläuterungen	explications
only	only
audi	audi
gesetzliche	légal
gesetzliche	légale
tipp	astuce
tödlich	mortel
freiburger	fribourgeoise
geworfen	jeté
zufrieden	satisfait
widerspricht	contredit
veraltet	obsolète
bozen	bolzano
butler	butler
knight	knight
ethnien	ethnies
vegetation	végétation
gehirn	cerveau
born	born
säule	pilier
empfehlen	recommander
armstrong	armstrong
into	into
dauern	durer
dauern	durent
isaac	isaac
ludwigsburg	ludwigsburg
humor	humour
meiningen	meiningen
montiert	monté
emmy	emmy
hannes	hannes
messer	couteau
brt	tjb
friederike	friederike
legion	légion
ergo	ergo
aristoteles	aristote
gladbach	gladbach
padding	padding
expansion	expansion
sakristei	sacristie
side	side
schlag	frappe
industrialisierung	industrialisation
igor	igor
vernunft	raison
freising	freising
zensur	censure
nachteile	inconvénients
dreieck	triangle
gepflegt	soigné
intelligenz	intelligence
pol	pol
entkommen	échapper
senkrecht	verticalement
senkrecht	vertical
mediawiki	mediawiki
gekürzt	écourtée
experte	expert
verantwortlichen	responsables
aufgerufen	appelé
pmid	pmid
augusta	augusta
warte	attends
skandal	scandale
bauch	ventre
bauch	abdomen
fördert	favorise
logos	logos
blockiert	bloqué
bankier	banquier
low	low
seattle	seattle
grundsatz	principe
fünfter	cinquième
apsis	abside
fände	trouverait
bio	bio
begeistert	enthousiaste
theologen	théologiens
watson	watson
their	their
iris	iris
burgenland	burgenland
quedlinburg	quedlinburg
wiese	prairie
seltsam	étrange
labels	libellés
überzeugung	persuasion
überzeugung	conviction
gasse	ruelle
ältester	aîné
bergisch	bergisch
nannten	appelaient
treu	fidèle
nachdenken	réfléchir
kunststoff	plastique
angebliche	prétendue
folk	folk
erwartungen	attentes
werkzeug	outil
ibm	ibm
sophia	sophia
unvollständig	incomplet
georgien	géorgie
zerstören	détruire
illustrator	illustrateur
anschlag	attentat
heimlich	secrètement
verletzte	blessés
tus	tus
tempo	tempo
reinhardt	reinhardt
square	square
getestet	testé
cousin	cousin
ungültig	invalide
queensland	queensland
moser	moser
dietz	dietz
jeanne	jeanne
herzegowina	herzégovine
hinzufügen	ajouter
trade	trade
statuen	statues
verehrt	vénère
armut	pauvreté
libanon	liban
fine	fine
unbrauchbar	inutilisable
protein	protéine
organe	organes
organisieren	organiser
dänisch	danois
betrag	montant
mathilde	mathilde
gran	gran
freiberg	freiberg
blind	aveugle
blind	blind
publishers	publishers
verfehlt	raté
mohr	mohr
böhlau	böhlau
beamte	fonctionnaires
gonzález	gonzález
leidenschaft	passion
glockenturm	clocher
vereinbarung	accord
thriller	thriller
regierte	gouvernait
leiten	diriger
zusammenstellung	compilation
eifel	eifel
amadeus	amadeus
con	con
marien	marien
verhältnismäßig	proportionné
tell	tell
opel	opel
linda	linda
rita	rita
angelo	angelo
martina	martina
aue	aue
brechen	briser
isabella	isabella
arnsberg	arnsberg
künstliche	artificiel
künstliche	artificielle
motorsport	motorsport
gesetzlich	légale
trust	trust
müll	ordures
honda	honda
palermo	palerme
handwerker	artisans
verwandtschaft	parenté
beute	butin
kompromiss	compromis
elektrisch	électrique
münze	pièce
veranstalter	organisateur
rechtschreibung	orthographe
panorama	panorama
professionelle	professionnels
professionelle	professionnel
moral	moralité
tallinn	tallinn
never	never
judentum	judaïsme
romeo	roméo
kasachstan	kazakhstan
verkörperte	incarnait
nils	nils
scottish	scottish
überlebt	survécu
geistigen	intellectuelle
märtyrer	martyrs
märtyrer	martyr
explosion	explosion
larven	larves
rangers	rangers
drogen	drogues
arabisch	arabe
bautzen	bautzen
terror	terreur
bewahren	préserver
niederrhein	niederrhein
rhône	rhône
soziologe	sociologue
tibet	tibet
sparen	économiser
homo	homo
territorien	territoires
nacheinander	successivement
ewald	ewald
untersuchen	enquêter
jefferson	jefferson
algebra	algèbre
pascal	pascal
homosexualität	homosexualité
formale	formelle
zeuge	témoin
hope	hope
bowl	bowl
edwards	edwards
oberseite	dessus
jenny	jenny
sevilla	séville
birgit	birgit
korrektur	correction
holt	holt
telekom	telekom
wöchentlich	hebdomadaire
ideal	idéal
tff	tff
spencer	spencer
hardy	hardy
unsicher	incertain
äbtissin	abbesse
angestellte	employés
ram	ram
kleve	clèves
olivier	olivier
schmuck	bijoux
innovation	innovation
stößt	heurte
werder	werder
öffnet	ouvre
craig	craig
zivilen	civil
dumont	dumont
schräg	oblique
persischen	persique
altona	altona
mähren	moravie
häfen	ports
alessandro	alessandro
mix	mix
gfdl	gfdl
use	use
aka	aka
umfrage	sondage
else	else
werkzeuge	outils
jennifer	jennifer
schilling	shilling
allgäu	allgäu
sandra	sandra
cannes	cannes
tänzerin	danseuse
anklage	accusation
weiden	pâturages
lettland	lettonie
sammler	collectionneurs
regisseurin	réalisatrice
apollo	apollo
sudan	soudan
magdeburger	magdeburger
bewerten	noter
bewerten	évaluer
mut	courage
arms	arms
achsen	axes
achsen	essieux
crew	crew
enterprise	enterprise
lüttich	liège
algorithmus	algorithme
casa	casa
uno	uno
uno	onu
étienne	étienne
cars	cars
watt	watt
reis	riz
bär	ours
slam	slam
gert	gert
ecuador	équateur
potential	potentiel
ilse	ilse
come	come
rosenheim	rosenheim
trinken	boire
support	support
nachhaltig	durable
nachhaltig	durables
potter	potter
pazifik	pacifique
duell	duel
elektrotechnik	électrotechnique
verschwindet	disparaît
zahlung	paiement
third	third
nathan	nathan
ausländer	étrangers
spitz	spitz
guatemala	guatemala
portland	portland
spam	spam
annette	annette
theresia	theresia
rico	rico
willem	willem
leonardo	leonardo
flash	flash
fonds	fonds
havel	havel
verbringen	passer
#default	#default
seven	seven
komm	viens
risiken	risques
wettkampf	compétition
herzöge	ducs
konzeption	conception
beleidigung	insulte
simone	simone
take	take
datierung	datation
inter	inter
fühlen	sentir
bratislava	bratislava
potok	potok
ming	ming
grace	grace
elektronen	électrons
klassisch	classique
mosel	moselle
vereinbart	convenu
stuhl	chaise
zustände	états
beweise	preuves
neuhaus	neuhaus
republikaner	républicain
republikaner	républicains
nachwuchs	progéniture
laufzeit	durée
mar	mar
glaub	crois
minderheiten	minorités
einschränkungen	restrictions
some	some
biologische	biologique
nützlich	utile
wiedergewählt	réélu
druckerei	imprimerie
lambert	lambert
lima	lima
dog	dog
geschossen	tiré
buchhandlung	librairie
modernisierung	modernisation
angeklagt	inculpé
angeklagt	accusé
vermont	vermont
schädel	crâne
toyota	toyota
schuster	cordonnier
make	make
nepomuk	nepomuk
dec	dec
beschreibungen	descriptions
mbh	mbh
thesen	thèses
str	str
kate	kate
hanna	hanna
gregory	gregory
return	return
balken	poutre
cia	cia
taufe	baptême
kompetenz	compétence
kay	kay
chur	coire
schmitz	schmitz
socke	chaussette
pittsburgh	pittsburgh
prosa	prose
bosch	bosch
romantik	romantisme
fiktiven	fictif
signale	signaux
irish	irish
mechanik	mécanique
schenk	schenk
karosserie	carrosserie
sigmaringen	sigmaringen
unterbrechung	interruption
ewig	éternel
geladen	chargé
here	here
manuskript	manuscrit
fasst	résume
landgraf	landgraf
pölten	pölten
lehnt	rejette
ausbreitung	propagation
montevideo	montevideo
neuss	neuss
beta	beta
beta	bêta
