von	de
das	isso
des	do
mit	com
für	para
auf	em
ein	um
eine	uma
auch	também
nicht	não
war	foi
sie	você
sie	ela
cest	cest
bis	até
ich	eu
werden	serão
sind	são
oder	ou
wird	será
score	pontuação
dass	que
über	sobre
aber	mas
wie	como
nur	apenas
nur	só
noch	ainda
hat	tem
artikel	artigos
man	man
vor	antes
sein	ser
diese	este
diese	estes
diese	esta
diese	estas
the	the
kann	pode
hier	aqui
diskussion	discussão
seit	desde
dieser	este
jahr	ano
wenn	quando
wenn	se
dann	então
zwei	dois
jahre	anos
mai	maio
isbn	isbn
hatte	tinha
zwischen	entre
team	equipe
mehr	mais
gegen	contra
waren	eram
waren	mercadorias
zeit	tempo
stadt	cidade
schon	já
haben	ter
gibt	dá
mal	vez
ersten	primeiro
dort	lá
seed	seed
siehe	veja
siehe	ver
drei	três
teil	parte
berlin	berlim
heute	hoje
habe	tenho
während	enquanto
ihre	sua
dieses	este
können	podem
jan	jan
mir	me
sehr	muito
ihr	seu
erste	primeira
august	august
ohne	sem
deutschland	alemanha
ihm	nele
ende	fim
märz	março
band	banda
januar	janeiro
oktober	outubro
immer	sempre
nov	nov
wikipedia	wikipédia
jun	jun
kirche	igreja
juni	junho
konnte	podia
april	abril
september	setembro
juli	julho
geschichte	história
verlag	editora
jpg	jpg
dezember	dezembro
dez	dec
universität	universidade
platz	praça
steht	stands
sep	sep
november	novembro
liste	lista
kam	veio
wir	nós
jahrhundert	século
vier	quatro
seite	página
februar	fevereiro
dessen	cujo
gab	deu
etwas	algo
mich	me
zusammen	juntos
zusammen	junto
film	filme
wäre	seria
leben	vida
namen	nome
weil	porque
relevanz	relevância
muss	deve
einige	alguns
einige	algumas
mitglied	membro
deren	cujos
deren	cujo
viele	muitos
viele	muitas
text	texto
löschen	apagar
bekannt	conhecido
zurück	voltar
geht	vai
jetzt	agora
friedrich	frederico
saison	temporada
stand	stand
würde	dignidade
politiker	políticos
personen	pessoas
titel	título
karl	karl
gut	bem
familie	família
weiter	continue
name	nome
ganz	toda
sohn	filho
hans	hans
erl	erl
gehört	pertence
gehört	ouvido
bild	imagem
nichts	nada
wien	viena
gelöscht	excluído
gelöscht	eliminado
denn	pois
peter	peter
kommt	vem
begann	começou
sei	seja
fall	caso
wilhelm	guilherme
englisch	inglês
fünf	cinco
könig	rei
mehrere	vários
mehrere	várias
form	forma
gruppe	grupo
finden	encontrar
genannt	chamado
nahm	tomou
heinrich	henrique
spielte	jogou
neu	novo
john	john
könnte	poderia
gewann	ganhou
beispiel	exemplo
usa	eua
recht	direito
zwar	though
bin	sou
york	york
paul	paul
frage	pergunta
insgesamt	total
gehörte	pertencia
kurz	curto
unternehmen	empresa
unternehmen	empresas
straße	rua
rund	redondo
einfach	fácil
einfach	simples
datei	arquivo
frau	mulher
lassen	deixar
fast	quase
hatten	tiveram
hatten	tinham
trat	pisou
tod	morte
arbeit	trabalho
macht	poder
vielleicht	talvez
paris	paris
alles	tudo
landkreis	concelho
führte	resultou
kategorie	categoria
bedeutung	importância
bedeutung	significado
relevant	relevante
welt	mundo
quelle	fonte
haus	casa
michael	michael
region	região
findet	encontra
lang	lang
allen	allen
hamburg	hamburgo
besonders	especialmente
deutsch	alemão
franz	franz
lange	lange
begriff	termo
gegründet	fundada
gesellschaft	sociedade
beide	ambos
will	will
georg	georg
arbeitete	trabalhou
führt	executa
studierte	estudou
london	londres
alten	antigo
kinder	crianças
österreich	áustria
weg	caminho
sechs	seis
album	álbum
museum	museu
musik	música
gebäude	edifícios
begründung	justificação
wenig	pouco
kreis	círculo
frankreich	frança
pro	pro
thomas	thomas
grund	razão
möglich	possível
thema	tema
rolle	papel
werk	obra
gewünscht	desejado
entwicklung	desenvolvimento
meine	minha
meine	meu
bau	construção
zweite	segunda
frankfurt	frankfurt
stuttgart	stuttgart
stuttgart	estugarda
benutzer	usuários
maria	maria
vater	pai
sehen	ver
frauen	mulheres
buch	livro
provinz	província
dir	te
quellen	fontes
bleibt	permanece
kilometer	quilómetros
stunden	horas
martin	martin
ernst	sério
schule	escola
leipzig	leipzig
https	https
ludwig	luís
archivierung	arquivamento
dorf	vila
dorf	aldeia
robert	robert
tochter	filha
staaten	estados
gesperrt	bloqueado
stark	forte
gewählt	eleito
oben	acima
mann	homem
spielen	jogar
iii	iii
weiß	branco
bar	bar
blieb	permaneceu
county	condado
seiten	páginas
richtung	direção
richtung	direcção
köln	colónia
partei	partido
wer	quem
kleine	pequena
http	http
version	versão
international	internacional
tage	dias
rahmen	moldura
offizielle	oficial
weniger	menos
autor	autor
fußballspieler	futebolista
wirklich	realmente
preis	preço
genau	exatamente
genau	exato
spiel	jogo
teilweise	parcial
burg	castelo
schweiz	suíça
serie	série
erreichte	alcançou
eingesetzt	implantado
verschiedene	vários
jemand	alguém
arbeiten	trabalhar
tag	dia
norden	norte
entstand	originou
literatur	literatura
millionen	milhões
übernahm	assumiu
krieg	guerra
besser	melhor
sprache	língua
zeigt	mostra
danke	obrigado
danke	obrigada
kunst	arte
pdf	pdf
schauspieler	ator
ehemaligen	antiga
hätte	teria
auswahl	seleção
spieler	jogador
links	esquerda
warum	porquê
otto	otto
from	from
konnten	puderam
beschreibung	descrição
online	online
direkt	direto
schriftsteller	escritor
alter	idade
beginn	início
klasse	classe
obwohl	embora
gemeinden	municípios
bischof	bispo
erschien	apareceu
höhe	altitude
häufig	frequentes
süden	sul
gruß	saudação
entfernt	removido
gehören	pertencem
kleinen	pequeno
kleinen	pequenos
christian	christian
johannes	joão
erwähnt	mencionado
chr	chr
letzte	última
informationen	informaçoes
bezeichnung	denominação
saint	saint
ihnen	lhes
meister	mestre
zuvor	anteriormente
stellt	restaura
insel	ilha
klar	claro
joseph	joseph
veröffentlicht	publicado
ursprünglich	originalmente
regierung	governo
carl	carl
sieben	sete
bevölkerung	população
osten	leste
van	van
gleich	igual
problem	problema
starb	morreu
bayern	bayern
westen	oeste
lage	localização
mitglieder	membros
national	national
graf	conde
david	david
präsident	presidente
betrieb	exploração
bad	bad
baden	baden
kaiser	imperador
arten	espécies
geboren	nascido
richard	richard
sitz	sede
zog	puxou
wasser	água
hermann	hermann
san	san
karriere	carreira
zehn	dez
center	center
uns	nos
system	sistema
bilder	imagens
enthält	contém
main	main
mutter	mãe
linie	linha
west	west
acht	oito
scheint	parece
weit	longe
ziel	alvo
grüße	saudações
roman	roman
liga	liga
spiele	jogos
sachsen	saxônia
wolfgang	wolfgang
folgen	siga
walter	walter
leider	infelizmente
uhr	relógio
liegen	deitado
geben	dar
meinung	opinião
kultur	cultura
alexander	alexandre
trotz	despeito
projekt	projeto
folgte	seguiu
maler	pintor
paar	casal
max	max
sommer	verão
runde	ronda
william	william
institut	instituto
raum	espaço
armee	exército
jean	jean
aufgenommen	tiradas
tun	fazer
vereinigten	unidos
regel	regra
gefunden	encontrado
daten	dados
erledigt	feito
theater	teatro
lag	gal
wollte	queria
person	pessoa
kloster	mosteiro
city	city
schrieb	escreveu
hilfe	ajuda
gegeben	dado
entstanden	surgiram
reich	império
kamen	vieram
schnell	rápido
teile	peças
world	world
gmbh	gmbh
google	google
besten	melhores
republik	república
setzte	sentou
italien	itália
fragen	perguntas
general	general
hälfte	metade
euro	euro
verbindung	conexão
nähe	proximidade
anders	anders
vertrag	tratado
vertrag	contrato
james	james
top	top
bruder	irmão
künstler	artista
england	inglaterra
erfolg	sucesso
früher	antigamente
wissen	conhecimento
länge	comprimento
groß	grande
geschrieben	escrito
abschnitt	secção
rechts	direita
trainer	treinador
see	lago
spielt	joga
hohen	alto
zeitschrift	revista
finde	encontre
führen	conduzir
etc	etc
ausbildung	formação
park	park
george	george
wappen	brasão
zürich	zurique
wort	palavra
komponist	compositor
zahl	número
zusätzlich	além
dresden	dresden
homepage	homepage
schreiben	escrever
rudolf	rudolf
nahe	próximo
tore	gols
wahl	escolha
männer	homens
schauspielerin	atriz
hannover	hanôver
werde	vou
werde	serei
gründete	baseou
beste	melhor
zeitung	jornal
spd	spd
schlacht	batalha
richtig	certo
richtig	correto
akademie	academia
gehen	ir
stil	estilo
sagen	dizer
charles	charles
gebaut	construído
american	american
größte	maior
funktion	função
wahrscheinlich	provavelmente
till	till
herzog	duque
zentrum	centro
jede	cada
jede	qualquer
liebe	amor
rom	roma
nachfolger	sucessor
wenige	poucos
grenze	fronteira
truppen	tropas
werner	werner
verwendung	utilização
sieg	vitória
veröffentlichte	publicou
entwickelt	desenvolvido
china	china
hohe	alta
falls	falls
besitzt	possui
besitzt	possua
leicht	leve
besitz	posse
verbunden	ligado
autoren	autores
all	all
tiefe	profundidade
allein	sozinho
bürgermeister	prefeito
polen	polónia
link	link
nord	nord
bestehen	insistir
verheiratet	casado
km²	km²
produktion	produção
herrschaft	dominação
berg	montanha
sla	sla
alt	velho
punkt	ponto
andreas	andreas
stiftung	fundação
aktiv	ativo
gute	boa
punkte	pontos
minuten	minutos
bleiben	ficar
rang	rank
diente	serviu
historischen	histórico
finale	final
tour	tour
wollen	querer
ergebnis	resultado
mark	mark
württemberg	württemberg
falsch	errado
gold	ouro
weise	sábio
außer	excepto
außer	exceto
möglichkeit	possibilidade
leiter	escada
rennen	corrida
del	del
union	união
japan	japão
fläche	superfície
webseite	site
müller	müller
albert	albert
dank	agradecimentos
kanton	cantão
düsseldorf	düsseldorf
erkennen	reconhecer
politik	política
right	right
position	posição
schwer	pesado
gruppen	grupos
weder	nem
satz	frase
ersetzt	substitui
hauptsächlich	principalmente
indem	colocando
indem	fornecendo
stimmen	vozes
geführt	guiado
engl	engl
wert	valor
späteren	posterior
frank	frank
klaus	klaus
kritik	críticas
kritik	crítica
inhalt	conteúdo
heinz	heinz
bekannte	conhecidos
beteiligt	borá
wochen	semanas
fritz	fritz
kategorien	categorias
louis	louis
records	records
selten	raros
schüler	alunos
dritte	terceira
fluss	rio
admin	admin
club	clube
bremen	bremen
relativ	relativamente
relativ	relativo
erklärt	explica
fort	fort
musiker	músicos
gesehen	viu
fanden	encontraram
nimmt	toma
adolf	adolf
schiff	navio
fußball	futebol
bedeutet	significa
bietet	oferece
vertreter	representante
hessen	hesse
organisation	organização
les	les
halten	manter
hand	mão
sammlung	coleção
www	www
unterstützung	apoio
meisterschaft	campeonato
sinn	sinn
sinn	sentido
bilden	formando
westfalen	vestefália
herren	cavalheiros
herren	senhores
karte	mapa
probleme	problemas
alfred	alfred
erscheint	aparece
orte	localidades
hallo	olá
vergleich	comparação
php	php
hof	pátio
halle	halle
staat	estado
langen	langen
dient	serve
anton	anton
neun	nove
genommen	tomado
wirtschaft	economia
college	faculdade
brachte	trouxe
markt	mercado
städte	cidades
kapelle	capela
verloren	perdido
ausgezeichnet	excelente
russland	rússia
bonn	bona
jugend	juventude
spanien	espanha
post	post
soldaten	soldados
lebt	vive
umgebung	arredores
bücher	livros
medien	mídia
entscheidung	decisão
einfluss	influência
monate	meses
beschrieben	descrito
übernommen	assumido
schutz	proteção
christoph	cristóvão
cdu	cdu
rechte	direitos
erkennbar	reconhecível
stück	peça
programm	programa
live	live
namens	chamado
jazz	jazz
unten	abaixo
papst	papa
themen	tópicos
gerhard	gerhard
erschienen	apareceu
junge	menino
eltern	pais
sprachen	línguas
internet	internet
folgt	segue
größe	tamanho
start	lançamento
spricht	fala
hauptstadt	capital
abschluss	conclusão
philosophie	filosofia
friedhof	cemitério
philipp	filipe
lehrer	professores
würden	fariam
würden	seriam
betrug	fraude
kopf	cabeça
zusammenarbeit	cooperação
nein	não
gebracht	trazido
brücke	ponte
usw	etc
zerstört	destruído
zerstört	destruída
bundesliga	bundesliga
teilen	compartilhar
nacht	noite
versionen	versões
lesen	ler
daniel	daniel
idee	idéia
rot	vermelho
eindeutig	claramente
daraus	daí
bestimmt	determina
turm	torre
lebte	vivia
lebte	viveu
klein	pequeno
klein	klein
interesse	interesse
genug	suficiente
zuerst	primeiro
enzyklopädie	enciclopédia
kind	criança
münster	münster
svg	svg
studien	estudos
direktor	diretor
marie	marie
gustav	gustav
freiburg	friburgo
fehlt	falta
modell	modelo
bildung	educação
washington	washington
island	islândia
gesagt	dito
you	you
kampf	luta
vertreten	representada
vertreten	representou
vertreten	representado
abteilung	divisão
durchgeführt	realizado
beginnt	começa
schwarz	preto
ulrich	ulrich
kurt	kurt
single	solteiro
regeln	regras
fiel	caiu
wald	floresta
ferdinand	ferdinand
löschung	supressão
dollar	dólar
music	music
besondere	especial
jürgen	jürgen
sänger	cantor
département	département
heidelberg	heidelberg
fischer	fischer
schweden	suécia
ergebnisse	resultados
verkauft	vendido
vandalismus	vandalismo
zwölf	doze
juden	judeus
border	border
henry	henry
elisabeth	isabel
möglicherweise	possivelmente
brandenburg	brandemburgo
stieg	subiu
suche	pesquisa
breite	largura
royal	royal
festival	festival
übersetzung	tradução
folgten	seguiram
pfalz	palatinado
state	state
beziehungen	relações
rhein	reno
bewegung	movimento
erfüllt	cumprido
opfer	sacrifício
bayerischen	bávara
erde	terra
angegeben	especificado
typ	tipo
united	united
open	open
mainz	mainz
boden	chão
grand	grand
siedlung	assentamento
radio	rádio
entdeckt	descoberto
bernhard	bernhard
bernhard	bernardo
vorschlag	proposta
erzbischof	arcebispo
ungarn	hungria
stammen	provêm
historiker	historiador
pierre	pierre
software	software
rock	rock
entsprechenden	correspondente
aufstieg	ascensão
verwaltung	administração
lebten	viveram
wiki	wiki
bank	banco
rein	puro
mannschaften	equipes
tor	tor
tor	gol
herbst	outono
schulen	escolas
ebene	nível
schmidt	schmidt
gehörten	pertenciam
essen	comer
göttingen	göttingen
richter	juiz
ausstellung	exposição
aufgabe	tarefa
geld	dinheiro
kirchen	igrejas
lösung	solução
north	north
tiere	animais
rheinland	renânia
werbung	publicidade
winter	inverno
unterschied	diferença
familien	famílias
inseln	ilhas
offensichtlich	obviamente
objekte	objectos
objekte	objetos
anteil	proporção
society	society
house	house
nürnberg	nuremberga
blick	olhar
herr	senhor
silber	prata
hintergrund	fundo
französisch	francês
theorie	teoria
air	air
jährlich	anual
erweitert	avançado
unterstützt	suporta
produziert	produzido
allgemein	geral
treffen	encontro
arbeitet	trabalha
architekt	arquiteto
jurist	jurista
fällt	cai
south	south
führung	liderança
bestimmte	certos
bestimmte	certas
ordnung	ordem
tragen	vestindo
herbert	herbert
wichtigsten	principais
westlichen	ocidental
zeichen	sinais
früheren	anterior
kraft	força
komplett	completo
braunschweig	brunsvique
verhalten	comportamento
sport	desporto
mittel	meios
mittel	dotações
verbreitung	difusão
theodor	teodoro
sofort	imediatamente
wissenschaft	ciência
gesetz	lei
journalist	jornalista
moskau	moscovo
hamburger	hambúrguer
edit	edit
verfügt	dispõe
verfügt	disponha
stimme	voz
qualität	qualidade
aufnahme	gravação
veröffentlichung	publicação
zahlen	números
galerie	galeria
black	black
aufgaben	tarefas
fehler	erro
filme	filmes
stadion	estádio
moderne	modernidade
basel	basileia
org	org
sur	sur
situation	situação
wichtig	importante
leistung	potência
handbuch	manual
gespielt	jogado
motor	motor
offiziell	oficialmente
dieter	dieter
texte	textos
gott	deus
rat	conselho
villa	villa
dichter	poeta
helmut	helmut
nationalen	nacional
beschäftigt	ocupado
hergestellt	fabricado
tal	vale
fotos	fotos
sagt	diz
gewinnen	ganhar
woche	semana
berufen	invocar
schreibt	escreve
erich	erich
fernsehen	televisão
schleswig	schleswig
stein	pedra
preußen	prússia
nennt	chama
wettbewerb	concorrência
wären	seriam
natur	natureza
dienen	servir
braucht	precisa
kosten	custo
teilnehmer	participantes
bildete	fêz
archiv	arquivo
chor	coro
stefan	stefan
bach	bach
polizei	polícia
jakob	jacó
gebildet	formado
html	html
super	super
australien	austrália
hall	hall
urv	urv
zeiten	tempos
flughafen	aeroporto
kreuz	cruz
aussage	depoimento
png	png
länder	países
niemand	ninguém
zukunft	futuro
änderungen	alterações
bern	berna
revolution	revolução
tradition	tradição
kanada	canadá
veröffentlichungen	publicações
straßen	estradas
architektur	arquitetura
umbenannt	renomeado
arzt	médico
parallel	paralelo
medizin	medicina
praxis	prática
angeboten	oferecido
zählen	contando
zählen	contagem
rest	descanso
rest	restante
rest	resto
bibliothek	biblioteca
konrad	konrad
druck	pressão
freund	amigo
antwort	resposta
geschlossen	fechado
love	love
landwirtschaft	agricultura
könnten	poderiam
salzburg	salzburgo
fahrzeuge	veículos
portal	portal
erstellt	criado
schiffe	navios
schwester	irmã
augen	olhos
min	min
beispiele	exemplos
theologe	teólogo
simon	simon
don	don
präsidenten	presidentes
antrag	pedido
führten	conduziram
julius	julius
nominiert	nomeados
anwendung	aplicação
lieber	prefiro
lake	lake
formel	fórmula
santa	santa
red	red
geburtstag	aniversário
niederlage	derrota
chicago	chicago
formen	formas
video	vídeo
wolf	wolf
elf	onze
elf	elf
aufgelöst	dissolvido
übersetzt	traduzido
mädchen	meninas
glaube	fé
hätten	teriam
suchen	procurar
wissenschaften	ciências
trug	usava
architekten	arquitetos
foto	foto
ergänzt	completado
ergänzt	completada
herausgeber	editor
einheit	unidade
nordosten	nordeste
ritter	cavaleiro
hersteller	fabricante
lief	correu
rückkehr	retorno
rückkehr	regresso
darmstadt	darmstadt
bringt	traz
verantwortlich	responsável
zeitraum	período
tom	tom
menge	quantidade
zentimeter	centímetro
zentimeter	centímetros
besitzen	possuir
versuchte	tentou
tübingen	tübingen
parteien	partidos
energie	energia
wesentlichen	essencial
bürger	cidadão
kennen	conhecer
arthur	arthur
life	life
holstein	holstein
auszeichnungen	prêmios
teilnahme	participação
besuch	visita
definition	definição
lae	lae
original	original
prag	praga
bot	bot
teams	equipas
verstehen	compreender
ehefrau	esposa
indien	índia
beschreibt	descreve
josé	josé
schlecht	ruim
shift	shift
südwesten	sudoeste
politisch	politicamente
leser	leitor
turnier	torneio
körper	corpo
chemie	química
bildhauer	escultor
bericht	relatório
angriff	ataque
sängerin	cantora
sprechen	falar
gewonnen	ganhado
kontakt	contato
bist	és
evangelische	evangélica
diskutiert	discutiu
diskutiert	discute
luft	ar
mexiko	méxico
kommission	comissão
reise	viagem
gebiete	territórios
erhält	recebe
mehrheit	maioria
nordwesten	noroeste
datum	data
british	british
marine	marinha
variante	variante
tat	tat
kalifornien	califórnia
sicherheit	segurança
kassel	kassel
meer	mar
theologie	teologia
heft	dobrador
gast	convidado
nächste	próxima
konzept	conceito
türkei	turquia
bronze	bronze
entstehen	surgem
lieder	músicas
persönlich	pessoalmente
verwenden	usar
grenzen	limites
oper	ópera
smith	smith
fenster	janela
farbe	cor
commons	commons
poly	poli
matthias	matthias
geändert	modificado
russisch	russo
horst	horst
unternehmer	empresário
karten	mapas
prinzip	princípio
struktur	estrutura
grafschaft	condado
beruf	profissão
südosten	sudeste
alben	álbuns
aktuell	atual
boot	barco
stimmt	verdade
szene	cena
parlament	parlamento
licht	luz
ausdruck	expressão
oxford	oxford
ungefähr	aproximadamente
verschoben	movido
zeigte	mostrou
argumente	argumentos
spitze	ponta
hugo	hugo
morgen	amanhã
holz	madeira
qualifikation	qualificação
industrie	indústria
material	material
king	king
manfred	manfred
edward	edward
erhielten	receberam
one	one
prozess	processo
best	best
elemente	elementos
existieren	existir
anhalt	anhalt
inneren	interior
adam	adão
adam	adam
unbekannt	desconhecido
feld	campo
dänemark	dinamarca
arts	arts
würzburg	würzburg
imho	imho
kriterien	critérios
standard	padrão
pflanzen	plantas
änderung	mudança
vereinigung	unificação
infanterie	infantaria
brüder	irmãos
förderung	promoção
albrecht	albrecht
kiel	kiel
interview	entrevista
spiegel	espelho
ausnahme	excepção
ausnahme	exceção
mecklenburg	mecklemburgo
zug	comboio
töchter	filhas
königin	rainha
geplant	planejada
lizenz	licença
veranstaltungen	eventos
ändern	mudar
high	high
diskussionen	discussões
verstanden	entendeu
verstanden	entendi
talk	talk
blieben	permaneceram
vertrat	representou
aachen	aachen
figuren	personagens
sendung	remessa
argument	argumento
zentrale	central
erlaubt	permite
läuft	corre
wiesbaden	wiesbaden
besaß	possuía
lauf	corra
verkehr	transportes
show	show
landschaft	paisagem
gegner	adversário
blau	azul
gemeinsamen	comum
stern	estrela
abs	abs
herstellung	fabricação
ausreichend	suficiente
hockey	hóquei
antonio	antonio
lee	lee
bestätigt	confirmado
berichtet	relatou
einheiten	unidades
israel	israel
brasilien	brasil
klavier	piano
durchmesser	diâmetro
gericht	tribunal
helfen	ajudar
bestritt	contestou
bewohner	moradores
barbara	barbara
orchester	orquestra
augsburg	augsburg
unsere	nossa
entstehung	surgimento
unbedingt	necessariamente
früh	cedo
physik	física
einträge	entradas
gouverneur	governador
belgien	bélgica
treffer	hit
ähnliche	semelhante
cambridge	cambridge
auto	carro
graz	graz
francisco	francisco
vergangenheit	passado
presse	imprensa
verhindern	prevenir
wann	quando
definiert	definido
religion	religião
jena	jena
linien	linhas
sender	transmissor
fallen	armadilhas
besetzung	ocupação
methode	método
hektar	hectare
zweck	finalidade
gelesen	lido
gründer	fundador
farben	cores
texas	texas
meyer	meyer
entscheiden	decidir
erklärung	declaração
handel	comércio
ausland	estrangeiro
solange	solange
monat	mês
studenten	estudantes
letzter	último
windows	windows
funktionen	funções
listen	listas
dinge	coisas
lübeck	lübeck
eigenschaften	propriedades
günter	günter
fließt	flui
versuchen	tentar
widerstand	resistência
design	design
entschieden	decidido
offizier	oficial
ältesten	ancião
erklären	explicar
kongress	congresso
volk	povo
white	white
universitäten	universidades
nachgewiesen	comprovada
günther	günther
gottfried	gottfried
code	código
management	gerência
songs	músicas
beziehung	relacionamento
karlsruhe	karlsruhe
grad	graus
grad	grau
mathematik	matemática
bund	convênio
amsterdam	amsterdam
verbessern	melhorar
nsdap	nsdap
vorgesehen	previsto
geschützt	protegido
profil	perfil
glauben	fé
wikimedia	wikimedia
las	las
einschließlich	incluindo
millimeter	milímetro
dvd	dvd
fuß	pé
portugal	portugal
begriffe	termos
vergeben	perdoar
tabelle	tabela
zuschauer	telespectadores
arnold	arnold
reaktion	reação
sozialen	social
wahlen	eleições
schriftstellerin	escritora
party	festa
entfernen	remover
ausgestattet	equipado
automatisch	automaticamente
harry	harry
regionen	regiões
außen	fora
außen	exterior
verfassung	constituição
getrennt	separado
entfernung	distância
gefahr	perigo
minister	ministro
speziell	especificamente
mitarbeit	colaboração
leopold	leopold
plan	plano
interessant	interessante
sowjetischen	soviético
generation	geração
wunsch	desejo
drittel	terço
oblast	oblast
verurteilt	condenado
waffen	armas
dietrich	dietrich
erhoben	cobrado
mfg	mfg
schneider	schneider
schneider	alfaiate
gemeinschaft	comunidade
zugang	acesso
garten	jardim
weisen	sábios
thüringen	turíngia
tonnen	toneladas
afrika	áfrica
wagner	wagner
bedingungen	condições
niederlande	holanda
hafen	porto
entschied	decidiu
verbindungen	conexões
verbindungen	ligações
kontrolle	controle
emil	emil
langsam	lento
langsam	devagar
norwegen	noruega
angeblich	supostamente
sebastian	sebastião
initiative	iniciativa
maßnahmen	medidas
oscar	oscar
medaille	medalha
dritter	terceira
dritter	terceiro
freiheit	liberdade
sicherlich	certamente
route	rota
baron	barão
verschieben	mover
projekte	projetos
felix	félix
kamera	câmera
priester	sacerdote
charakter	personagem
erklärte	explicou
big	big
darstellen	retratar
organisationen	organizações
ziehen	puxar
fahrer	motorista
magdeburg	magdeburg
kommentar	comentário
vorbei	perto
time	time
eindruck	impressão
möglichkeiten	oportunidades
grenzt	roça
donau	danúbio
spielten	jogaram
mission	missão
kombination	combinação
first	first
prinz	príncipe
kapitel	capítulo
juan	juan
drehbuch	roteiro
versuche	tentativas
alternative	alternativa
praktisch	prático
value	value
jacques	jacques
biografie	biografia
gründe	razões
mündet	desagua
phase	fase
junioren	juniores
françois	françois
antike	antiguidade
korrekt	correto
behandlung	tratamento
edits	edits
erstellen	criar
unterscheidet	diferencia
unterscheidet	distingue
pokal	troféu
eng	eng
jack	jack
mary	mary
nikolaus	nicolau
baute	construiu
freunde	amigos
frieden	paz
stub	stub
bereichen	domínios
bereichen	áreas
ruf	reputação
herz	coração
pov	pov
fuhr	dirigi
fuhr	dirigia
ägypten	egito
größer	maior
studio	estúdio
spanisch	espanhol
kollegen	colegas
not	not
hill	hill
irrelevant	irrelevante
bruno	bruno
regensburg	ratisbona
dortmund	dortmund
aktion	ação
mannheim	mannheim
griechenland	grécia
umfasste	incluiu
neustadt	neustadt
leo	leo
gestaltung	concepção
anspruch	reivindicação
angebot	oferta
zweifel	dúvidas
reine	pura
produzent	produtor
township	township
lager	rolamentos
beck	beck
jones	jones
blue	blue
umgeben	cercado
kat	kat
net	net
wirkt	atua
hitler	hitler
wiederholt	repete
tatsache	fato
rainer	rainer
übernehmen	assumir
mathematiker	matemático
operation	cirurgia
studie	estudo
zusätzliche	adicional
schließen	fechar
patienten	doentes
bernd	bernd
vol	vol
anlagen	instalações
alleine	sozinho
flucht	fuga
abt	abade
maschinen	máquinas
verbesserung	melhoria
erforderlich	necessário
michel	michel
vorkommen	ocorrência
sonne	sol
nannte	chamou
verboten	proibido
erweiterung	extensão
virginia	virgínia
geschichten	histórias
modelle	modelos
brown	brown
vorstand	diretoria
statistik	estatística
fälle	casos
weimar	weimar
endlich	finalmente
anne	anne
erfahrungen	experiências
falle	armadilha
treten	chutar
grab	túmulo
weber	weber
earl	earl
zieht	puxa
verbindet	conecta
samuel	samuel
methoden	métodos
williams	williams
ukraine	ucrânia
mühle	moinho
rolf	rolf
verwendete	utilizou
rostock	rostock
bauern	camponeses
linz	linz
untergebracht	alojados
funktioniert	funciona
festung	fortaleza
joe	joe
rumänien	roménia
computer	computador
grün	verde
marburg	marburg
east	east
einleitung	introdução
nachrichten	notícias
kanal	canal
werte	valores
ansprache	alocução
entlassen	demitido
damen	senhoras
sprach	falou
moment	momento
zitat	citação
krankenhaus	hospital
dame	dama
diskutieren	discutir
ring	anel
mail	mail
dynastie	dinastia
innsbruck	innsbruck
existenz	existência
braun	marrom
giovanni	giovanni
zählte	contei
zählte	contava
ziele	objetivos
bühne	palco
anerkennung	reconhecimento
städtischen	urbano
konflikt	conflito
fahrzeug	veículo
young	young
kandidaten	candidatos
vielzahl	variedade
gewalt	violência
interessiert	interessados
hören	ouvir
passt	encaixa
dokumentation	documentação
krone	coroa
amerika	américa
format	formato
voll	cheio
gewinn	lucro
umgebaut	reconstruída
frühe	early
merkmale	características
ständig	constantemente
boston	boston
major	major
sächsischen	saxão
stephan	estêvão
jacob	jacob
erreichten	alcançaram
persönlichkeiten	personalidades
youtube	youtube
erzeugt	gerado
venedig	veneza
rollen	rolos
beteiligung	participação
alpen	alpes
logo	logotipo
creek	creek
trier	trier
bands	bandas
madrid	madrid
militärische	militar
barcelona	barcelona
halbinsel	península
freiherr	freiherr
carolina	carolina
sekunden	segundos
episode	episódio
blätter	folhas
siegen	vencer
volkszählung	recenseamento
scott	scott
dach	telhado
athen	atenas
sucht	vício
bgcolor	bgcolor
sitze	assentos
potsdam	potsdam
einst	outrora
besucher	visitantes
mailand	milão
entgegen	contrariando
schritt	passo
eberhard	eberhard
traten	ocorreram
real	real
sagte	disse
kardinal	cardeal
analyse	análise
organisiert	organizado
streit	disputa
koch	cozinheiro
weiterleitung	encaminhamento
ausstellungen	exposições
roger	roger
schlug	bateu
tempel	templo
gedacht	pensado
erfahrung	experiência
carlos	carlos
täglich	diário
abgelehnt	rejeitado
umfang	circunferência
laufen	correr
kern	núcleo
dörfer	aldeias
bill	bill
schließt	fecha
ben	ben
forum	fórum
preise	preços
philosoph	filósofo
goldenen	dourado
times	times
oliver	oliver
diplomat	diplomata
wissenschaftler	cientista
malerei	pintura
gewicht	peso
erhöht	aumenta
absolut	absolutamente
kenne	conheço
who	who
glück	felicidade
veränderungen	mudanças
autorin	autora
gitarre	guitarra
patrick	patrick
behörden	autoridades
rechtsanwalt	advogado
umwelt	ambiente
ingenieur	engenheiro
manager	gerenciador
senat	senado
reisen	viagens
rundfunk	radiodifusão
hoffmann	hoffmann
zugänglich	acessível
reinhard	reinhard
din	din
urteil	acórdão
botschafter	embaixador
drehbuchautor	roteirista
eingefügt	inserido
marx	marx
moritz	maurício
fdp	fdp
fraktion	facção
media	media
üblichen	usual
bauen	construir
filmografie	filmografia
lord	lord
lord	lorde
auge	olho
katharina	catarina
geburt	nascimento
systeme	sistemas
america	america
rose	rose
wales	gales
feuer	fogo
prüfung	ensaio
vergessen	esquecer
day	day
distrikt	distrito
iso	iso
bestanden	existiram
bestanden	insistiu
behauptet	alega
irland	irlanda
pennsylvania	pensilvânia
eugen	eugen
kunden	clientes
himmel	céu
hundert	cem
mike	mike
adresse	endereço
eva	eva
western	western
green	green
anhänger	reboque
bearbeitet	editado
columbia	columbia
kontext	contexto
sichtbar	visível
blues	blues
beschlossen	decidiram
details	detalhes
info	info
herrscher	governantes
planung	planejamento
leiden	sofrer
leiden	sofrimento
komponisten	compositores
victor	victor
anscheinend	aparentemente
aufgehoben	revogado
henri	henri
partner	parceiro
zustimmung	consentimento
jörg	jörg
masse	massa
chance	chance
rücken	costas
chris	chris
nationen	nações
test	teste
harald	harald
unterstützen	apoiar
francis	francis
bundeswehr	bundeswehr
anforderungen	requisitos
schützen	proteger
beleg	deslizamento
verhaftet	preso
web	web
florida	flórida
ausgaben	despesas
kommunikation	comunicações
gebrauch	uso
ursprung	origem
dauer	duração
bewusst	consciente
roland	roland
geist	espírito
della	della
katalog	catálogo
begrenzt	limitado
vii	vii
argentinien	argentina
episoden	episódios
siegfried	siegfried
gezogen	puxado
verkauf	venda
play	play
objekt	objeto
positiv	positivo
wohnung	apartamento
bass	bass
interessen	interesses
erfurt	erfurt
goethe	goethe
master	master
posten	postos
ideen	idéias
gedanken	pensamentos
bergen	bergen
veranstaltung	evento
hinten	atrás
hinten	trás
verletzt	ferido
krankheit	doença
jung	jovem
johnson	johnson
jesus	jesus
via	via
königsberg	königsberg
transport	transporte
umsetzung	implementação
flügel	asas
kämpfen	lutar
baum	árvore
steve	steve
ohio	ohio
maximilian	maximiliano
mario	mario
istanbul	istambul
uwe	uwe
bildeten	formaram
unabhängigkeit	independência
beziehen	relacionar
gipfel	cimeira
pop	pop
beeinflusst	influencia
vermeiden	evitar
bauer	peão
rosa	rosa
produzierte	produziu
verständnis	compreensão
luxemburg	luxemburgo
abgerissen	demolida
ford	ford
begleitet	acompanhado
begleitet	acompanha
viertel	bairro
pläne	planos
unterricht	aulas
victoria	victoria
erworben	adquirido
fakten	factos
trennung	separação
budapest	budapeste
charlotte	charlotte
uss	uss
little	little
vorteil	vantagem
schöne	bela
oldenburg	oldenburg
gerät	dispositivo
berge	montanhas
grundlagen	fundamentos
wilson	wilson
varianten	variantes
bielefeld	bielefeld
verbessert	melhora
altar	altar
runden	voltas
utc	utc
zeitschriften	revistas
illinois	illinois
chronik	cronologia
enzyklopädische	enciclopédico
public	public
identisch	idêntico
aussehen	aparência
gefängnis	prisão
gesucht	procurado
regionalliga	regionalliga
drama	drama
marc	marc
maschine	máquina
manuel	manuel
renaissance	renascença
verfasst	redigido
sturm	tempestade
bord	bordo
umstritten	controverso
prinzessin	princesa
geschwindigkeit	velocidade
bob	bob
exemplare	espécimes
davis	davis
bernard	bernard
jerusalem	jerusalém
kino	cinema
übergang	transição
ball	bola
lernen	aprender
tunnel	túnel
provinzen	províncias
marcus	marcus
zusammengefasst	resumiu
zusammengefasst	resumido
minute	minuto
verteilt	distribuído
funde	achados
effekt	efeito
massachusetts	massachusetts
griechisch	grego
great	great
stockholm	estocolmo
gelegen	situado
produkt	produto
vorgänger	antecessor
autobahn	rodovia
gestern	ontem
umgewandelt	convertido
umfangreiche	extenso
keller	cave
ansatz	abordagem
abgeordneten	congressista
abgeordneten	deputados
taylor	taylor
vorlagen	modelos
flagge	bandeira
italienisch	italiano
schottland	escócia
verteidigung	defesa
finnland	finlândia
mauer	muralha
psychologie	psicologia
strukturen	estruturas
bayerische	bayerische
gelb	amarelo
nachfolge	sucessão
absatz	parágrafo
leichtathletik	atletismo
strom	eletricidade
golden	golden
integriert	integra
spuren	vestígios
schwierig	difícil
benjamin	benjamin
hoffe	espero
konzert	concerto
jahrbuch	anuário
brach	partiu
verfügte	dispunha
milliarden	bilhões
beobachtet	observado
gang	gang
last	last
runs	runs
lehrte	ensinou
tirol	tirol
eingeweiht	inaugurado
eingeweiht	inaugurada
verhandlungen	negociações
claude	claude
zdf	zdf
tony	tony
schaden	dano
schaden	danos
zeitungen	jornais
aspekte	aspectos
iran	irã
kabinett	gabinete
normalerweise	normalmente
assistent	assistente
warten	esperar
andrew	andrew
douglas	douglas
festgestellt	constatou
beginnen	começar
koblenz	koblenz
becker	becker
flotte	frota
flugzeug	avião
server	servidor
kritisiert	critica
angst	medo
innen	dentro
konzerte	concertos
erwin	erwin
erinnern	lembrar
bochum	bochum
bearbeiten	editar
legende	lenda
box	box
preußische	prussiano
besatzung	tripulação
botschaft	embaixada
brunnen	poço
benannte	chamou
flora	flora
sätze	frases
paderborn	paderborn
night	night
museen	museus
symbol	ícone
eric	eric
verfügbar	disponível
brüssel	bruxelas
verlängerung	prorrogação
ermordet	assassinado
parameter	parâmetros
reduziert	reduz
gegenstand	objecto
wollten	queriam
wollten	quiseram
unterschiede	diferenças
engel	anjo
angepasst	adaptado
holte	holte
lokomotiven	locomotivas
stationen	estações
europe	europe
auftritte	aparições
warschau	varsóvia
haltung	atitude
erfüllen	cumprir
phil	phil
nhl	nhl
nachkommen	descendentes
liter	litros
andrea	andrea
vorgeschlagen	propôs
vorgeschlagen	sugeriu
kindheit	infância
wind	vento
angesprochen	abordado
weiler	weiler
wächst	cresce
positionen	posições
chile	chile
lewis	lewis
petersburg	petersburgo
out	out
synagoge	sinagoga
ausgeschlossen	excluídos
wild	wild
regionale	regional
jackson	jackson
analog	analógico
aufgegeben	abandonados
aufgegeben	abandonado
long	long
szenen	cenas
böhmen	boémia
islam	islamismo
annahme	adoção
oberst	coronel
nation	nação
präsentiert	apresenta
haut	pele
modern	moderno
ray	ray
schwierigkeiten	dificuldades
eigentümer	proprietário
gefördert	promovido
gabriel	gabriel
beschädigt	danificado
neutral	neutro
pommern	pomerânia
schwerin	schwerin
christen	cristãos
saale	saale
anfrage	pedido
forderte	apelou
firmen	companhias
hoffnung	esperança
stephen	stephen
lösen	resolver
valign	valign
erbe	herança
nassau	nassau
ecke	canto
ruhestand	aposentadoria
okres	okres
sophie	sophie
buchstaben	letras
mittelalterlichen	medieval
vertrieben	expulsos
sonntag	domingo
arena	arena
christus	cristo
verlust	perda
this	this
gestorben	morri
verlängert	prorrogado
null	zero
law	law
zone	zona
bezeichnungen	denominações
entsprechen	corresponder
uefa	uefa
gräfin	condessa
duisburg	duisburg
singles	solteiros
blut	sangue
ersetzen	substituir
erzählung	narração
pseudonym	pseudónimo
auswirkungen	efeitos
lat	lat
ausführung	execução
mord	homicídio
power	power
jäger	caçador
betroffen	afetado
betroffen	afetados
gaben	dons
berichte	relatórios
carlo	carlo
oskar	oskar
fahrt	passeio
tourismus	turismo
centre	centre
vogel	ave
fassade	fachada
sprint	sprint
worte	palavras
norbert	norbert
franken	francos
lady	lady
abtei	abadia
saarbrücken	saarbrücken
adler	águia
ursache	causa
zerstörung	destruição
beschreiben	descrever
kathedrale	catedral
debütierte	estreou
luis	luis
stahl	aço
rené	rené
entscheidungen	decisões
bedient	atendido
plus	plus
georges	georges
horn	corno
kritiker	críticos
institutionen	instituições
konsens	consenso
sydney	sydney
geräte	dispositivos
geräte	aparelhos
schnitt	corte
ali	ali
religiösen	religioso
klassen	classes
ibn	ibn
partien	lotes
nrw	nrw
geleitet	guiado
achtelfinale	eliminatória
anthony	anthony
brian	brian
asien	ásia
pianist	pianista
country	country
old	old
blatt	folha
hildesheim	hildesheim
programme	programas
befehl	comando
bestimmung	determinação
free	free
marathon	maratona
demokratie	democracia
tier	animal
geschlecht	sexo
instrument	instrumento
town	town
angezeigt	mostrado
angezeigt	exibido
prof	prof
kopenhagen	copenhaga
rücktritt	demissão
summe	soma
ändert	muda
klingt	soa
fielen	caíram
wende	virada
musical	musical
burgen	castelos
jersey	jersey
osnabrück	osnabrück
antworten	respostas
witwe	viúva
hart	hart
zeichnungen	desenhos
gerd	gerd
gespräch	conversa
kim	kim
year	year
jene	aqueles
bewertung	avaliação
genf	genebra
verdacht	suspeita
tokio	tóquio
erlebte	experimentou
junior	junior
ans	pnd
materialien	materiais
gelegenheit	oportunidade
schau	olha
obersten	supremo
onkel	tio
end	end
abstimmung	votação
wein	vinho
gegenteil	oposto
richtlinien	réguas
richtlinien	diretrizes
element	elemento
kapitän	capitão
weite	vastidão
bucht	baía
reiste	viajou
fortsetzung	continuação
natürliche	natural
büro	escritório
plattform	plataforma
auseinandersetzungen	confrontos
gewinnt	ganha
ulm	ulm
regelung	regulamentação
ard	ard
diplom	diploma
verfolgung	perseguição
motiv	motivo
usd	usd
kandidat	candidato
gray	gray
jura	jura
johanna	joana
versorgung	abastecimento
versorgung	aprovisionamento
straßburg	estrasburgo
alan	alan
may	may
temperatur	temperatura
komödie	comédia
fans	fãs
gehabt	tido
costa	costa
wiederaufbau	reconstrução
hollywood	hollywood
biographisches	biographisches
toronto	toronto
aufstand	revolta
ernennung	nomeação
bulgarien	bulgária
gesetze	leis
christopher	christopher
philadelphia	filadélfia
verbot	proibição
werkstatt	oficina
zellen	células
walther	walther
identität	identidade
tot	morto
boote	barcos
hagen	hagen
fotograf	fotógrafo
dicht	denso
hit	hit
can	can
elbe	elba
erscheinung	aparição
sang	cantou
kinos	cinemas
miller	miller
alex	alex
verhindert	evita
brigade	brigada
sed	sed
council	council
gitarrist	guitarrista
flugzeuge	aviões
michigan	michigan
howard	howard
viii	viii
steiermark	estíria
gewinner	vencedores
amerikaner	americanos
verzeichnet	alistado
gesundheit	saúde
premiere	estreia
niemals	nunca
marco	marco
verantwortung	responsabilidade
lorenz	lorenz
polnisch	polonês
klima	clima
sonstige	outros
unabhängige	independente
bestimmen	determinar
hamilton	hamilton
sorgen	preocupar
flug	voo
schatten	sombra
dan	dan
minnesota	minnesota
übersetzer	tradutor
ausgestellt	emitido
ersatz	substituição
erkennt	detecta
jagd	caça
volker	volker
sitzen	sentado
typisch	típico
betriebe	explorações
parks	parques
argumentation	raciocínio
verordnung	regulamento
verordnung	portaria
ministerium	ministério
anti	anti
express	express
begriffsklärung	desambiguação
german	portuguese
jim	jim
disziplin	disciplina
dokumente	documentos
lust	luxúria
chemische	química
point	point
basketball	basquetebol
florenz	florença
konferenz	conferência
sound	som
bamberg	bamberg
dokumentiert	documentado
vergleichbar	comparável
vergleichbar	comparáveis
lothar	lothar
ausgewählt	selecionado
wille	vontade
clemens	clemens
nutzte	aproveitou
death	death
tschechoslowakei	checoslováquia
are	are
julia	júlia
belagerung	cerco
sun	sun
francesco	francesco
motoren	motores
klinik	clínica
lippe	lábio
ern	ern
digital	digital
behauptung	alegação
schicksal	destino
act	act
entdeckte	descobriu
bibel	bíblia
unentschieden	empate
verschiebung	deslocamento
schwestern	irmãs
jahrzehnte	décadas
hubert	hubert
durchführung	execução
harvard	harvard
mengen	quantidades
nick	nick
sam	sam
dachte	pensou
conrad	conrad
romane	romances
jap	jap
fusion	fusão
fähigkeiten	habilidades
traditionell	tradicional
integration	integração
besonderheit	especificidade
valley	valley
ips	ips
pedro	pedro
festen	fixo
wiederherstellung	restauração
messe	feira
tim	tim
schlesien	silésia
ablauf	expiração
zimmer	quartos
zimmer	quarto
wahrnehmung	percepção
abgebrochen	cancelado
abgebrochen	cancelada
beschrieb	descreveu
bevorzugt	preferido
vereinen	unir
schlagzeuger	baterista
anwendungen	aplicações
bundestag	bundestag
dick	dick
gründeten	basearam
ehemann	marido
wachsen	crescer
eis	gelo
griff	alça
erfinder	inventor
samt	veludo
präfektur	prefeitura
abbildung	figura
archäologie	arqueologia
freundin	amiga
stamm	tribo
saß	sentou
willi	willi
berater	consultor
qualifiziert	qualificado
jury	júri
formal	formalmente
anwalt	advogado
beruht	assenta
konkurrenz	competição
geteilt	compartilhado
gesicht	cara
unfall	acidente
atlas	atlas
sterben	morrer
abschnitte	seções
zitiert	cita
zitiert	citados
einspruch	objecção
platte	placa
eroberung	conquista
sand	areia
scheinen	parecem
heide	heide
stadtrat	vereador
monte	monte
wesen	essência
brauerei	cervejaria
zeugen	testemunhas
roth	roth
gefahren	perigos
philip	philip
dateien	arquivos
slowakei	eslováquia
luther	luther
aufwand	esforço
formulierung	formulação
vögel	aves
kommunistischen	comunista
ursula	ursula
willy	willy
alice	alice
pflanze	planta
kämpfte	lutou
hund	cão
hütte	cabana
nachruf	obituário
briten	britânicos
jahrgang	safra
exil	exílio
soldat	soldado
eigentum	propriedade
leer	vazio
neapel	nápoles
entdeckung	descoberta
fuchs	raposa
verdient	merece
beobachten	observar
beobachten	observando
block	bloco
dokumentarfilm	documentário
angriffe	ataques
jens	jens
hell	hell
non	non
wörterbuch	dicionário
abgeordnete	deputados
ralf	ralf
gordon	gordon
niederlagen	derrotas
stift	caneta
maurice	maurice
missouri	missouri
abfluss	dreno
freundschaft	amizade
stärke	força
office	office
konkreten	concreto
overs	overs
elizabeth	elizabeth
wählte	escolheu
sekretär	secretário
fred	fred
johnny	johnny
testament	testamento
dei	dei
wand	parede
diözese	diocese
abgrenzung	demarcação
arm	braço
samen	sementes
kontakte	contatos
glocken	sinos
unterscheidung	distinção
unesco	unesco
peking	pequim
journalisten	jornalistas
pflege	cuidados
gewidmet	dedicado
hanau	hanau
wirklichkeit	realidade
corporation	corporação
bene	bene
hochzeit	casamento
formuliert	formulado
studios	estúdios
hms	hms
ltd	ltd
bbc	bbc
personal	pessoal
netzwerk	rede
ergab	revelou
verbände	associações
liest	lê
reihen	séries
neumann	neumann
steigt	sobe
festschrift	comemorativa
starben	morreram
technologie	tecnologia
#aaa	#aaa
wittenberg	wittenberg
nachricht	mensagem
bmw	bmw
infobox	infobox
gefangen	capturados
gregor	gregório
übernimmt	assume
ausgesprochen	pronunciado
statue	estátua
extra	extra
mythologie	mitologia
brachten	trouxeram
axel	axel
abraham	abraão
gestalten	moldar
verzeichnis	diretório
inhaber	titular
therapie	terapia
synonym	sinônimo
kommentare	comentários
hahn	galo
überflüssig	supérfluo
erwartet	esperado
erzeugen	gerar
meinungen	opiniões
flüsse	rios
kämpfe	lutas
million	milhão
global	global
abenteuer	aventura
jugoslawien	jugoslávia
könige	reis
nato	otan
verkaufen	vender
beherbergt	abriga
kreise	círculos
kroatien	croácia
teilnehmen	participar
giuseppe	giuseppe
territorium	território
kärnten	caríntia
wurzeln	raízes
sammlungen	coleções
thailand	tailândia
steine	pedras
racing	racing
luise	luísa
markiert	marcado
markiert	marca
neckar	neckar
gemessen	medido
instrumente	instrumentos
bischöfe	bispos
verluste	perdas
schwach	fraco
prince	prince
clark	clark
sterne	estrelas
gefällt	gosta
vorstellen	imaginar
vorstellen	imagine
breisgau	brisgóvia
benedikt	bento
zwecke	fins
erik	erik
angelegenheiten	assuntos
tote	mortos
marcel	marcel
enthielt	continha
erkannt	detectado
berger	berger
völker	povos
philippe	philippe
microsoft	microsoft
fabrik	fábrica
haupt	home
dauerte	durou
jahrhunderte	séculos
anmerkung	nota
anmerkung	observação
produktionen	produções
linux	linux
tausend	mil
duke	duke
training	treinamento
thüringer	thüringer
orange	laranja
übrig	sobra
tür	porta
syndrom	síndrome
sultan	sultão
zusammensetzung	composição
fliegen	voar
gedicht	poema
soziologie	sociologia
jimmy	jimmy
schild	escudo
hartmann	hartmann
explizit	explícito
römer	romanos
biologie	biologia
wisconsin	wisconsin
aires	aires
vermögen	fortuna
indiana	indiana
gefragt	perguntado
informiert	informado
anordnung	disposição
tanz	dança
glas	vidro
mayer	mayer
eingestuft	classificado
wladimir	vladimir
kauf	compra
anderson	anderson
atp	atp
bergbau	mineração
these	tese
ermöglichte	permitiu
gelöst	resolvido
geschätzt	estimado
waffe	arma
trugen	contribuíram
trugen	usavam
beurteilen	julgar
trio	trio
ice	ice
nahen	médio
charlie	charlie
negativ	negativo
senator	senador
kennzeichen	matrícula
entworfen	projetado
down	down
turin	turim
berichtete	relatou
verwandt	relacionado
typen	tipos
adams	adams
betreiber	operador
louise	louise
absicht	intenção
stanley	stanley
festivals	festivais
taucht	mergulha
pass	passaporte
nahrung	alimento
ärzte	médicos
sichern	backup
doktor	doutor
zugehörigkeit	pertença
fulda	fulda
verbrechen	crime
debatte	debate
eisen	ferro
seele	alma
becken	bacia
wdr	wdr
bit	bit
missbrauch	abuso
wiederhergestellt	restaurado
bogen	arco
ehrlich	honesto
kritisch	crítica
csu	csu
knoten	nó
realität	realidade
mercedes	mercedes
campus	campus
gebraucht	usado
stellvertreter	suplente
bäume	árvores
künstlerischen	artístico
napoleon	napoleão
fünfte	quinta
what	what
brücken	pontes
wars	wars
unmöglich	impossível
nicolas	nicolas
pferd	cavalo
vergleiche	comparações
vincent	vincent
queen	queen
chemnitz	chemnitz
wählen	escolher
intensiv	intenso
hinzugefügt	adicionado
övp	övp
hände	mãos
beweis	prova
säulen	pilares
duo	duo
udssr	urss
graben	vala
bus	ônibus
bataillon	batalhão
sarah	sarah
winkel	ângulo
erneuert	renova
gäbe	haveria
ausgerichtet	alinhado
bewegt	move
pferde	cavalos
erinnerungen	memórias
steiner	steiner
railway	railway
kriterium	critério
lutherischen	luterana
lüneburg	luneburgo
admiral	almirante
edgar	edgar
helsinki	helsínquia
sabine	sabine
alois	alois
vergleichsweise	comparativamente
greifswald	greifswald
wiesen	prados
edmund	edmund
vereinten	unida
boris	boris
höhle	caverna
bruce	bruce
palast	palácio
wahrscheinlichkeit	probabilidade
lyon	lyon
ausrichtung	alinhamento
magnus	magno
gefolgt	seguido
werft	estaleiro
freiwillige	voluntários
böse	maldade
manchester	manchester
gesellschaften	sociedades
back	back
serbien	sérvia
küche	cozinha
ontario	ontário
messen	feiras
dirk	dirk
badminton	badminton
geöffnet	aberto
zentral	central
schröder	schröder
definitiv	definitivamente
benz	benz
stirbt	morre
spö	spö
modus	modo
schuld	culpa
diego	diego
panzer	tanques
bitten	pedir
rekord	recorde
kevin	kevin
ausgesetzt	suspenso
verteilung	distribuição
restaurant	restaurante
piloten	pilotos
luzern	luzern
jane	jane
theorien	teorias
ruth	ruth
good	good
htm	htm
grau	cinza
moore	moore
krise	crise
billy	billy
pause	pausa
glocke	sino
entsprach	correspondia
entsprach	correspondeu
perspektive	perspectiva
armen	pobres
lissabon	lisboa
forscher	pesquisador
phänomen	fenômeno
einkommen	renda
mandat	mandato
kansas	kansas
opposition	oposição
dunkel	escuro
verbesserte	melhorou
logik	lógica
aufhebung	revogação
partie	lote
mischung	mistura
pour	pour
streng	severo
claus	claus
colorado	colorado
übersetzungen	traduções
kompositionen	composições
opera	opera
dichte	densidade
verursacht	causando
place	place
gnu	gnu
kopie	cópia
verzichtet	renuncia
enkel	neto
danzig	gdańsk
bevölkerungsdichte	ngm
experten	peritos
stieß	empurrou
ralph	ralph
normal	normal
besuchen	visitar
schafft	cria
reform	reforma
institution	instituição
paulo	paulo
mond	lua
gas	gás
verwaltet	gerido
verwaltet	gere
autos	carros
austausch	troca
finanzierung	financiamento
dringend	urgente
überzeugen	convencer
century	century
stone	stone
töten	matar
raymond	raymond
gesammelt	recolhida
dna	dna
anbau	cultivo
hammer	martelo
unterbrochen	interrompido
takt	compasso
glaubt	crê
glaubt	acredita
genehmigung	homologação
ausführlich	detalhado
ausnahmen	excepções
administrator	administrador
verletzung	lesão
eintritt	entrada
richtet	alinha
roy	roy
gottlieb	gottlieb
girl	girl
sozialistischen	socialista
spektrum	espectro
installiert	instalado
round	round
marketing	marketing
people	people
donald	donald
regelmäßige	regular
humboldt	humboldt
eier	ovos
oslo	oslo
eingeladen	convidado
suchte	procurou
zeitgleich	coincidindo
publizist	publicista
light	light
ross	ross
thai	tailandês
interessieren	interessar
antrieb	propulsão
urban	urban
jonathan	jonathan
memorial	memorial
gegangen	ido
nelson	nelson
beschäftigen	empregar
part	part
speyer	speyer
iowa	iowa
komplex	complexo
bayerischer	bayerischer
australian	australian
finanziert	financiado
überraschend	surpreendentemente
schichten	camadas
ten	ten
khan	khan
tsv	tsv
regen	chuva
mac	mac
fox	fox
verweist	remete
boxer	boxer
clubs	clubes
erhaltung	conservação
bell	bell
herzen	corações
verzichten	renunciar
passen	caber
diss	diss
denis	denis
litauen	lituânia
theologischen	teológico
einfügen	inserir
premier	premier
behielt	manteve
akten	limas
verbinden	ligar
rtl	rtl
ruhig	calma
planeten	planetas
just	just
verteidiger	defensor
second	second
artillerie	artilharia
steuern	impostos
wolff	wolff
welle	onda
versammlung	assembléia
richtlinie	directiva
sizilien	sicília
fifa	fifa
ablehnung	rejeição
zimmermann	zimmermann
kriege	guerras
antragsteller	requerente
melden	denunciar
nikolai	nikolai
mississippi	mississippi
mitgliedschaft	filiação
santiago	santiago
insekten	insetos
feat	feat
schulz	schulz
übernahmen	aquisições
claudia	claudia
spaß	diversão
vorläufer	precursor
verlässt	abandona
tennessee	tennessee
gen	gen
widerspruch	contradição
bedenken	preocupações
aufenthalt	estada
komponenten	componentes
walker	walker
privat	privado
var	var
versuchten	tentaram
tennis	tênis
hotels	hotéis
ghs	ghs
susanne	susanne
robin	robin
vertrauen	confiança
bier	cerveja
baby	bebê
berufung	vocação
spur	pista
gefeiert	comemorado
lieben	amar
lösungen	soluções
akzeptiert	aceita
cds	cds
irak	iraque
jordan	jordan
ian	ian
überprüfen	verificar
dead	dead
lieferte	forneceu
absolute	absoluto
schwaben	suábia
kaufen	comprar
forderungen	créditos
überreste	restos
ersetzte	substituiu
islamischen	islâmicos
informatik	informática
zeile	linha
antoine	antoine
zusammenfassung	resumo
platzierungen	posicionamentos
risiko	risco
bande	bando
veröffentlichen	publicar
cover	capa
auguste	auguste
philippinen	filipinas
lawrence	lawrence
metall	metal
lothringen	lorena
aufgelistet	listadas
borussia	borussia
mode	moda
update	atualização
geliefert	entregue
russell	russell
konstantin	constantino
dialog	diálogo
ann	ann
reinhold	reinhold
großvater	avô
gefühl	sentimento
gefühl	sensação
montreal	montreal
flugplatz	aeródromo
komponierte	compôs
wachstum	crescimento
gäste	convidados
passau	passau
qualifizieren	qualificar
vorteile	vantagens
ungewöhnlich	incomum
gärten	jardins
wolle	lã
berechnung	cálculo
videos	vídeos
kulturen	culturas
platten	placas
way	way
konflikte	conflitos
helden	heróis
gesamt	total
öffnen	abrir
arbeitgeber	empregadores
hört	ouçam
jochen	jochen
entscheidet	decide
schlägt	bate
pastor	pastor
besonderheiten	particularidades
korea	coreia
gebunden	vinculado
bedeutete	significava
bedeutete	significou
mdl	mdl
syrien	síria
dark	dark
zwanzig	vinte
nasa	nasa
geschäfte	lojas
temperaturen	temperaturas
umfassen	incluem
fake	fake
bayer	bayer
agnes	inês
berühmte	famosos
fleisch	carne
moschee	mesquita
zeichnet	desenha
verliert	perde
handball	handebol
slalom	slalom
orientiert	orientado
erweitern	expandir
pfund	libra
osmanischen	otomano
stationiert	situa
limburg	limburgo
frederick	frederick
beliebt	popular
fernando	fernando
bayreuth	bayreuth
erwähnten	mencionaram
abkommen	acordo
stuart	stuart
siedler	colonos
hot	hot
over	over
inn	inn
kanzel	púlpito
gehandelt	agido
gehandelt	agiu
bewohnt	habitado
laden	loja
laden	carregar
bewertet	avaliado
weser	weser
guy	guy
zweig	ramo
felder	campos
spannung	tensão
volle	pleno
dave	dave
achse	eixo
fan	fã
bewegungen	movimentos
christentum	cristianismo
fähigkeit	capacidade
fürstentum	principado
verletzungen	lesões
triebwagen	automotoras
bgb	bgb
reaktionen	reacções
schmid	schmid
tobias	tobias
greift	ataca
lutz	lutz
continental	continental
facebook	facebook
kraftwerk	usina
tisch	mesa
page	page
korrigiert	corrigido
starten	iniciar
angegriffen	atacado
huber	huber
reagiert	reage
betont	realça
vfl	vfl
faktoren	fatores
behörde	autoridade
skulpturen	esculturas
banken	bancos
coburg	coburgo
geographie	geografia
zeichnung	desenho
kai	kai
kentucky	kentucky
behandeln	tratar
gekauft	comprei
gekauft	comprado
loch	buraco
koordinaten	coordenadas
matt	matt
kaserne	quartel
boy	boy
beweisen	provar
verständlich	compreensível
mars	marte
pacific	pacific
gewöhnlich	tipicamente
langhaus	maloca
indianer	índios
ferrari	ferrari
maus	rato
edinburgh	edimburgo
peru	peru
heart	heart
verliebt	apaixonada
bibliotheken	bibliotecas
sendungen	remessas
kuba	cuba
stört	incomoda
unnötig	desnecessário
organist	organista
lloyd	lloyd
strand	praia
verglichen	comparado
erhöhen	aumentar
kavallerie	cavalaria
begleitete	acompanhou
motto	lema
norm	norma
notwendigkeit	necessidade
zulässig	autorizado
zulässig	permitido
zählten	contaram
caspar	caspar
besiegte	derrotou
entwarf	projetou
miguel	miguel
half	ajudou
wall	wall
afghanistan	afeganistão
moderator	moderador
rückgängig	desfazer
vereinigt	unida
adel	nobreza
vize	vice
pas	pas
bat	bat
hubraum	cilindrada
gary	gary
map	map
qualifizierten	qualificados
stewart	stewart
ursachen	causas
befreiung	isenção
zoll	alfândega
hingerichtet	executado
zeigten	mostraram
wunder	maravilha
kindergarten	creche
bottom	bottom
erkannte	reconheceu
finger	dedo
geheimnis	segredo
andy	andy
lost	lost
stufen	degraus
java	java
ebenen	níveis
mountain	mountain
versteckt	escondido
est	est
schlüssel	chave
katholiken	católicos
strafe	punição
brust	peito
gulden	florim
erwähnte	mencionou
lisa	lisa
court	court
angekündigt	anunciou
planet	planeta
mozart	mozart
angewandte	aplicada
einflüsse	influências
vorsitz	presidência
traum	sonho
allianz	aliança
pietro	pietro
barock	barroco
pilot	piloto
abgebildet	mapeados
universal	universal
verstorben	faleceu
geologie	geologia
melbourne	melbourne
lausanne	lausanne
teilt	compartilha
verwandte	parentes
unterkategorien	subcategorias
kampagne	campanha
nba	nba
beobachtung	observação
detail	detalhe
felsen	rocha
arme	braços
airlines	airlines
blog	blog
malerin	pintora
wiederwahl	reeleição
erfindung	invenção
xii	xii
reichweite	alcance
hals	pescoço
schlösser	fechaduras
olympia	olympia
johan	johan
margaret	margaret
arizona	arizona
sprung	salto
franklin	franklin
bde	bde
flüchtlinge	refugiados
koalition	coligação
skulptur	escultura
interpretiert	interpreta
rue	rue
vermittlung	mediação
area	area
informieren	informar
seminar	seminário
substanz	substância
harris	harris
generationen	gerações
vancouver	vancouver
bestätigte	confirmou
ausrüstung	equipamento
versorgt	provê
ronald	ronald
freiwillig	voluntário
minderheit	minoria
peters	peters
niederländisch	holandês
beamten	funcionários
klagenfurt	klagenfurt
kupfer	cobre
lincoln	lincoln
sandstein	arenito
bedeuten	significam
field	field
marken	marcas
studieren	estudar
rezension	revisão
fische	peixes
schiller	schiller
sven	sven
kleidung	roupa
erlaubnis	permissão
eingeschränkt	restrito
norman	norman
atmosphäre	atmosfera
siemens	siemens
mini	mini
ernest	ernest
geprüft	verificado
kreuzer	cruzador
erdbeben	sismo
besaßen	possuíam
son	son
feier	comemoração
rückseite	verso
lokomotive	locomotiva
propaganda	propaganda
spalte	coluna
southern	southern
oswald	oswald
fremde	estranhos
lkw	caminhão
registriert	registrado
abbildungen	retratos
verschwinden	desaparecer
magdalena	madalena
spenden	doações
earth	earth
boys	boys
mdr	mdr
monarchie	monarquia
bestätigen	confirmar
scharf	afiada
frisch	frescos
frisch	fresco
kelly	kelly
alabama	alabama
dokument	documento
loire	loire
audio	áudio
kette	corrente
schicht	camada
alberto	alberto
mittelmeer	mediterrâneo
faktor	fator
connecticut	connecticut
persönlichkeit	personalidade
kaliningrad	kaliningrado
zusatz	adição
guido	guido
xvi	xvi
abbau	degradação
vietnam	vietname
strategie	estratégia
uruguay	uruguai
liechtenstein	liechtenstein
holocaust	holocausto
siegel	selo
quer	transversal
hamm	hamm
auschwitz	auschwitz
zeitgenössische	contemporânea
detroit	detroit
emma	emma
krankheiten	doenças
bukarest	bucareste
mans	mans
maine	maine
entlassung	despedimento
kongo	congo
stämme	tribos
grob	grosseiramente
dialekt	dialecto
philologie	filologia
hofmann	hofmann
grimm	grimm
merkmal	característica
engineering	engenharia
browser	navegador
konsul	cônsul
draft	draft
eintracht	concórdia
götter	deuses
vfb	vfb
lass	deixa
harz	resina
beitragen	contribuir
lars	lars
kopiert	copiado
schiedsrichter	árbitro
dünn	magro
bestimmungen	disposições
mauern	muros
berechnet	calculado
verlieren	perder
gefangenschaft	cativeiro
henning	henning
comics	quadrinhos
umfassenden	abrangente
sainte	sainte
moon	moon
teufel	diabo
notre	notre
rugby	rugby
verarbeitet	processa
verarbeitet	processados
riga	riga
kameramann	cinegrafista
madonna	madonna
roberto	roberto
bedeutend	significando
vorfahren	antepassados
ressourcen	recursos
laura	laura
zeichnen	desenhar
bürgerschaft	cidadania
vorträge	palestras
marianne	marianne
mathias	mathias
mont	mont
belgrad	belgrado
maryland	maryland
abhängigkeit	dependência
ankunft	chegada
mörder	assassino
sofia	sofia
abu	abu
glasgow	glasgow
heller	heller
emanuel	emanuel
kohle	carvão
graham	graham
caroline	caroline
marokko	marrocos
nordischen	nórdico
wrestling	wrestling
ryan	ryan
demo	demo
renault	renault
turner	turner
einnahmen	receitas
dorothea	doroteia
kreuzung	cruzamento
kritisierte	criticou
gilbert	gilbert
verschwunden	desapareceu
ausgang	saída
estland	estónia
startet	lança
clara	clara
nad	nad
sierra	serra
forest	forest
meißen	meißen
trennen	separar
sogn	sogn
stralsund	stralsund
spezialisiert	especializado
spezialisiert	especializada
kennedy	kennedy
karin	karin
händler	revendedor
mönchengladbach	mönchengladbach
durchschnitt	média
singen	cantar
camp	camp
minden	minden
campbell	campbell
mind	mind
beine	pernas
techniken	técnicas
asteroiden	asteróides
franco	franco
überprüfung	revisão
böden	solos
option	opção
stade	stade
lukas	lucas
morgan	morgan
ständigen	permanente
porsche	porsche
flecken	manchas
äußerte	exprimiu
äußerte	expressou
japanisch	japonês
sat	sat
fliehen	fugir
stoffe	substâncias
château	château
fraglich	questionável
steven	steven
parker	parker
empfangen	recebido
diff	diff
pflicht	obrigação
talent	talento
fire	fire
türkisch	turco
passagiere	passageiros
wusste	sabia
theologische	teológica
hanns	hanns
thompson	thompson
konstantinopel	constantinopla
henriette	henriette
four	four
robinson	robinson
decken	cobertores
hop	hop
wünsche	desejos
dennis	dennis
nachbarn	vizinhos
ernährung	nutrição
bologna	bolonha
vergleichen	comparar
björn	björn
gestrichen	suprimido
kolumbien	colômbia
download	download
dublin	dublin
gabriele	gabriele
planck	planck
springen	saltar
aktivität	atividade
luigi	luigi
gedruckt	impresso
abteilungen	divisões
störungen	perturbações
ken	ken
halbe	meia
louisiana	louisiana
nachweisbar	indetectável
taiwan	taiwan
vorzeitig	prematuramente
aufzeichnungen	registos
aufzeichnungen	registros
amazon	amazon
teilgenommen	participado
shakespeare	shakespeare
löscht	apaga
labor	laboratório
gleichnamige	homónima
samstag	sábado
lehmann	lehmann
med	med
student	estudante
schwäbisch	schwäbisch
berühmt	famoso
garden	garden
geehrt	honrado
jonas	jonas
held	herói
wüste	deserto
adolph	adolph
mhz	mhz
uci	uci
carter	carter
princeton	princeton
latein	latim
fortgesetzt	continuado
atlanta	atlanta
hip	hip
antwerpen	antuérpia
kaiserslautern	kaiserslautern
bks	bks
invasion	invasão
muhammad	muhammad
northern	northern
julian	julian
nil	nilo
alternativen	alternativas
sant	sant
altenburg	altemburgo
abc	abc
herrscht	reina
schaffung	criação
kiew	kiev
hard	hard
uraufgeführt	estreada
faust	punho
vita	vita
unverändert	inalterado
evans	evans
holding	holding
apple	apple
schwanz	cauda
fisch	peixe
thron	trono
rapper	rapper
ozean	oceano
konservatorium	conservatório
redundanz	redundância
senior	senior
more	more
cooper	cooper
rechner	calculadora
ulmer	ulmer
schubert	schubert
brigitte	brigitte
barry	barry
other	other
patent	patente
knochen	ossos
ack	ack
veb	veb
posen	poses
wenzel	wenzel
pionier	pioneiro
type	type
metz	metz
harold	harold
brothers	brothers
tests	testes
lebenslauf	currículo
alkohol	álcool
gene	gene
trasse	traçado
silva	silva
bemerkenswert	notável
menschheit	humanidade
produzieren	produzindo
produzieren	produzir
ehre	honra
toll	ótimo
vorwort	prefácio
tropischen	tropical
miami	miami
shanghai	xangai
vertretung	representação
fauna	fauna
abriss	demolição
protokoll	protocolo
athleten	atletas
lahn	lahn
baker	baker
ethnischen	étnicos
copa	copa
udo	udo
vortrag	palestra
ausgehend	partindo
dienstleistungen	serviços
subsp	subsp
hansen	hansen
catherine	catherine
standorte	localizações
aufteilung	repartição
erwachsene	adultos
philosophen	filósofos
dicke	espessura
note	toque
han	han
vielfalt	diversidade
wettbewerbe	competições
rowohlt	rowohlt
heiraten	casar
murray	murray
archäologe	arqueólogo
austin	austin
zelle	célula
wälder	florestas
schließung	encerramento
ausgelöst	acionado
indian	indian
maßnahme	medida
echo	echo
kunsthalle	kunsthalle
grundlegende	básico
rüdiger	rüdiger
konzentration	concentração
interviews	entrevistas
ansprüche	reivindicações
kabel	cabo
have	have
keramik	cerâmica
bismarck	bismarck
monika	monika
flensburg	flensburg
pakistan	paquistão
grant	grant
löwe	leão
gerechtfertigt	justificado
gerechtfertigt	justificada
pädagogik	pedagogia
melodie	melodia
beratung	consultoria
boeing	boeing
beschäftigung	emprego
mängel	deficiências
challenge	challenge
salvador	salvador
saarland	sarre
dakota	dakota
rache	vingança
dutzend	dúzia
egon	egon
utrecht	utrecht
kategorisierung	categorização
tiger	tigre
päpstlichen	papais
finanziell	financeiramente
verließen	sairam
lichtenberg	lichtenberg
wang	wang
liverpool	liverpool
identifiziert	identificado
roll	roll
broadway	broadway
jason	jason
alaska	alasca
soul	soul
barocke	barroca
matthew	matthew
plant	plant
helene	helene
angela	angela
syn	syn
ruprecht	ruprecht
religionen	religiões
romanische	românica
freigegeben	liberado
head	head
leonard	leonard
disney	disney
helm	capacete
ruinen	ruínas
offenbach	offenbach
sky	sky
köhler	köhler
vision	visão
jorge	jorge
kilogramm	quilograma
messung	medição
bassist	baixista
schwert	espada
elsass	alsácia
schlagen	bater
phoenix	phoenix
italia	italia
nature	nature
eisenach	eisenach
gewerkschaft	sindicato
touristen	turistas
oregon	oregon
christina	christina
normen	normas
agentur	agência
age	age
blüte	floração
punk	punk
dell	dell
digitalen	digital
joan	joan
bremerhaven	bremerhaven
tabellen	tabelas
wahlperiode	legislatura
einladung	convite
slowenien	eslovénia
disziplinen	disciplinas
alltag	cotidiano
jerry	jerry
türken	turcos
hawaii	havaí
jules	jules
mine	mina
überleben	sobrevivência
gelassen	deixado
école	école
anpassung	adaptação
flach	plana
entwickler	desenvolvedor
schwedisch	sueco
kostenlos	livre
under	under
tausende	milhares
anwesenheit	presença
freude	alegria
prototyp	protótipo
rotterdam	roterdão
effekte	efeitos
gletscher	glaciares
versenkt	afundado
offs	offs
erzähler	narrador
operationen	operações
haute	haute
homburg	homburg
montana	montana
wayne	wayne
dessau	dessau
verwundet	ferido
klöster	mosteiros
anfänge	começos
kaiserin	imperatriz
meier	meier
morris	morris
gertrud	gertrud
größen	tamanhos
dnb	dnb
öffnung	abertura
petra	petra
lebensmittel	alimentos
objektiv	objetiva
geometrie	geometria
bosnien	bósnia
now	now
zerstörer	destruidor
wright	wright
wohnsitz	residência
independent	independent
alpha	alpha
studiert	estuda
berkeley	berkeley
illustrationen	ilustrações
richtungen	direcções
burschenschaft	burschenschaft
schnee	neve
gerald	gerald
angel	angel
hartmut	hartmut
funk	funk
herrmann	herrmann
troll	troll
mythos	mito
schumacher	schumacher
sin	sin
begangen	cometido
ansätze	abordagens
designer	designer
verstand	mente
fühlt	sente
türen	portas
valentin	valentin
brandt	brandt
oklahoma	oklahoma
ignoriert	ignorado
überwachung	monitorização
chinesisch	chinês
gerechtigkeit	justiça
folglich	conseqüentemente
bett	cama
vorarlberg	vorarlberg
verlangen	exigir
angemessen	adequado
dynamo	dínamo
drehen	rodar
angeben	especificar
venezuela	venezuela
astronom	astrónomo
nina	nina
ingrid	ingrid
krüger	krüger
umwandlung	conversão
rosenberg	rosenberg
chaos	caos
zoo	zoo
bezahlt	pago
cornelius	cornelius
bobby	bobby
interne	interna
imo	omi
gem	gem
weihnachten	natal
laien	leigo
dekan	decano
häftlinge	detidos
russen	russos
basilika	basílica
zyklus	ciclo
konzepte	conceitos
ndr	ndr
heiliger	santo
tendenz	tendência
garcía	garcía
beibehalten	manter
orleans	orleans
orleans	orleães
anstieg	aumento
eddie	eddie
vorbereitet	preparado
landschaften	paisagens
years	years
baltimore	baltimore
kannte	conhecia
fotografen	fotógrafos
mund	boca
berthold	berthold
löst	resolve
xiv	xiv
reformen	reformas
sklaven	escravos
weinbau	viticultura
griechen	gregos
individuelle	individual
fair	justo
scheitern	fracasso
spitzen	pontas
mohammed	maomé
mohammed	mohammed
gattin	esposa
arkansas	arkansas
indonesien	indonésia
reagieren	reagir
bedingung	condição
paolo	paolo
tagebuch	diário
ethik	ética
britisch	britânico
entdecken	descobrir
gestapo	gestapo
lit	lit
marshall	marshall
handwerk	artesanato
most	most
houston	houston
adrian	adrian
reichlich	abundante
gefallenen	caídos
kaffee	café
agent	agente
zagreb	zagreb
verbesserungen	melhorias
schien	parecia
schien	pareceu
grey	grey
krakau	cracóvia
gesendet	enviado
zypern	chipre
jeff	jeff
geezer	geezer
zwang	coerção
germania	germânia
unterart	subespécie
komplexe	complexos
our	our
hut	chapéu
milch	leite
jon	jon
schmitt	schmitt
hills	hills
beeinflussen	afetar
beeinflussen	influenciar
bug	bug
meilen	milhas
wta	wta
freizeit	lazer
motorrad	moto
peer	peer
wellen	ondas
verbreiteten	espalharam
car	car
burgund	borgonha
partnerschaft	parceria
erfordert	requer
pauli	pauli
brot	pão
xiii	xiii
marseille	marselha
hugh	hugh
chen	chen
leon	leon
french	french
beethoven	beethoven
mönche	monges
krefeld	krefeld
tommy	tommy
ungarisch	húngaro
rgb	rgb
görlitz	görlitz
glatt	liso
erwerb	aquisição
stiegen	aumentaram
run	run
anime	anime
kairo	cairo
haltestelle	paragem
bittet	pede
olaf	olaf
bewusstsein	consciência
berufliche	profissional
avenue	avenida
let	let
small	small
schumann	schumann
remix	remix
lorenzo	lorenzo
renate	renate
masters	masters
tschechisch	checo
angebote	ofertas
zugewiesen	atribuído
reifen	pneus
wolfram	tungsténio
roberts	roberts
komitee	comitê
hirsch	veado
augsburger	augsburger
unterarten	subespécies
speicher	memória
nancy	nancy
hunter	hunter
get	get
krieger	guerreiro
umstände	circunstâncias
systematisch	sistemática
eichstätt	eichstätt
eastern	eastern
selbstverlag	selbstverlag
delta	delta
armin	armin
brockhaus	brockhaus
ivan	ivan
erwünscht	desejado
edwin	edwin
kent	kent
matthäus	mateus
bond	bond
aluminium	alumínio
dimension	dimensão
schönheit	beleza
sauerstoff	oxigénio
mitchell	mitchell
marion	marion
rasse	raça
ingolstadt	ingolstadt
zähne	dentes
cottbus	cottbus
freuen	alegrar
gültig	válido
sri	sri
systematische	sistemática
satelliten	satélite
umgehen	contornar
symbole	ícones
germanischen	germânica
theo	theo
medaillen	medalhas
abbruch	demolição
spannungen	tensões
bricht	quebra
sony	sony
verarbeitung	transformação
empfohlen	recomendado
bundesautobahn	bundesautobahn
five	five
frühling	primavera
raf	raf
akzeptieren	aceitar
gräber	túmulos
ansbach	ansbach
collins	collins
terry	terry
gleichung	equação
sockel	soquete
erlaubte	permitiu
mögen	gostar
schulze	schulze
traditionen	tradições
six	six
hunde	cães
krebs	câncer
fett	gordo
anzeigen	mostrar
alain	alain
wiederholen	repetir
historique	historique
astronomie	astronomia
decke	teto
achim	achim
wohnt	mora
schritte	passos
geschafft	consegui
michail	mikhail
linden	linden
globe	globe
ulrike	ulrike
nicholas	nicholas
jubiläum	jubileu
schnabel	bico
palästina	palestina
wilfried	wilfried
still	still
eingeleitet	iniciados
beobachter	observadores
bilanz	balanço
fürth	fürth
mtv	mtv
alias	alias
bestätigung	confirmação
mühlen	moinhos
libretto	libreto
wiederherstellen	restaurar
massaker	massacre
suffix	sufixo
rudolph	rudolph
umgangssprachlich	coloquialmente
woman	woman
matrix	matriz
ähnlichkeit	semelhança
verteidigte	defendeu
empfehlung	recomendação
bedrohung	ameaça
landung	aterragem
dallas	dallas
offensive	ofensiva
pole	pole
herman	herman
besiegt	derrotado
krause	krause
entwürfe	rascunhos
schwimmen	natação
early	early
abkürzungen	abreviaturas
protest	protesto
messina	messina
bsg	zpe
kugel	esfera
kosovo	kosovo
delegation	delegação
färbung	coloração
pest	peste
genehmigt	aprovado
universum	universo
gespräche	conversações
biathlon	biatlo
wärme	calor
ordentlichen	ordinário
kommerzielle	comercial
korrigieren	corrigir
mechanische	mecânica
moor	moor
ward	ward
ehrungen	homenagens
commonwealth	commonwealth
hohenzollern	hohenzollern
malta	malta
sitzung	reunião
sitzung	sessão
bolivien	bolívia
nrhp	nrhp
wood	wood
seoul	seul
verpflichtung	obrigação
warner	warner
lernt	aprende
verträge	contratos
perfekt	perfeito
kommunisten	comunistas
ngc	ngc
definieren	definir
augustin	augustin
konto	conta
busse	autocarros
mineral	mineral
work	work
holger	holger
kommissar	comissário
präsentierte	apresentou
dream	dream
grammatik	gramática
lustig	engraçado
landshut	landshut
silver	silver
case	case
upper	upper
filter	filtro
hölle	inferno
beat	beat
grade	grade
mönch	monge
plateau	planalto
befreien	libertar
amateur	amador
popularität	popularidade
oberhausen	oberhausen
laurent	laurent
wolfenbüttel	volfembutel
rechtsprechung	jurisprudência
martha	martha
pan	pan
übersetzen	traduzir
erhard	erhard
hunderte	centenas
trainiert	treina
kings	kings
taunus	taunus
damm	barragem
genua	génova
cook	cook
rum	rum
warren	warren
erzählen	contar
nigeria	nigéria
its	its
christiane	christiane
paare	casais
blood	blood
set	set
rechtfertigen	justificar
protagonisten	protagonistas
administratoren	administradores
gelernt	aprendi
auslegung	interpretação
haushalt	orçamento
marschall	marechal
installation	instalação
kaspar	kaspar
ecken	cantos
speichern	salvar
schuss	tiro
freundlich	amigável
zylinder	cilindro
vorschlagen	sugerir
portugiesisch	português
wähler	eleitores
days	days
nachteil	desvantagem
gramm	gramas
abgekürzt	abreviado
wände	paredes
genres	gêneros
chancen	oportunidades
stören	perturbar
gastgeber	anfitrião
denkt	pensa
kämpfer	lutador
charlottenburg	charlottenburg
blumen	flores
wünschen	desejar
venus	vênus
schema	esquema
alexandra	alexandra
split	split
rosen	rosas
keith	keith
beigetragen	contribuiu
beigetragen	contribuído
fis	fis
statistische	estatística
renommierten	renome
tante	tia
einstellungen	configurações
selbständig	independente
nazi	nazista
pfarrhaus	reitoria
hudson	hudson
fdl	fdl
diktatur	ditadura
lehrerin	professora
nase	nariz
ebert	ebert
finanzen	finanças
jungfrau	virgem
marsch	marcha
brooklyn	brooklyn
verbandsgemeinde	verbandsgemeinde
tel	tel
herder	herder
doppelte	dupla
eiförmig	ovóide
heine	heine
teilchen	partícula
kong	kong
achtung	atenção
buddhismus	budismo
zufall	coincidência
jay	jay
suite	suite
massive	massive
salz	sal
monaco	mônaco
guillaume	guillaume
export	exportação
future	future
helen	helen
normandie	normandia
larry	larry
ghana	gana
yale	yale
find	find
administrativ	administrativamente
there	there
regierungen	governos
wilden	selvagens
deep	deep
manhattan	manhattan
volleyball	voleibol
urlaub	férias
neffe	sobrinho
plural	plural
baptiste	baptiste
julie	julie
oldid	oldid
inspiriert	inspirado
rafael	rafael
metro	metro
regina	regina
feind	inimigo
fortschritt	progresso
schickte	enviou
untersuchte	examinou
untersuchte	investigou
dachau	dachau
sms	sms
anatomie	anatomia
strauss	strauss
raketen	mísseis
steuer	imposto
bull	boi
bull	bull
irene	irene
aussterben	extinção
aussprache	pronúncia
perry	perry
aufgeben	desistir
trainierte	treinou
kurve	curva
rettung	salvamento
fotografiert	fotografada
ems	ems
empfänger	destinatário
iucn	uicn
konsequent	consistente
erläuterung	explicação
edith	edith
gewerkschaften	sindicatos
playoffs	playoffs
tatsachen	fatos
bois	bois
glücklich	feliz
demokraten	democratas
rakete	foguete
ausgleich	compensação
wallace	wallace
unverständlich	incompreensível
abschaffung	abolição
helena	helena
increment	increment
moses	moisés
singapur	cingapura
pablo	pablo
baut	constrói
mülheim	mülheim
toulouse	toulouse
neunten	nono
muslime	muçulmanos
heyne	heyne
miles	miles
ellen	ellen
fell	pêlo
zitate	citações
places	places
arno	arno
bemerkungen	observações
cleveland	cleveland
santos	santos
gefangene	prisioneiros
geiger	geiger
freud	freud
minor	minor
god	god
situationen	situações
kontrolliert	controla
piper	piper
algerien	argélia
kanzler	chanceler
provence	provença
jülich	jülich
verwaltungsgemeinschaft	verwaltungsgemeinschaft
streitigkeiten	litígios
kenneth	kenneth
passagen	passagens
revue	revue
franziska	francisca
newton	newton
aufführungen	performances
katastrophe	catástrofe
mdb	mdb
summer	summer
lords	lordes
neutralität	neutralidade
after	after
ignaz	ignaz
true	true
quartett	quarteto
flandern	flandres
bristol	bristol
waldeck	waldeck
namibia	namíbia
verteilen	distribuir
univ	univ
salomon	salomon
erika	erika
but	but
atlantik	atlântico
pont	pont
zusammenbruch	colapso
marina	marina
gehalt	salário
sauber	limpo
when	when
flöte	flauta
forstwirtschaft	silvicultura
ideologie	ideologia
herzogin	duquesa
harrison	harrison
diana	diana
handschrift	caligrafia
nazis	nazis
ron	ron
landwirt	agricultor
heilig	sagrado
malaysia	malásia
strahlung	radiação
eintragung	inscrição
vera	vera
internen	interno
alexandria	alexandria
ergänzungen	adições
psychiatrie	psiquiatria
ohren	orelhas
labour	trabalhista
ruft	chamem
trennt	separa
bush	bush
variiert	varia
vorherige	anterior
bordeaux	bordéus
elite	elite
ostfriesland	ostfriesland
elias	elias
astronomen	astrônomos
abwesenheit	ausência
bibliographie	bibliografia
rallye	rali
abb	fig
kraus	kraus
pädagogischen	pedagógico
einstein	einstein
motivation	motivação
ungeeignet	inadequado
apostel	apóstolo
mrs	mrs
spalten	colunas
wolfsburg	wolfsburg
singer	singer
widmen	dedicar
aufsicht	supervisão
ancient	ancient
ausgegeben	gasto
eurovision	eurovisão
gutachten	pareceres
bock	bock
winkler	winkler
match	match
erneuerung	renovação
firefox	firefox
colin	colin
phasen	fases
kombiniert	combinado
brecht	brecht
olga	olga
italiener	italianos
het	het
musikvideo	videoclipe
gezeichnet	desenhado
gefühle	sentimentos
atlantic	atlantic
anhang	anexo
schulden	dívida
barth	barth
naturforscher	naturalista
nebel	nevoeiro
carmen	carmen
ffffff	ffffff
codex	codex
turniere	torneios
gesichtet	avistado
gerichtsbarkeit	jurisdição
hedwig	edviges
susan	susan
exemplar	exemplar
veit	veit
analysen	análises
treppe	escadas
winterthur	winterthur
oberpfalz	oberpfalz
holmes	holmes
dramatiker	dramaturgo
ware	mercadoria
kantone	cantões
heck	heck
hardware	hardware
stolz	orgulho
göttin	deusa
electric	electric
stärken	fortalecer
schweigen	silêncio
elektronik	eletrônica
helga	helga
instanz	instância
geologe	geólogo
witz	brincadeira
munition	munição
vegas	vegas
neil	neil
kramer	kramer
utah	utah
celle	celle
trek	trek
brett	brett
unterhaltung	entretenimento
allan	allan
gutenberg	gutenberg
kosmos	cosmos
kontinent	continente
castro	castro
götz	götz
happy	happy
föderation	federação
nutzten	aproveitaram
haas	haas
symptome	sintomas
hopkins	hopkins
unwahrscheinlich	improvável
jahn	jahn
nfl	nfl
species	species
rohr	tubo
danny	danny
maier	maier
dean	dean
ringe	anéis
sort	sort
ausgedrückt	expressa
längengrad	longitude
albanien	albânia
angreifer	atacante
valencia	valencia
unterzeichnet	assinado
toni	toni
emden	emden
schlachten	batalhas
marmor	mármore
kant	kant
katze	gata
judith	judith
erweiterungen	extensões
adalbert	adalberto
sternbild	constelação
bedeutungen	significados
justus	justus
monster	monstro
call	call
landau	landau
statistiken	estatísticas
pos	pos
sorten	variedades
liberal	liberal
march	march
paula	paula
alb	alb
hampshire	hampshire
landen	aterrar
stanford	stanford
senioren	idosos
imdb	imdb
rudi	rudi
record	record
konservative	conservadores
ludwigshafen	ludwigshafen
limited	limited
höhlen	grutas
äthiopien	etiópia
harten	duras
birmingham	birmingham
kopieren	copiar
hob	pegou
hob	levantei
gestanden	confessou
alba	alba
zucker	açúcar
ida	ida
singt	canta
gisela	gisela
short	short
sigmund	sigmund
gelebt	vivi
société	société
haare	cabelo
nicole	nicole
transkription	transcrição
lucius	lúcio
abzug	dedução
circle	circle
zwickau	zwickau
getreide	cereais
sigismund	sigismund
fpö	fpö
sozialismus	socialismo
doris	doris
sexuelle	sexual
madison	madison
magic	magic
respekt	respeito
zentren	centros
tambon	tambon
büros	escritórios
rundschau	rundschau
überschritten	excedido
überschritten	ultrapassou
repertoire	repertório
protestantischen	protestante
synchronsprecher	dubladores
angekommen	chegou
joint	joint
oma	vovó
only	only
audi	audi
tipp	dica
tödlich	fatal
freiburger	freiburger
zufrieden	satisfeito
widerspricht	contradiz
veraltet	obsoleto
bozen	bolzano
butler	mordomo
knight	knight
ethnien	etnias
vegetation	vegetação
gehirn	cérebro
born	born
anschließende	subsequente
primera	primera
empfehlen	recomendar
armstrong	armstrong
into	into
dauern	duram
ludwigsburg	ludwigsburg
humor	humor
meiningen	meiningen
montiert	montado
emmy	emmy
hannes	hannes
kessel	caldeiras
messer	faca
friederike	frederica
legion	legião
ergo	ergo
aristoteles	aristóteles
expansion	expansão
sakristei	sacristia
side	side
schlag	soco
schlag	golpe
industrialisierung	industrialização
igor	igor
erheben	cobrar
freising	frisinga
zensur	censura
nachteile	desvantagens
dreieck	triângulo
intelligenz	inteligência
pol	pol
mediawiki	mediawiki
experte	especialista
pmid	pmid
augusta	augusta
warte	espera
skandal	escândalo
bauch	barriga
fördert	promove
logos	logos
low	low
seattle	seattle
grundsatz	princípio
fächer	leque
apsis	abside
bio	bio
theologen	teólogos
arbeitnehmer	trabalhadores
watson	watson
their	their
iris	íris
burgenland	burgenland
wiese	prado
seltsam	estranho
überzeugung	convicção
gasse	beco
nannten	chamaram
treu	fiel
kunststoff	plástico
folk	folk
erwartungen	expectativas
werkzeug	ferramenta
tauchen	mergulho
ibm	ibm
sophia	sophia
unvollständig	incompleto
georgien	geórgia
zerstören	destruir
illustrator	ilustrador
anschlag	batente
heimlich	secretamente
verletzte	feridos
tus	tus
weltweiten	mundial
reinhardt	reinhardt
getestet	testado
cousin	primo
ungültig	inválido
queensland	queensland
moser	moser
dietz	dietz
jeanne	jeanne
herzegowina	herzegovina
secret	secret
hinzufügen	adicionar
statuen	estátuas
armut	pobreza
libanon	líbano
flog	voou
fine	fine
lieutenant	tenente
protein	proteína
organe	órgãos
organisieren	organizar
dänisch	dinamarquês
vorwärts	avante
betrag	montante
mathilde	matilde
gran	gran
freiberg	freiberg
blind	cego
apostolische	apostólica
mohr	mohr
böhlau	böhlau
gonzález	gonzález
leidenschaft	paixão
glockenturm	campanário
thriller	thriller
gitarristen	guitarristas
eifel	eifel
kostete	custou
amadeus	amadeus
con	con
geraden	reta
tell	tell
opel	opel
rita	rita
angelo	angelo
martina	martina
brechen	quebrando
brechen	quebrar
isabella	isabella
ville	ville
arnsberg	arnsberg
künstliche	artificial
motorsport	motorsport
ernähren	alimentar
trust	trust
pays	pays
müll	lixo
honda	honda
palermo	palermo
handwerker	artesão
verwandtschaft	parentesco
beute	presa
elektrisch	elétrico
veranstalter	organizadores
rechtschreibung	ortografia
panorama	panorama
moral	moral
tallinn	tallinn
never	never
judentum	judaísmo
romeo	romeu
kasachstan	cazaquistão
vollzogen	consumado
nils	nils
scottish	scottish
märtyrer	mártir
explosion	explosão
theoretischen	teórico
larven	larvas
rangers	rangers
contemporary	contemporary
drogen	drogas
arabisch	árabe
gewässern	águas
kurse	cursos
bautzen	bautzen
terror	terror
bewahren	preservar
rhône	ródano
soziologe	sociólogo
tibet	tibete
homo	homo
ewald	ewald
untersuchen	investigar
jefferson	jefferson
algebra	álgebra
pascal	pascal
homosexualität	homossexualidade
zeuge	testemunha
hope	hope
billboard	billboard
bowl	bowl
edwards	edwards
jenny	jenny
sevilla	sevilha
inszenierte	encenou
birgit	birgit
korrektur	correção
holt	holt
telekom	telekom
wöchentlich	semanal
ideal	ideal
communes	communes
tff	tff
spencer	spencer
hardy	hardy
unsicher	inseguro
äbtissin	abadessa
angestellte	empregados
ram	ram
verkürzt	encurtado
olivier	olivier
schmuck	jóias
innovation	inovação
craig	craig
musikalisch	musicalmente
dumont	dumont
boten	mensageiros
flüssigkeit	líquido
altona	altona
steinbruch	pedreira
mähren	morávia
häfen	portos
alessandro	alessandro
mix	mix
gfdl	gfdl
aka	aka
umfrage	enquete
else	else
werkzeuge	ferramentas
jennifer	jennifer
schilling	xelim
bemerkung	observação
aufgewachsen	cresceu
allgäu	allgäu
sandra	sandra
cannes	cannes
tänzerin	bailarina
tänzerin	dançarina
anklage	acusação
brauche	preciso
weiden	pastagens
lettland	letónia
sammler	colecionadores
aktualisiert	atualizado
regisseurin	realizadora
apollo	apollo
sudan	sudão
stimmte	votou
bewerten	avaliar
mut	coragem
arms	arms
achsen	eixos
enterprise	enterprise
prominente	celebridades
lüttich	liège
algorithmus	algoritmo
einhaltung	cumprimento
uno	uno
uno	onu
étienne	étienne
cars	cars
watt	watt
balthasar	baltazar
reis	arroz
bär	urso
slam	slam
gert	gert
ecuador	equador
ilse	ilse
rosenheim	rosenheim
trinken	beber
nachhaltig	sustentável
potter	potter
kategorisiert	categorizados
pazifik	pacífico
duell	duelo
verschwindet	desaparece
verringert	diminui
zahlung	pagamento
third	third
nathan	nathan
ausländer	estrangeiros
spitz	spitz
guatemala	guatemala
portland	portland
spam	spam
annette	annette
geliebte	amada
aufkommen	advento
optische	óptica
willem	willem
leonardo	leonardo
flash	flash
havel	havel
verbringen	passar
#default	#default
messungen	medições
unterstützer	apoiantes
vergabe	adjudicação
risiken	riscos
herzöge	duques
beleidigung	ofensa
simone	simone
besuchten	visitados
take	take
inter	inter
fühlen	sentir
bratislava	bratislava
potok	potok
ming	ming
grace	grace
elektronen	elétrons
klassisch	clássico
mosel	mosela
stuhl	cadeira
neffen	sobrinhos
beweise	provas
neuhaus	neuhaus
republikaner	republicanos
minderheiten	minorias
einschränkungen	restrições
some	some
biologische	biológica
nützlich	útil
wiedergewählt	reeleito
druckerei	tipografia
lambert	lambert
dog	dog
buchhandlung	livraria
modernisierung	modernização
angeklagt	acusado
stilistisch	estilisticamente
vermont	vermont
schädel	crânio
toyota	toyota
stiftungen	fundações
schuster	sapateiro
make	make
nepomuk	nepomuk
formulieren	formular
beschreibungen	descrições
mbh	mbh
thesen	teses
kate	kate
hanna	hanna
gregory	gregory
pictures	pictures
return	return
cia	cia
taufe	batismo
kompetenz	competência
fordern	exigindo
kay	kay
chur	chur
schmitz	schmitz
pittsburgh	pittsburgh
prosa	prosa
bosch	bosch
fiktiven	fictício
irish	irish
mechanik	mecânica
karosserie	carroçaria
sigmaringen	sigmaringen
unterbrechung	interrupção
nachname	sobrenome
spezifischen	específico
pädagogische	pedagógica
geladen	carregado
here	here
manuskript	manuscrito
fasst	resume
landgraf	landgraf
pölten	pölten
lehnt	rejeita
ausbreitung	propagação
montevideo	montevidéu
neuss	neuss
beta	beta
tunesien	tunísia
diagnose	diagnóstico
npov	npov
justin	justin
rebellen	rebeldes
saur	saur
konzil	concílio
tochtergesellschaft	filial
großmutter	avó
maurer	pedreiro
extreme	extreme
ostern	páscoa
saga	saga
ravensburg	ravensburg
frist	prazo
schienen	trilhos
terminal	terminal
spring	spring
fähig	capaz
trend	tendência
währung	moeda
umgestaltung	remodelação
telefon	telefone
feinde	inimigos
fiat	fiat
fragmente	fragmentos
opus	opus
justice	justice
nordwest	noroeste
hong	hong
kostet	custa
