centered	gesentreer
centered	gesentreerde
bolivia	bolivië
forget	vergeet
implies	impliseer
halifax	halifax
toll	toll
monk	monk
extraordinary	extraordinary
lessons	lesse
pub	pub
pub	kroeg
paralympics	paralympics
monte	monte
maría	maría
segments	segmente
deer	takbokke
deer	takbok
wireless	wireless
wireless	draadloos
wireless	draadlose
mysterious	mysterious
mysterious	geheimsinnige
consultant	konsultant
fraser	fraser
formats	formate
chicken	hoender
enable	geaktiveer
enable	aktiveer
idol	afgod
idol	idol
reid	reid
amazing	amazing
amazing	ongelooflik
pet	troeteldier
upset	ontsteld
loves	liefhet
loves	lief
stretch	strek
stretch	rek
louisville	louisville
hopkins	hopkins
eds	eds
goddess	godin
satisfy	bevredig
voltage	spanning
betty	betty
geology	geologie
cyclone	sikloon
export	verstryk
lightning	weerlig
impressed	beïndruk
logical	logies
logical	logiese
aggressive	aggressief
jin	jin
fbi	fbi
yankees	yankees
ludwig	ludwig
pond	dammetjie
suburban	suburban
moments	oomblikke
interim	interim
lucky	lucky
lucky	gelukkig
targeted	geteiken
targeted	geteikende
lon	lon
speedway	speedway
toy	speelding
toy	toy
bicycle	fiets
interactions	interaksies
arcade	arcade
arcade	arkade
lecture	lesing
dragons	dragons
copa	copa
careful	versigtig
nurse	nurse
nurse	verpleegster
supplement	supplement
lens	lens
commands	opdragte
trend	trend
trend	tendens
trend	neiging
superintendent	superintendent
gerald	gerald
rap	rap
geneva	geneva
ash	ash
blade	blade
array	skikking
loose	loose
boom	boom
sailors	matrose
smoke	smoke
assassination	sluipmoord
lancaster	lancaster
reynolds	reynolds
divorce	egskeidings
divorce	egskeiding
dust	stof
saxon	saksiese
healthcare	gesondheidsorg
separately	afsonderlik
separately	apart
grain	graan
translations	vertalings
zimbabwe	zimbabwe
cohen	cohen
diving	duik
diving	diving
carroll	carroll
accounting	boekhou
accounting	rekeningkundige
accounting	rekeningkunde
mesa	mesa
prussia	pruise
intelligent	intelligente
cherry	cherry
underlying	underlying
tobacco	tabak
bench	bench
directions	aanwysings
directions	voorskrifte
ellen	ellen
measurement	meting
measurement	mate
measurement	mates
measurement	maatreëls
paradise	paradise
alexandria	alexandrië
alexandria	alexandria
witch	heks
witch	hekse
attraction	aantrekkingskrag
attraction	aantreklikheid
diana	diana
personalities	persoonlikhede
colleagues	kollegas
busy	besig
cia	cia
rankings	wêreldranglys
aboriginal	aboriginal
salem	salem
wagner	wagner
americas	amerikas
instructor	instrukteur
nobility	nobility
divorced	geskei
tomorrow	môre
tomorrow	more
manuscripts	manuscripts
unified	vereenselwig
scouts	scouts
silva	silva
derek	derek
agenda	agenda
provision	verskaffing
provision	voorsiening
humanity	humanity
admit	erken
trinidad	trinidad
distant	verre
burke	burke
circles	sirkels
shrine	shrine
sail	sail
willie	willie
karnataka	karnataka
celebrate	vier
ranch	ranch
vampire	vampire
sick	siek
associates	associates
heinrich	heinrich
ethiopia	ethiopia
ethiopia	ethiopië
flags	vlae
flags	gemerk
flags	vlaggies
drove	gery
shorts	kortbroek
drives	drives
drives	skywe
autobiography	outobiografie
edwin	edwin
velocity	velocity
velocity	snelheid
terminology	terminology
raiders	raiders
brighton	brighton
viola	viola
para	para
morrison	morrison
propulsion	propulsion
boxer	boxer
shoulder	skouer
disabled	gestremde
disabled	geaktiveer
disabled	afgeskakel
div	div
ernst	ernst
innocent	onskuldige
innocent	onskuldig
innocent	innocentius
innocent	innocent
rapper	rapper
settle	betaal
settle	vereffen
privacy	privaatheid
boeing	boeing
cites	cites
indo	indo
indo	sersant
distinguish	onderskei
rosa	rosa
thermal	termiese
flute	fluit
marines	marines
feminist	feminist
trustees	trustees
nationally	landswyd
bacteria	bakterie
landmarks	bakens
disorders	kwale
prevention	voorkoming
honored	geëerd
healthy	gesonde
circus	sirkus
circus	circus
burma	burma
sec	sekondes
sec	sek
quiet	stille
quiet	quiet
knee	knie
hypothesis	hipotese
referendum	referendum
estonian	estniese
pastor	pastor
sofia	sofia
tribune	tribune
lasting	langdurige
permit	permit
priority	prioriteit
pounds	ponde
cent	cent
consequence	consequence
rica	rica
furniture	meubels
furniture	meubelstuk
macdonald	macdonald
honest	eerlike
innovative	innoverend
innovative	innoverende
estimate	skatting
estimate	beraming
estimate	skat
atp	atp
rotation	rotasie
syracuse	syracuse
obscure	obscure
kosovo	kosovo
classics	classics
julius	julius
appreciated	appreciated
naples	napels
sebastian	sebastian
barnes	barnes
exceptions	uitsonderings
martha	martha
quarters	quarters
drawings	tekeninge
barely	effens
barely	skaars
hitting	kolf
refuge	refuge
maharashtra	maharashtra
conventions	gebruike
elliott	elliott
unused	ongebruikte
searches	soektogte
brigadier	brigadier
particle	deeltjie
malayalam	malayalam
thursday	donderdag
icon	ikoon
ulster	ulster
genes	genes
infinite	oneindige
vale	vale
portraits	portraits
paste	plak
randy	randy
saxony	sakse
annie	annie
excessive	buitensporig
believing	meen
rhine	ryn
mineral	mineraal
implement	implement
implement	implementeer
surgeon	chirurg
badge	kenteken
charleston	charleston
infection	infeksie
electron	elektron
walt	walt
cnn	cnn
tonight	vanaand
confederation	konfederasie
accommodate	akkommodeer
casino	casino
aux	aux
guatemala	guatemala
settings	stellings
settings	verstellings
mask	masker
shelter	skuiling
dorothy	dorothy
ethnicity	etnisiteit
hopefully	hopelik
elimination	eliminasie
heath	heath
pregnant	swanger
richards	richards
theodore	theodore
theodore	fjodor
theodore	theodorus
delegates	afgevaardigdes
blair	blair
fac	fac
phrases	frases
crashed	omgeval
preference	voorkeur
janeiro	janeiro
concerto	concerto
bits	bisse
bits	bits
construct	konstrueer
tune	tune
unofficial	unofficial
bulk	grootmaat
lighthouse	vuurtoring
stan	stan
highland	highland
mascot	mascot
acceptance	aanvaarding
hub	spil
mess	mess
wilderness	wilderness
routine	roetine
dozens	dosyne
spotted	spotted
spotted	gevlekte
harmony	harmonie
entrepreneur	entrepreneur
wwe	wwe
apollo	apollo
runway	runway
naked	naked
anton	anton
moses	moses
legally	legally
fake	valse
fake	fake
biased	biased
división	división
equity	equity
reliability	betroubaarheid
tenor	tenoor
tenor	tenor
pocket	pocket
pocket	broeksak
sad	hartseer
troy	troy
treasure	treasure
ion	ion
rendered	gelewer
roberto	roberto
adoption	aanneem
decrease	verminder
reserved	gereserveer
crop	snoei
licensing	lisensiëring
collecting	collecting
trumpet	trompet
johnston	johnston
norton	norton
collector	collector
cluster	cluster
dear	liewe
georges	georges
roller	troupant
roller	roller
clothes	klere
sovereign	sovereign
enhanced	verhewe
enhanced	verbeterde
compensation	vergoeding
consent	toestemming
outline	buitelyn
holdings	holdings
jorge	jorge
darkness	donkerte
penalties	strafskoppe
hometown	tuisdorp
blow	blow
cooking	kook
cooking	kookkuns
vfd	vfd
aftermath	aftermath
rican	ricaanse
chip	chip
consciousness	bewussyn
consciousness	consciousness
archaeology	argeologie
latvia	letland
blogs	blogs
hardy	hardy
stamp	stamp
stamp	stempel
fur	pels
estimates	skattings
estimates	beramings
lit	lit
ritual	ritual
trace	trace
marble	marmer
marble	marble
foundations	foundations
nottingham	nottingham
derivative	afgeleide
boxers	boksers
dimension	dimensie
dimension	dimension
crawford	crawford
tanzania	tanzanië
succeed	slaag
motto	motto
motto	leuse
dirty	stoute
dirty	vuil
hayes	hayes
xbox	xbox
likes	likes
genres	genres
galleries	galleries
forbes	forbes
councils	councils
adequate	voldoende
bach	bach
alias	alias
counsel	counsel
comprising	comprising
tough	tough
tough	lot
advertisement	advertensie
protagonist	hoofkarakter
trails	spore
claire	claire
bruno	bruno
dylan	dylan
bag	sak
churchill	churchill
witnesses	getuies
thames	thames
anybody	anybody
kazakhstan	kasakstan
bots	bots
bots	botte
bots	robotte
constitute	constitute
presenting	aangebied
highlights	hoogtepunte
jumping	spring
prof	prof
slovak	slowaaks
skull	skedel
skull	skull
hoped	gehoop
mandatory	verpligtend
stern	stern
fees	gelde
bet	bie
bet	bet
dancers	dansers
quantity	hoeveelheid
quantity	aantal
quantity	kwantiteit
endorse	onderskryf
cairo	kaïro
graves	graves
sue	sue
barrier	barrier
creatures	skepsels
logan	logan
erik	erik
leicester	leicester
silence	stilte
jessica	jessica
plateau	plateau
finite	eindige
walsh	walsh
zones	sones
murders	moorde
paragraphs	paragrawe
costume	kostuum
bike	bike
neighborhoods	woonbuurte
imprisonment	uitdien
suffolk	suffolk
forwards	vorentoe
remarkable	merkwaardig
remarkable	remarkable
tin	tin
garcia	garcia
madagascar	madagaskar
madagascar	madagascar
cameras	kameras
ammunition	ammunisie
fires	fires
fires	vure
explore	verken
builder	bouer
minneapolis	minneapolis
bullet	koeël
bullet	bullet
kerry	kerry
subway	subway
arrow	pyl
economist	ekonoom
bread	brood
lou	lou
strategies	strategieë
rubber	rubber
precise	presiese
rifles	rifles
cognitive	kognitiewe
governorate	governorate
nest	nes
slam	slam
ancestry	ancestry
portsmouth	portsmouth
miscellany	miscellany
audiences	gehore
joshua	joshua
casey	casey
attract	lok
kilometres	kilometer
pump	pomp
feeding	feeding
feeding	voering
prey	prey
ain	ain
diary	dagboek
vulnerable	kwesbare
dubai	dubai
michelle	michelle
lebanese	lebanese
productive	produktiewe
productive	produktief
guided	begeleide
happening	gebeur
accordingly	accordingly
della	della
upgraded	opgegradeer
equality	gelykheid
philosophers	filosowe
spacecraft	ruimtetuig
trap	lokval
clara	clara
invitation	uitnodiging
expertise	kundigheid
sacramento	sacramento
certification	sertifisering
supposedly	veronderstel
governance	governance
frog	padda
mhz	mhz
secular	secular
spa	spa
publicity	publisiteit
armoured	armoured
watts	watts
gibraltar	gibraltar
fever	koors
melody	melody
melody	melodie
supporter	ondersteuner
jeffrey	jeffrey
useless	useless
swift	swift
tuesday	dinsdag
silly	laf
silly	silly
empress	empress
newman	newman
scales	skale
beatles	beatles
clergy	predikante
clergy	predikant
jacksonville	jacksonville
sara	sara
lifestyle	leefstyl
bee	bee
baltic	baltiese
brandon	brandon
loaded	gelaaide
loaded	gelaai
evangelical	evangeliese
evangelical	evangelies
enterprises	ondernemings
enterprises	enterprises
imo	imo
mature	volwasse
physically	fisies
sequences	herhalings
breast	breast
beast	beast
beast	monster
raja	raja
griffin	griffin
rhodes	rhodes
itv	itv
ana	ana
ceiling	plafon
rainbow	reënboog
demon	demoon
demon	demon
prussian	pruisiese
prussian	prg
equations	vergelykings
answered	beantwoord
ist	ist
perception	perception
entities	entiteite
jackie	jackie
dynamics	dynamics
fiji	fiji
insufficient	onvoldoende
algebra	algebra
homer	homer
johns	johns
bce	bce
chaos	chaos
chang	chang
layers	lae
crater	koepel
crater	krater
chad	chad
webster	webster
excess	oortollige
hurling	hurling
ashley	ashley
dot	punt
dot	dot
gif	gif
translator	vertaler
cowboys	cowboys
counted	getel
hanging	hang
soprano	sopraan
interviewed	interviewed
workshops	werkswinkels
liked	gehou
nascar	nascar
teenage	teenage
graduates	gegradueerdes
jungle	jungle
ballot	ballot
placement	plasing
fairy	barry
fairy	fairy
tourists	toeriste
tourists	tourists
romans	romeine
rpm	rpm
diploma	diploma
circa	circa
environments	omgewings
swan	swan
swan	swaan
carpenter	carpenter
carpenter	skrynwerker
boris	boris
berry	bessie
berry	berry
invention	uitvinding
southampton	southampton
prairie	prairie
bend	bend
app	toepassing
explicit	eksplisiet
explicit	eksplisiete
slight	ligte
maxwell	maxwell
planes	planes
everyday	alledaagse
oriental	oosterse
airing	uitsendings
coordinator	koördineerder
bombs	bomme
mohammad	mohammad
superman	superman
philippe	philippe
philippe	filip
felix	felix
bengali	bengali
greene	greene
voluntary	vrywillige
voluntary	vrywillig
floating	swewende
floating	wissel
montenegro	montenegro
mann	mann
flooding	vloede
escort	escort
astronomy	sterrekunde
sudden	skielike
skiing	ski
timothy	timothy
cello	tjello
rafael	rafael
sphere	sfeer
rewrite	herskryf
georg	georg
canvas	doek
chest	chest
chest	borskas
chest	kassie
krishna	krishna
provider	verskaffer
frances	frances
crowned	gekroonde
cabin	hut
cabin	kajuit
cabin	cabin
civilization	beskawing
broader	breër
tongue	tong
newer	nuwer
eliminate	elimineer
panels	panele
darwin	darwin
cheese	kaas
easter	paasfees
rat	rat
rat	rot
debates	debatte
informal	informele
cry	huil
cry	cry
loyal	lojaal
loyal	loyal
loyal	lojale
surfaces	oppervlaktes
nicolas	nicolas
madonna	madonna
worcester	worcester
cooperative	koöperatiewe
substantially	aansienlik
trips	reise
trips	uitstappies
winston	winston
llc	llc
drake	drake
fountain	fontein
consulting	konsultasie
tends	geneig
patricia	patricia
garcía	garcía
quit	bedank
quit	sluit
rid	ontslae
rid	uid
maple	maple
aberdeen	aberdeen
verb	werkwoord
illustrations	illustrations
illustrations	illustrasies
mechanisms	meganismes
reds	reds
reds	rooi
posters	plakkate
leipzig	leipzig
santo	santo
engaging	aantreklik
roland	roland
telecommunications	telekommunikasie
strait	strait
misleading	misleidende
misleading	misleidend
misleading	wanvoorstelling
sherman	sherman
stefan	stefan
sleeping	slaap
sleeping	slapende
alto	alto
thomson	thomson
directing	aanstuur
prehistoric	prehistoric
communicate	kommunikeer
alphabet	alfabet
zagreb	zagreb
chef	chef
chef	sjef
carnegie	carnegie
eighteen	agtien
shirt	hemp
weird	weird
weird	vreemd
edges	rande
plantation	kolonisasie
vernon	vernon
acre	akker
wonderful	wonderlik
wonderful	heerlik
missiles	missiele
guides	gidse
finger	vinger
savage	savage
rely	staatmaak
shoes	skoene
climbing	klim
barrel	vat
biographies	biographies
spite	spyte
spite	spite
assembled	assembled
ham	ham
hon	hon
geoffrey	geoffrey
valve	valve
histories	geskiedenisse
osaka	osaka
beck	beck
analog	analoog
monkey	apie
monkey	aap
listening	listening
integrity	integriteit
definitions	definisies
critically	feitlik
operas	operas
baldwin	baldwin
objections	objections
marina	marina
detection	opsporing
sixty	sestig
differential	differential
linguistic	linguistiese
venus	venus
salmon	salmon
salmon	salm
monarchy	monargie
stade	stade
francesco	francesco
abortion	aborsie
elephant	olifant
polar	polêre
trademark	handelsmerk
provisional	provisional
counting	counting
counting	tel
corn	mielies
corn	koring
corn	mielie
trucks	vragmotors
trucks	bakkies
trucks	trokke
sank	gesink
deutsche	deutsche
par	par
tension	tension
pablo	pablo
aviv	aviv
judgement	oordeel
catalina	catalina
disasters	rampe
lesbian	lesbian
rays	strale
walks	walks
realm	realm
trailer	sleepwa
trailer	lokprent
janet	janet
tornado	tornado
aunt	tannie
distribute	versprei
genesis	genesis
shallow	shallow
makers	skeppers
makers	makers
mentioning	mentioning
floors	floors
scattered	verstrooide
boyfriend	kêrel
consolidated	saamgevat
luther	luther
pleasure	plesier
webb	webb
alberto	alberto
magical	magiese
magical	magical
deliberately	opsetlik
sacrifice	sacrifice
sacrifice	opoffering
faction	fraktion
olive	olive
olive	olyf
compatible	aanpasbaar
compatible	versoenbaar
molecules	molekules
kiev	kiëf
vista	vista
castro	castro
preceded	voorafgegaan
pleasant	aangenaam
miscellaneous	allerlei
miscellaneous	diverse
miscellaneous	verskeie
lineup	besetting
ultra	ultra
nowhere	nêrens
bulletin	bulletin
clinic	kliniek
itunes	itunes
pollution	besoedeling
herman	herman
sally	sally
rex	rex
stuck	stuck
stuck	vasgehaak
proceeded	voortgegaan
afghan	afghaanse
vatican	vatikaan
folklore	folklore
cruiser	cruiser
princes	princes
silk	silk
agreements	ooreenkomste
eng	eng
stamps	stamps
stamps	seëls
harder	harder
consumers	verbruikers
cage	hok
ferguson	ferguson
correspondence	korrespondensie
illustrates	illustreer
tehran	teheran
cheshire	cheshire
amanda	amanda
employer	werkgewer
tibetan	tibettaanse
nixon	nixon
sociology	sosiologie
recreational	recreational
capability	lancelot
addressing	aanspreek
panthers	panthers
objection	beswaar
systematic	stelselmatig
violated	geskend
chocolate	sjokolade
helsinki	helsinki
bedford	bedford
cambodia	kambodja
cambodia	cambodia
grandmother	ouma
rounded	gerond
fitness	fiksheid
halls	sale
midlands	midlands
jung	jung
brilliant	brilliant
brilliant	ongelooflike
brilliant	briljante
libya	libië
angela	angela
creature	diertjie
gather	vergader
gather	bymekaar
volcanic	volcanic
android	android
mentor	mentor
freeman	freeman
apartments	woonstelle
uci	uci
puppet	puppet
carey	carey
hiding	wegkruip
meyer	meyer
gameplay	spel
lima	lima
kirk	kirk
kirk	damara
batteries	batterye
chains	kettings
ucla	ucla
recover	onklaar
wong	wong
ear	oor
combine	kombineer
decent	ordentlike
hawk	hawk
cumberland	cumberland
rational	rasionale
altar	altar
organize	rangskik
organize	organiseer
exhibits	bewysstukke
determination	bepaling
determination	vasberadenheid
chennai	chennai
dong	dong
threshold	drumpel
myanmar	mianmar
proud	trots
surveillance	observasie
threatening	dreigend
threatening	dreigende
threatening	dreig
allegiance	allegiance
discharge	ontslag
discharge	ontlaai
penny	penny
kannada	kannada
astronomical	astronomiese
petroleum	petroleum
bug	fout
chapman	chapman
mud	mud
honey	heuning
diagram	diagram
infringement	skending
broadcaster	uitsaaier
complexity	complexity
riley	riley
displacement	displacement
sponsor	borg
ira	ira
careers	loopbane
haiti	haiti
haiti	haïti
wisdom	wysheid
pierce	pierce
stupid	dom
alma	alma
alexandra	alexandra
continuously	voortdurend
continuously	deurlopend
continuously	heeltyd
shuttle	shuttle
hampton	hampton
eva	eva
mickey	mickey
atlético	atlético
yuan	yuan
johannes	johannes
ecclesiastical	ecclesiastical
trunk	trommel
genuine	genuine
adolf	adolf
sharon	sharon
acquire	verkry
corrected	reggestel
corrected	korrigeer
gardner	gardner
artifacts	artifacts
mandate	mandaat
terrible	verskriklike
terrible	terrible
revived	herleefde
reagan	reagan
rebecca	rebecca
toledo	toledo
indefinitely	onbepaald
divide	verdeel
recommendations	aanbevelings
gymnastics	gimnastiek
alter	alter
ideology	ideologie
carriers	diensverskaffers
constantinople	konstantinopel
fatal	fatale
bulls	bulle
bulls	bulls
harassment	teistering
favorable	gunstig
bore	bore
inserted	ingesit
paramount	paramount
luxury	luukse
luxury	luxury
yahoo	yahoo
ecology	ekologie
reviewers	proeflesers
emirates	emirates
neutrality	neutrality
chronicles	chronicles
deployment	ontplooiing
lepidoptera	vlinder
blast	vernietig
jenkins	jenkins
omaha	omaha
detected	opgespoor
detected	bespeur
attribution	toeskrywing
harsh	kras
bundesliga	bundesliga
monarchs	monarge
hermann	hermann
morton	morton
echo	ego
echo	echo
bangkok	bangkok
bergen	bergen
hawks	hawks
availability	beskikbaarheid
organizing	organizing
lung	long
andreas	andreas
cedar	cedar
flagship	flagship
spirits	geeste
spirits	spirits
torture	marteling
toyota	toyota
wheat	koring
membrane	membrane
coleman	coleman
homeland	bantoestan
dhaka	dhaka
dental	tandheelkunde
christine	christine
curious	nuuskierig
curious	eienaardige
tucker	tucker
evolutionary	evolusionêre
responsibilities	verantwoordelikhede
viscount	burggraaf
ffffff	ffffff
pavilion	pavilion
fantastic	fantasties
ceremonies	ceremonies
augustus	august
loans	lenings
joey	joey
corporations	korporasies
moss	mos
moss	moss
yield	oplewer
yield	opbrengs
sizes	groottes
sizes	grotes
armored	gewapende
neighbourhood	woonbuurt
cheap	goedkoop
stuttgart	stuttgart
dialects	dialekte
backup	rugsteun
forbidden	verbode
sanskrit	sanskrit
neill	neill
knife	knife
knife	mes
wade	wade
humanities	geesteswetenskappe
gonzález	gonzález
yesterday	yesterday
yesterday	gister
percy	percy
transform	transformeer
vegetation	plantegroei
tickets	kaartjies
dams	dams
throws	throws
plural	meervoud
filmmaker	filmmaker
habitats	habitats
sicily	sisilië
zip	poskode
zip	zip
updates	opdaterings
updates	bywerkings
updates	wysigings
replied	geantwoord
restriction	beperking
lin	lin
measurements	maatreëls
courthouse	hof
tide	gety
laps	laps
dynamo	dynamo
predicted	voorspelde
poker	poker
kane	kane
trevor	trevor
reprinted	reprinted
attractive	aantreklike
sidney	sidney
factual	feitelik
holidays	vakansiedae
holidays	vakansies
wondering	gewonder
initiatives	ondernemings
initiatives	inisiatiewe
comfortable	gemaklik
outlets	gevestigde
fletcher	fletcher
airways	airways
floyd	floyd
snail	slak
genocide	volksmoord
saga	saga
scots	sco
kingdoms	koninkryke
commissioners	kommissarisse
smoking	rook
leather	leer
def	def
patch	lap
unreliable	onbetroubaar
porto	porto
valencia	valencia
tracy	tracy
downloaded	afgelaai
breakfast	ontbyt
subspecies	subspesie
andhra	andhra
mercy	mercy
botanical	botaniese
peaks	pieke
bottle	bottel
tunisia	russies
tunisia	tunisië
angola	angola
decorations	versierings
slide	gly
slide	skuif
invalid	ongeldig
invalid	ongeldige
trapped	vasgevang
trapped	vasgekeer
rao	rao
guru	guru
freshwater	freshwater
telescope	teleskoop
satisfied	tevrede
coral	gespikkelde
xavier	xavier
obituary	huldeblyk
helena	helena
anatomy	anatomy
binary	binêre
wound	wonde
conviction	skuldigbevinding
dixon	dixon
kuwait	kuwait
suffer	suffer
nsw	nsw
blacklisted	blacklisted
nord	nord
caves	caves
regent	regent
riverside	riverside
shane	shane
balanced	gebalanseerd
balanced	gebalanseerde
fitzgerald	fitzgerald
highlight	hoogtepunt
highlight	verlig
payments	betalings
lópez	lopez
joyce	joyce
belle	belle
davidson	davidson
rouge	rouge
rockets	rockets
cure	genees
bolton	bolton
manning	manning
boyd	boyd
organisms	organismes
paraguay	paraguay
preview	besigtig
preview	voorskou
preview	oorleg
dodgers	dodgers
qatar	katar
qatar	qatar
buddy	maatjie
iucn	iubn
dock	dock
clare	clare
penguin	pikkewyn
rapids	rapids
exceptional	uitsonderlik
papal	papal
cologne	keulen
cologne	cologne
beings	beings
beings	wesens
norwich	norwich
challenging	uitdagende
anthem	anthem
supervision	toesig
ming	ming
lease	verhuur
yours	joune
cecil	cecil
toys	speelgoed
conrad	conrad
bulldogs	bulldogs
italia	italia
portable	psp
portable	portable
portable	draagbare
dell	dell
irving	irving
bells	bells
composite	saamgestelde
councillors	raadslede
salary	loon
salary	salaris
blacks	blacks
enhance	verbeter
sysop	sysop
dropping	drop
smallest	kleinste
smallest	oorleg
caesar	caesar
tragedy	tragedie
macedonian	macedoniese
unesco	unesco
cameroon	kameroen
carson	carson
slot	slot
slot	gleuf
icelandic	yslands
sophie	sophie
granite	granite
jenny	jenny
apostolic	apostolic
apostolic	apostoliese
pirate	pirate
pirate	seerower
paralympic	paralimpiese
slovenian	sloweens
accompanying	gepaardgaande
seasonal	seisoenale
portfolio	portfolio
machinery	masjinerie
embedded	ingebedde
embedded	ingelegde
embedded	ingebed
keen	keen
gandhi	gandhi
fiscal	fiscal
testimony	testimony
duchess	hertogin
reflection	refleksie
middlesex	middlesex
carr	carr
booth	booth
rudolf	rudolf
león	león
courage	moed
midland	midland
pier	pier
formatting	instellings
formatting	formatering
woodland	woodland
auction	veiling
cbc	cbc
specifications	spesifikasies
acclaim	asketisme
secrets	secrets
secrets	geheime
crest	crest
sutton	sutton
decreased	afgeneem
ups	ups
bypass	ompad
bypass	bypass
prominence	prominensie
slopes	hellings
phantom	phantom
hartford	hartford
alps	alpe
cet	cet
investments	beleggings
auburn	auburn
flame	vlam
exeter	exeter
din	din
kay	kay
rent	huur
highlands	hoogland
verses	verses
crane	crane
simulation	simulasie
latitude	breedtegraad
lance	lance
wanderers	wanderers
fixing	regmaak
asset	bate
prospect	prospekt
prejudice	prejudice
highlighted	gemerk
gymnasium	gymnasium
gloria	gloria
trent	trent
yemen	jemen
riot	oproer
quinn	quinn
excluded	uitgesluit
excluded	gevoer
elena	elena
anger	woede
hierarchy	hiërargie
decoration	versiering
disability	gestremdheid
giuseppe	giuseppe
exceed	oorskry
scan	skandeer
rca	rca
pioneers	pioniers
canberra	canberra
flowing	vloeiende
fungi	fungus
sensors	sensors
cottage	kothuis
honduras	honduras
resides	woonagtig
shepherd	shepherd
shepherd	herdershond
reservation	bespreking
elderly	bejaardes
pbs	pbs
mapping	mapping
mongolia	angola
mongolia	mongolia
commentator	kommentator
nash	nash
sharks	sharks
ricky	ricky
shirley	shirley
exercises	oefeninge
destroyers	destroyers
mild	mild
vikings	vikings
correspondent	correspondent
reproduction	voortplanting
sings	sing
mercedes	mercedes
compliance	nakoming
bombay	bombay
barack	barack
premises	perseel
hawaiian	hawaise
poly	poly
rené	rené
screenshot	skermkiekie
imported	ingevoer
imported	ingevoerde
transactions	transaksies
statute	statute
jerome	jerome
shark	shark
shark	haai
shark	haaie
choices	keuses
doom	doom
bare	bare
raids	gestroop
diagnosis	diagnose
referencing	referencing
firearms	vuurwapens
stoke	stoke
bride	bride
bride	bruid
selective	selektiewe
criminals	misdadigers
lindsay	lindsay
advocates	verkondig
automotive	motorvoertuie
worry	worry
heating	verhitting
rushing	storm
radius	radius
johan	johan
inactive	onaktief
celebrities	bekendes
meta	meta
estadio	estadio
rehabilitation	rehabilitasie
synonym	sinoniem
asserted	asserted
corp	corp
leone	leone
sailor	matroos
racism	rassisme
negro	negers
tears	tears
tears	trane
inspection	inspeksie
inspection	insae
ancestors	voorvaders
honda	honda
barn	barn
controller	beheerder
assert	beweer
abbreviated	afgekorte
encounters	encounters
fruits	fruits
ruby	ruby
lunch	middagete
nationalism	nationalism
photographers	fotograwe
mick	mick
classroom	klaskamer
btw	btw
delegate	delegeer
forums	forums
challenger	challenger
recommendation	aanbeveling
shi	shi
instant	kits
falcon	falcon
planted	geplant
nordic	nordic
hannah	hannah
hannah	hanna
coordination	koördinasie
hammond	hammond
barracks	kaserne
skilled	vaardige
hardcore	hardcore
precipitation	neerslag
ranger	ranger
lily	lily
surveys	opnames
peterson	peterson
albion	albion
destinations	bestemmings
calm	kalm
photographic	photographic
photographic	fotografiese
schmidt	schmidt
asylum	asylum
visa	visa
twelfth	twelfth
contacted	gekontak
matching	ooreenstemmend
pregnancy	swangerskap
blatant	blatant
noteworthy	noemenswaardig
commit	redigeer
expectations	expectations
carmen	carmen
erie	erie
harvest	oes
kashmir	kashmir
theft	diefstal
flames	vlamme
flames	flames
wesley	wesley
pga	pga
beats	beats
beats	slae
arlington	arlington
sterling	sterling
chances	kanse
donna	donna
petty	petty
sonic	sonic
transparent	deursigtig
transparent	transparent
transparent	deursigtige
dedication	toewyding
clarence	clarence
katherine	katherine
nervous	nervous
facto	facto
excluding	uitgesluit
everywhere	oral
everywhere	orals
sunset	sonsondergang
anthropology	antropologie
minds	minds
reward	beloning
antoine	antoine
ally	ally
gateway	gateway
gateway	portaal
leigh	leigh
slavic	slawiese
derbyshire	derbyshire
lopez	lopez
chronic	chroniese
donations	skenkings
duet	duet
intel	intel
winchester	winchester
broncos	broncos
pig	vark
whale	walvis
beaches	strande
archipelago	argipel
minerals	minerale
frozen	frozen
frozen	bevrore
frozen	gevries
fischer	fischer
dee	dee
accurately	akkuraat
accurately	noukeurig
participant	deelnemer
peaceful	vreedsame
peaceful	rustige
peaceful	vreedsaam
typhoon	typhoon
hank	hank
manually	eiehandig
verlag	verlag
tram	tram
alignment	belyning
ivory	ivoor
hastings	hastings
taxa	taxa
holly	holly
constellation	sterrebeeld
healing	healing
frames	rame
rey	rey
lorenzo	lorenzo
specification	spesifikasie
professors	professors
viking	viking
utc+	utc+
bloody	bloody
eden	eden
mormon	mormon
nielsen	nielsen
coloured	gekleurde
coloured	kleurlinge
relevance	toepaslikheid
interference	steuring
interference	inmenging
candy	lekkergoed
bitter	bitter
monetary	monetêre
trends	neigings
individually	individueel
funk	funk
basque	baskiese
bangalore	bangalore
synagogue	sinagoge
latvian	lettiese
pot	pot
paths	paths
paths	paaie
var	var
guarantee	waarborg
lacrosse	lacrosse
immigrant	immigrant
aus	aus
patriarch	patriarg
blessed	geseënd
tailed	tailed
oversight	toesig
servers	bedieners
rabbit	haas
rabbit	rabbit
phi	phi
sectors	sektore
powder	powder
vfl	vfl
trivia	trivia
coventry	coventry
institutional	institusionele
inform	inlig
vic	vic
summers	summers
detect	ondersoek
precision	presisie
sunshine	sonskyn
motivated	gemotiveerd
diaspora	diaspora
linguistics	taalkunde
flowering	flowering
nazis	nazis
savings	besparings
underwater	onderwater
deeper	dieper
mccarthy	mccarthy
georgetown	georgetown
screening	verwerking
phenomena	phenomena
liver	lewer
benedict	benedictus
commodore	commodore
hollow	hol
mob	mob
dawson	dawson
emi	emi
brett	brett
alert	waarskuwing
seventeen	sewentien
reunion	reunion
patterson	patterson
lighter	ligter
linnaeus	linnaeus
filling	invul
matthews	matthews
willis	willis
