mosque	mosque
guys	guys
lab	lab
sailing	sailing
orientation	orientation
virtually	virtually
generic	generic
reasoning	reasoning
stroke	stroke
unions	unions
efficient	efficient
opens	opens
impression	impression
discover	discover
relocated	relocated
novelists	novelists
roosevelt	roosevelt
dancer	dancer
phenomenon	phenomenon
preliminary	preliminary
recognize	recognize
anchor	anchor
arguing	arguing
abilities	abilities
procedures	procedures
emotional	emotional
timber	timber
fisher	fisher
prod	prod
cartoon	cartoon
disorder	disorder
fled	fled
demands	demands
lithuania	lithuania
continent	continent
fellowship	fellowship
lock	lock
relegated	relegated
warrant	warrant
pictured	pictured
recurring	recurring
overview	overview
wealthy	wealthy
acquisition	acquisition
eve	eve
filter	filter
addresses	addresses
independently	independently
slovenia	slovenia
observation	observation
roster	roster
challenged	challenged
threats	threats
fallen	fallen
protocol	protocol
judgment	judgment
grammy	grammy
colours	colours
distinctive	distinctive
landmark	landmark
package	package
controls	controls
completing	completing
sabha	sabha
prisoner	prisoner
signals	signals
owen	owen
capita	capita
inaugural	inaugural
intervention	intervention
arriving	arriving
cylinder	cylinder
tenth	tenth
liu	liu
tested	tested
renowned	renowned
shops	shops
dome	dome
philosopher	philosopher
epic	epic
stem	stem
specified	specified
davies	davies
collapse	collapse
allan	allan
albanian	albanian
canyon	canyon
samples	samples
perceived	perceived
celebrity	celebrity
priests	priests
louise	louise
workshop	workshop
herzegovina	herzegovina
claude	claude
fortune	fortune
bars	bars
cornwall	cornwall
palmer	palmer
presidency	presidency
tiny	tiny
appeals	appeals
istanbul	istanbul
rookie	rookie
expanding	expanding
calgary	calgary
shock	shock
stevens	stevens
employee	employee
yang	yang
housed	housed
tomb	tomb
earning	earning
innovation	innovation
streams	streams
unity	unity
lucas	lucas
grows	grows
armenia	armenia
interchange	interchange
proteins	proteins
proposals	proposals
swimmers	swimmers
mainland	mainland
seminary	seminary
hamlet	hamlet
timeline	timeline
coup	coup
newport	newport
negotiations	negotiations
exhibitions	exhibitions
malta	malta
hate	hate
westminster	westminster
installation	installation
enters	enters
goalkeeper	goalkeeper
julian	julian
morocco	morocco
efficiency	efficiency
chapters	chapters
aboard	aboard
helicopter	helicopter
fortress	fortress
ani	ani
burned	burned
displays	displays
compiled	compiled
ips	ips
contributors	contributors
torpedo	torpedo
giovanni	giovanni
chat	chat
catholics	catholics
herald	herald
chuck	chuck
pit	pit
supplied	supplied
optional	optional
desk	desk
garrison	garrison
sprint	sprint
exile	exile
surprised	surprised
achievements	achievements
biblical	biblical
rebels	rebels
denis	denis
geographical	geographical
sit	sit
alpine	alpine
bills	bills
glacier	glacier
binding	binding
indicating	indicating
estonia	estonia
eating	eating
saving	saving
chi	chi
developer	developer
indie	indie
difficulties	difficulties
doctrine	doctrine
worn	worn
fork	fork
simpson	simpson
maintaining	maintaining
theological	theological
upcoming	upcoming
vocalist	vocalist
temporarily	temporarily
hotels	hotels
edmonton	edmonton
developments	developments
literacy	literacy
currency	currency
missionary	missionary
arrives	arrives
hammer	hammer
dollar	dollar
ambassadors	ambassadors
twitter	twitter
centres	centres
solomon	solomon
recommend	recommend
descendants	descendants
ruth	ruth
handling	handling
customs	customs
collect	collect
grid	grid
secured	secured
certificate	certificate
destination	destination
albania	albania
indies	indies
euro	euro
consumption	consumption
feat	feat
pushing	pushing
constantly	constantly
survivors	survivors
mansion	mansion
cardiff	cardiff
temples	temples
blake	blake
sheet	sheet
lift	lift
confidence	confidence
cuisine	cuisine
frankfurt	frankfurt
galaxy	galaxy
ecuador	ecuador
breeding	breeding
outbreak	outbreak
legendary	legendary
handball	handball
georgian	georgian
copenhagen	copenhagen
trek	trek
ignored	ignored
arch	arch
keys	keys
proceedings	proceedings
enjoy	enjoy
quartet	quartet
aims	aims
propaganda	propaganda
disk	disk
funny	funny
punishment	punishment
accuracy	accuracy
meter	meter
theoretical	theoretical
suspension	suspension
graduation	graduation
flew	flew
seeds	seeds
lighting	lighting
jennifer	jennifer
smooth	smooth
customer	customer
armstrong	armstrong
southwestern	southwestern
involve	involve
philosophical	philosophical
escaped	escaped
powell	powell
kills	kills
taste	taste
allmusic	allmusic
requiring	requiring
bros	bros
assertion	assertion
boulevard	boulevard
northeastern	northeastern
brooks	brooks
sending	sending
atomic	atomic
antarctica	antarctica
strikes	strikes
reconstruction	reconstruction
chronicle	chronicle
traveling	traveling
leslie	leslie
ellis	ellis
devon	devon
ghana	ghana
gen	gen
rebel	rebel
duncan	duncan
pianist	pianist
canon	canon
reformed	reformed
pack	pack
iceland	iceland
solve	solve
cyclists	cyclists
payment	payment
suburbs	suburbs
militia	militia
pronounced	pronounced
exhibit	exhibit
mph	mph
glen	glen
eugene	eugene
compromise	compromise
tactical	tactical
discovers	discovers
uganda	uganda
jail	jail
yeah	yeah
withdraw	withdraw
holmes	holmes
promise	promise
deals	deals
convert	convert
dos	dos
afternoon	afternoon
recall	recall
arrive	arrive
warrior	warrior
mammals	mammals
dimensions	dimensions
surrey	surrey
gaming	gaming
lutheran	lutheran
ports	ports
amy	amy
survival	survival
responses	responses
badly	badly
collegiate	collegiate
scandal	scandal
widow	widow
swing	swing
nights	nights
polo	polo
linda	linda
adr	adr
consist	consist
probability	probability
farms	farms
conferences	conferences
zhang	zhang
crazy	crazy
witness	witness
nephew	nephew
sensitive	sensitive
mutual	mutual
diet	diet
clients	clients
fringe	fringe
passion	passion
rings	rings
millions	millions
dialect	dialect
orlando	orlando
undergraduate	undergraduate
relay	relay
wet	wet
cruise	cruise
henri	henri
publish	publish
joy	joy
julia	julia
kitchen	kitchen
abstract	abstract
snake	snake
comedian	comedian
motorcycle	motorcycle
nadu	nadu
arsenal	arsenal
millennium	millennium
assists	assists
bow	bow
andré	andré
serie	serie
dimensional	dimensional
travelled	travelled
eurovision	eurovision
firing	firing
suite	suite
doug	doug
gravity	gravity
stored	stored
departed	departed
optical	optical
frontier	frontier
evaluation	evaluation
graph	graph
hybrid	hybrid
oslo	oslo
earn	earn
keyboard	keyboard
jamie	jamie
decorated	decorated
complicated	complicated
nathan	nathan
slavery	slavery
circular	circular
operators	operators
armor	armor
mechanics	mechanics
bradford	bradford
leon	leon
rachel	rachel
footage	footage
strings	strings
header	header
hood	hood
inspector	inspector
warnings	warnings
relatives	relatives
plains	plains
defended	defended
wheels	wheels
criterion	criterion
ace	ace
arrangements	arrangements
penn	penn
joke	joke
sailed	sailed
religions	religions
grants	grants
andrews	andrews
moderate	moderate
stolen	stolen
tributary	tributary
pin	pin
carol	carol
owns	owns
prototype	prototype
copied	copied
canterbury	canterbury
midnight	midnight
quarterback	quarterback
duchy	duchy
bailey	bailey
arbitrators	arbitrators
performers	performers
handled	handled
exploration	exploration
diversity	diversity
sixteen	sixteen
findings	findings
repeat	repeat
brussels	brussels
imdb	imdb
planets	planets
theatrical	theatrical
reconnaissance	reconnaissance
shots	shots
complaint	complaint
batman	batman
exhibited	exhibited
espn	espn
investigate	investigate
verify	verify
discontinued	discontinued
absent	absent
girlfriend	girlfriend
resignation	resignation
fossil	fossil
explaining	explaining
tang	tang
inches	inches
proven	proven
franco	franco
dying	dying
tribal	tribal
tyler	tyler
surrender	surrender
glenn	glenn
substance	substance
luxembourg	luxembourg
colored	colored
administered	administered
explosion	explosion
pushed	pushed
generations	generations
duck	duck
porter	porter
permanently	permanently
memphis	memphis
salvador	salvador
emma	emma
mit	mit
zoo	zoo
gibson	gibson
emerging	emerging
mere	mere
notre	notre
portions	portions
macedonia	macedonia
ethics	ethics
curtis	curtis
rescued	rescued
gaelic	gaelic
slovakia	slovakia
elevated	elevated
jeremy	jeremy
listen	listen
impressive	impressive
bradley	bradley
surely	surely
egg	egg
conquest	conquest
rod	rod
cdp	cdp
algorithm	algorithm
burn	burn
thesis	thesis
lover	lover
capitol	capitol
remembered	remembered
ferdinand	ferdinand
marshal	marshal
judaism	judaism
balls	balls
nacional	nacional
wrestlers	wrestlers
ahmed	ahmed
sin	sin
holocaust	holocaust
edgar	edgar
saxophone	saxophone
retain	retain
curriculum	curriculum
wishes	wishes
prepare	prepare
ruins	ruins
ibm	ibm
rochester	rochester
nigerian	nigerian
pitched	pitched
jesse	jesse
malaysian	malaysian
atlas	atlas
telegraph	telegraph
performer	performer
cannon	cannon
encounter	encounter
emily	emily
dissolved	dissolved
catalogue	catalogue
discrimination	discrimination
myspace	myspace
reveal	reveal
wizard	wizard
teen	teen
spots	spots
bomber	bomber
foods	foods
quest	quest
connor	connor
screenplay	screenplay
motors	motors
minimal	minimal
muscle	muscle
prestigious	prestigious
sustainable	sustainable
chelsea	chelsea
strict	strict
kingston	kingston
sheep	sheep
andrea	andrea
complaints	complaints
connects	connects
nursing	nursing
defenders	defenders
richardson	richardson
triangle	triangle
nato	nato
teeth	teeth
occasional	occasional
strictly	strictly
harper	harper
fluid	fluid
fed	fed
newfoundland	newfoundland
disbanded	disbanded
comparable	comparable
documentation	documentation
brien	brien
compounds	compounds
pointing	pointing
edmund	edmund
instances	instances
naturally	naturally
forcing	forcing
ussr	ussr
laser	laser
lat	lat
sculptor	sculptor
guild	guild
observer	observer
worlds	worlds
imprisoned	imprisoned
wrestler	wrestler
praise	praise
parishes	parishes
bones	bones
css	css
cox	cox
contracts	contracts
consequences	consequences
provisions	provisions
circulation	circulation
butterfly	butterfly
hugo	hugo
abolished	abolished
algeria	algeria
edu	edu
armies	armies
separation	separation
spy	spy
cliff	cliff
technically	technically
reactions	reactions
lithuanian	lithuanian
trick	trick
curve	curve
accidents	accidents
horizontal	horizontal
legends	legends
enzyme	enzyme
freight	freight
lacks	lacks
hydrogen	hydrogen
broadcasts	broadcasts
viii	viii
caroline	caroline
pull	pull
plymouth	plymouth
twentieth	twentieth
cuts	cuts
mediation	mediation
airfield	airfield
catalog	catalog
dale	dale
synthesis	synthesis
rape	rape
seoul	seoul
engagement	engagement
coin	coin
lucy	lucy
consequently	consequently
platinum	platinum
twins	twins
memories	memories
robertson	robertson
verified	verified
anthology	anthology
milton	milton
geological	geological
defining	defining
dinner	dinner
hosting	hosting
thriller	thriller
retreat	retreat
albany	albany
abdul	abdul
ignore	ignore
migration	migration
carefully	carefully
magnitude	magnitude
sudan	sudan
manages	manages
duration	duration
henderson	henderson
explorer	explorer
marco	marco
fusion	fusion
aids	aids
gathered	gathered
privately	privately
reflected	reflected
afraid	afraid
presbyterian	presbyterian
automobile	automobile
estates	estates
pound	pound
allegedly	allegedly
delay	delay
developers	developers
semifinals	semifinals
belfast	belfast
arctic	arctic
kurt	kurt
mayors	mayors
windsor	windsor
assumption	assumption
plates	plates
fourteen	fourteen
nominee	nominee
disruption	disruption
monroe	monroe
hearts	hearts
belgrade	belgrade
victories	victories
extending	extending
pale	pale
pursuit	pursuit
glory	glory
destroyer	destroyer
deeply	deeply
lectures	lectures
affiliate	affiliate
preston	preston
deceased	deceased
speaks	speaks
gathering	gathering
angry	angry
incomplete	incomplete
enrolled	enrolled
configuration	configuration
brad	brad
skill	skill
intense	intense
tasmania	tasmania
commitment	commitment
loved	loved
reforms	reforms
rulers	rulers
uruguay	uruguay
sustained	sustained
napoleon	napoleon
confirm	confirm
breed	breed
auxiliary	auxiliary
enabled	enabled
discography	discography
licence	licence
refugees	refugees
adrian	adrian
pipe	pipe
karen	karen
altered	altered
budapest	budapest
designers	designers
heir	heir
advisor	advisor
illustrate	illustrate
authorized	authorized
hide	hide
announcement	announcement
compact	compact
tissue	tissue
particles	particles
refuses	refuses
receiver	receiver
civilians	civilians
marsh	marsh
vinyl	vinyl
delayed	delayed
wednesday	wednesday
checking	checking
chilean	chilean
hey	hey
chambers	chambers
demo	demo
agrees	agrees
ahmad	ahmad
santos	santos
paying	paying
interpreted	interpreted
submit	submit
desired	desired
followers	followers
observatory	observatory
problematic	problematic
springfield	springfield
kit	kit
remarks	remarks
burton	burton
inns	inns
monarch	monarch
observations	observations
beetle	beetle
promised	promised
palomar	palomar
cream	cream
presenter	presenter
potter	potter
copyvio	copyvio
favourite	favourite
transformation	transformation
mcdonald	mcdonald
bavaria	bavaria
kumar	kumar
nineteenth	nineteenth
severely	severely
mixture	mixture
browser	browser
endangered	endangered
mate	mate
everybody	everybody
lyon	lyon
illustration	illustration
kyle	kyle
afl	afl
brook	brook
geometry	geometry
ping	ping
extends	extends
aggregate	aggregate
variants	variants
baroque	baroque
iso	iso
collapsed	collapsed
integral	integral
jake	jake
hopes	hopes
cornell	cornell
modes	modes
servant	servant
kenny	kenny
hurt	hurt
maker	maker
inline	inline
carlo	carlo
lynn	lynn
stability	stability
hoping	hoping
imposed	imposed
confusing	confusing
summaries	summaries
beetles	beetles
joel	joel
jets	jets
logos	logos
vital	vital
malcolm	malcolm
winnipeg	winnipeg
kilometers	kilometers
songwriters	songwriters
buddhism	buddhism
nose	nose
respected	respected
pace	pace
thunder	thunder
centered	centered
physicians	physicians
bolivia	bolivia
forget	forget
implies	implies
crops	crops
halifax	halifax
toll	toll
monk	monk
extraordinary	extraordinary
lessons	lessons
pub	pub
paralympics	paralympics
monte	monte
segments	segments
deer	deer
wireless	wireless
mysterious	mysterious
consultant	consultant
fraser	fraser
formats	formats
jam	jam
chicken	chicken
enable	enable
idol	idol
reid	reid
births	births
amazing	amazing
pet	pet
upset	upset
loves	loves
stretch	stretch
nominate	nominate
striking	striking
striker	striker
accidentally	accidentally
louisville	louisville
hopkins	hopkins
eds	eds
goddess	goddess
burials	burials
resumed	resumed
satisfy	satisfy
notion	notion
voltage	voltage
betty	betty
marion	marion
geology	geology
consistently	consistently
cyclone	cyclone
export	export
lightning	lightning
impressed	impressed
maintains	maintains
logical	logical
aggressive	aggressive
jin	jin
julie	julie
fbi	fbi
yankees	yankees
ludwig	ludwig
pond	pond
suburban	suburban
enlisted	enlisted
moments	moments
conjunction	conjunction
interim	interim
argues	argues
lucky	lucky
lon	lon
regiments	regiments
prevented	prevented
toy	toy
bicycle	bicycle
purely	purely
interactions	interactions
fraud	fraud
lang	lang
arcade	arcade
lecture	lecture
sanctuary	sanctuary
dragons	dragons
copa	copa
careful	careful
nurse	nurse
rivals	rivals
module	module
supplement	supplement
lens	lens
patron	patron
commands	commands
trend	trend
superintendent	superintendent
gerald	gerald
rap	rap
geneva	geneva
ash	ash
blade	blade
disappeared	disappeared
array	array
patrolling	patrolling
predominantly	predominantly
committees	committees
loose	loose
boom	boom
sailors	sailors
beaten	beaten
smoke	smoke
assassination	assassination
lancaster	lancaster
reynolds	reynolds
divorce	divorce
dust	dust
saxon	saxon
separately	separately
grain	grain
executives	executives
translations	translations
zimbabwe	zimbabwe
cohen	cohen
puts	puts
diving	diving
carroll	carroll
accounting	accounting
mesa	mesa
prussia	prussia
intelligent	intelligent
cherry	cherry
underlying	underlying
tobacco	tobacco
cleaned	cleaned
varieties	varieties
bench	bench
directions	directions
ellen	ellen
padding	padding
measurement	measurement
paradise	paradise
alexandria	alexandria
complement	complement
witch	witch
attraction	attraction
diana	diana
personalities	personalities
colleagues	colleagues
busy	busy
cia	cia
screenwriter	screenwriter
rankings	rankings
aboriginal	aboriginal
commanders	commanders
salem	salem
wagner	wagner
firms	firms
sanctions	sanctions
americas	americas
endings	endings
instructor	instructor
nobility	nobility
divorced	divorced
varies	varies
tomorrow	tomorrow
manuscripts	manuscripts
unified	unified
clarify	clarify
scouts	scouts
investigations	investigations
silva	silva
derek	derek
agenda	agenda
provision	provision
humanity	humanity
admit	admit
terror	terror
contestants	contestants
trinidad	trinidad
distant	distant
burke	burke
circles	circles
assignment	assignment
releasing	releasing
recalled	recalled
shrine	shrine
sail	sail
willie	willie
karnataka	karnataka
celebrate	celebrate
ranch	ranch
collaborated	collaborated
vampire	vampire
playwright	playwright
sick	sick
associates	associates
heinrich	heinrich
ethiopia	ethiopia
flags	flags
tel	tel
drove	drove
shorts	shorts
drives	drives
accomplished	accomplished
autobiography	autobiography
recruited	recruited
uprising	uprising
edwin	edwin
velocity	velocity
terminology	terminology
raiders	raiders
coordinates	coordinates
brighton	brighton
viola	viola
para	para
morrison	morrison
propulsion	propulsion
boxer	boxer
finale	finale
shoulder	shoulder
disabled	disabled
div	div
tactics	tactics
ernst	ernst
innocent	innocent
rapper	rapper
settle	settle
privacy	privacy
boeing	boeing
cites	cites
bunch	bunch
emmy	emmy
indo	indo
distinguish	distinguish
rosa	rosa
thermal	thermal
flute	flute
marines	marines
feminist	feminist
trustees	trustees
sculptures	sculptures
nationally	nationally
bacteria	bacteria
introduce	introduce
landmarks	landmarks
disorders	disorders
rivalry	rivalry
prevention	prevention
honored	honored
healthy	healthy
circus	circus
speculation	speculation
burma	burma
sec	sec
quiet	quiet
knee	knee
deliver	deliver
threw	threw
hypothesis	hypothesis
referendum	referendum
travelling	travelling
estonian	estonian
pastor	pastor
sofia	sofia
tribune	tribune
lasting	lasting
permit	permit
priority	priority
pounds	pounds
cent	cent
consequence	consequence
rica	rica
furniture	furniture
macdonald	macdonald
honest	honest
innovative	innovative
estimate	estimate
atp	atp
rotation	rotation
syracuse	syracuse
lecturer	lecturer
automated	automated
obscure	obscure
kosovo	kosovo
classics	classics
julius	julius
appreciated	appreciated
naples	naples
sebastian	sebastian
activated	activated
varied	varied
offense	offense
advised	advised
barnes	barnes
acknowledged	acknowledged
exceptions	exceptions
martha	martha
quarters	quarters
drawings	drawings
barely	barely
hitting	hitting
refuge	refuge
maharashtra	maharashtra
conventions	conventions
elliott	elliott
diplomat	diplomat
searches	searches
brigadier	brigadier
particle	particle
malayalam	malayalam
thursday	thursday
icon	icon
ulster	ulster
genes	genes
infinite	infinite
considerably	considerably
vale	vale
portraits	portraits
paste	paste
randy	randy
saxony	saxony
convoy	convoy
annie	annie
excessive	excessive
believing	believing
rhine	rhine
mineral	mineral
implement	implement
surgeon	surgeon
badge	badge
charleston	charleston
clause	clause
infection	infection
electron	electron
walt	walt
cnn	cnn
likewise	likewise
confederation	confederation
accommodate	accommodate
casino	casino
doctorate	doctorate
aux	aux
guatemala	guatemala
settings	settings
mask	mask
shelter	shelter
dorothy	dorothy
ethnicity	ethnicity
hopefully	hopefully
elimination	elimination
heath	heath
pregnant	pregnant
richards	richards
theodore	theodore
delegates	delegates
blair	blair
fac	fac
phrases	phrases
crashed	crashed
preference	preference
janeiro	janeiro
concerto	concerto
bits	bits
construct	construct
tune	tune
unofficial	unofficial
bulk	bulk
lighthouse	lighthouse
stan	stan
highland	highland
mascot	mascot
squadrons	squadrons
acceptance	acceptance
tight	tight
considers	considers
hub	hub
mess	mess
routine	routine
reviewing	reviewing
dubbed	dubbed
dozens	dozens
spotted	spotted
harmony	harmony
entrepreneur	entrepreneur
wwe	wwe
apollo	apollo
runway	runway
naked	naked
anton	anton
moses	moses
legally	legally
nominating	nominating
fake	fake
biased	biased
revolt	revolt
equity	equity
providence	providence
investors	investors
reliability	reliability
tenor	tenor
fights	fights
pocket	pocket
sad	sad
troy	troy
treasure	treasure
ion	ion
transformed	transformed
roberto	roberto
adoption	adoption
decrease	decrease
reserved	reserved
forgotten	forgotten
lok	lok
crop	crop
licensing	licensing
advocacy	advocacy
collecting	collecting
treasury	treasury
trumpet	trumpet
johnston	johnston
uncertain	uncertain
norton	norton
collector	collector
cluster	cluster
dear	dear
georges	georges
roller	roller
clothes	clothes
sovereign	sovereign
enhanced	enhanced
compensation	compensation
consent	consent
outline	outline
holdings	holdings
jorge	jorge
darkness	darkness
penalties	penalties
bombers	bombers
holes	holes
blow	blow
cooking	cooking
aftermath	aftermath
trainer	trainer
measuring	measuring
lawsuit	lawsuit
retiring	retiring
chip	chip
consciousness	consciousness
archaeology	archaeology
latvia	latvia
telugu	telugu
blogs	blogs
protecting	protecting
hardy	hardy
nicknamed	nicknamed
scorer	scorer
stamp	stamp
nat	nat
fur	fur
redirected	redirected
estimates	estimates
lit	lit
ritual	ritual
locality	locality
trace	trace
marble	marble
foundations	foundations
politically	politically
nottingham	nottingham
derivative	derivative
boxers	boxers
dimension	dimension
touchdowns	touchdowns
crawford	crawford
bats	bats
yugoslav	yugoslav
tanzania	tanzania
succeed	succeed
motto	motto
streak	streak
concentrated	concentrated
dirty	dirty
hayes	hayes
xbox	xbox
identifying	identifying
likes	likes
genres	genres
galleries	galleries
forbes	forbes
councils	councils
adequate	adequate
brass	brass
bach	bach
alias	alias
counsel	counsel
tough	tough
advertisement	advertisement
protagonist	protagonist
trails	trails
demanded	demanded
claire	claire
mistakes	mistakes
bruno	bruno
dylan	dylan
bag	bag
throwing	throwing
churchill	churchill
tan	tan
spelled	spelled
climb	climb
witnesses	witnesses
thames	thames
anybody	anybody
kazakhstan	kazakhstan
bots	bots
presenting	presenting
highlights	highlights
jumping	jumping
prof	prof
slovak	slovak
skull	skull
missionaries	missionaries
ordained	ordained
eventual	eventual
hoped	hoped
myth	myth
mandatory	mandatory
stern	stern
fees	fees
bet	bet
monks	monks
dancers	dancers
quantity	quantity
inventor	inventor
cairo	cairo
graves	graves
proximity	proximity
seemingly	seemingly
sue	sue
armament	armament
barrier	barrier
creatures	creatures
logan	logan
erik	erik
leicester	leicester
silence	silence
jessica	jessica
plateau	plateau
finite	finite
precedent	precedent
walsh	walsh
zones	zones
intensity	intensity
exterior	exterior
murders	murders
paragraphs	paragraphs
costume	costume
bike	bike
neighborhoods	neighborhoods
imprisonment	imprisonment
suffolk	suffolk
forwards	forwards
remarkable	remarkable
differ	differ
tin	tin
garcia	garcia
madagascar	madagascar
cameras	cameras
ammunition	ammunition
fires	fires
viewing	viewing
explore	explore
builder	builder
minneapolis	minneapolis
bullet	bullet
kerry	kerry
subway	subway
arrow	arrow
economist	economist
bread	bread
lou	lou
strategies	strategies
rubber	rubber
precise	precise
rifles	rifles
cognitive	cognitive
governorate	governorate
nest	nest
slam	slam
ancestry	ancestry
portsmouth	portsmouth
convince	convince
audiences	audiences
boarding	boarding
bonds	bonds
joshua	joshua
inhabited	inhabited
casey	casey
attract	attract
kilometres	kilometres
pump	pump
feeding	feeding
prey	prey
ain	ain
mathematician	mathematician
diary	diary
vulnerable	vulnerable
inscription	inscription
dubai	dubai
michelle	michelle
lebanese	lebanese
productive	productive
guided	guided
happening	happening
accordingly	accordingly
researcher	researcher
della	della
baden	baden
upgraded	upgraded
demonstration	demonstration
equality	equality
philosophers	philosophers
trap	trap
clara	clara
invitation	invitation
marking	marking
expertise	expertise
admission	admission
sacramento	sacramento
certification	certification
precisely	precisely
casting	casting
submarines	submarines
prohibited	prohibited
supposedly	supposedly
governance	governance
frog	frog
vague	vague
tackles	tackles
mhz	mhz
secular	secular
tracking	tracking
spa	spa
publicity	publicity
armoured	armoured
cleared	cleared
watts	watts
gibraltar	gibraltar
renewed	renewed
reflects	reflects
fever	fever
melody	melody
supporter	supporter
elaborate	elaborate
jeffrey	jeffrey
discusses	discusses
surnames	surnames
useless	useless
swift	swift
tuesday	tuesday
silly	silly
