the	the
and	and
was	was
for	for
that	that
with	with
from	from
this	this
utc	utc
his	his
not	not
are	are
talk	talk
which	which
also	also
has	has
were	were
but	but
have	have
one	one
new	new
first	first
page	page
you	you
they	they
had	had
article	article
who	who
all	all
their	their
there	there
made	made
its	its
people	people
may	may
after	after
other	other
should	should
two	two
score	score
her	her
can	can
would	would
more	more
she	she
about	about
when	when
time	time
team	team
american	american
such	such
discussion	discussion
links	links
only	only
some	some
see	see
united	united
years	years
into	into
school	school
world	world
university	university
during	during
out	out
state	state
states	states
national	national
wikipedia	wikipedia
year	year
most	most
city	city
used	used
then	then
than	than
county	county
external	external
where	where
will	will
what	what
delete	delete
any	any
these	these
january	january
march	march
august	august
july	july
being	being
film	film
him	him
many	many
south	south
september	september
like	like
between	between
october	october
three	three
june	june
well	well
use	use
war	war
under	under
them	them
april	april
born	born
december	december
link	link
while	while
later	later
part	part
november	november
players	players
list	list
please	please
following	following
february	february
known	known
second	second
name	name
group	group
history	history
series	series
just	just
north	north
work	work
before	before
since	since
season	season
both	both
high	high
through	through
district	district
now	now
comments	comments
because	because
football	football
music	music
diff	diff
century	century
league	league
edits	edits
debate	debate
title	title
articles	articles
john	john
same	same
including	including
could	could
english	english
album	album
number	number
against	against
family	family
user	user
based	based
area	area
york	york
life	life
british	british
international	international
game	game
above	above
club	club
your	your
until	until
early	early
best	best
west	west
house	house
company	company
general	general
left	left
very	very
here	here
don	don
living	living
day	day
several	several
place	place
party	party
college	college
result	result
keep	keep
appropriate	appropriate
four	four
subsequent	subsequent
even	even
class	class
government	government
how	how
called	called
did	did
each	each
found	found
center	center
per	per
style	style
com	com
long	long
country	country
back	back
way	way
does	does
www	www
modify	modify
end	end
make	make
public	public
played	played
won	won
another	another
released	released
added	added
support	support
games	games
former	former
those	those
films	films
church	church
east	east
line	line
major	major
members	members
good	good
much	much
image	image
show	show
still	still
think	think
below	below
town	town
last	last
system	system
right	right
song	song
non	non
notable	notable
section	section
single	single
included	included
align	align
home	home
women	women
television	television
seed	seed
member	member
goals	goals
sources	sources
book	book
station	station
order	order
old	old
information	information
set	set
own	own
text	text
band	band
point	point
local	local
around	around
river	river
top	top
main	main
language	language
french	french
https	https
named	named
off	off
note	note
career	career
original	original
age	age
service	service
established	established
located	located
said	said
website	website
population	population
air	air
german	german
law	law
military	military
great	great
within	within
clubs	clubs
published	published
president	president
park	park
official	official
case	case
london	london
times	times
although	although
small	small
third	third
different	different
due	due
get	get
village	village
closed	closed
art	art
player	player
final	final
community	community
again	again
began	began
army	army
award	award
without	without
death	death
built	built
men	men
large	large
site	site
using	using
deletion	deletion
white	white
five	five
central	central
road	road
children	children
free	free
took	took
england	england
include	include
association	association
down	down
given	given
source	source
california	california
man	man
version	version
written	written
created	created
media	media
black	black
though	though
php	php
report	report
building	building
take	take
division	division
comment	comment
having	having
king	king
edit	edit
stadium	stadium
died	died
ship	ship
research	research
record	record
archive	archive
places	places
undo	undo
cup	cup
records	records
often	often
few	few
received	received
side	side
power	power
education	education
know	know
category	category
water	water
political	political
species	species
field	field
near	near
australia	australia
video	video
need	need
island	island
form	form
find	find
served	served
play	play
project	project
according	according
radio	radio
works	works
proposed	proposed
every	every
development	development
example	example
live	live
union	union
india	india
next	next
special	special
court	court
region	region
little	little
short	short
william	william
province	province
western	western
son	son
france	france
council	council
others	others
royal	royal
current	current
street	street
full	full
red	red
too	too
department	department
san	san
help	help
among	among
preserved	preserved
james	james
open	open
force	force
position	position
head	head
director	director
father	father
track	track
http	http
canada	canada
never	never
australian	australian
george	george
jpg	jpg
level	level
late	late
summer	summer
society	society
moved	moved
office	office
period	period
championship	championship
round	round
story	story
songs	songs
various	various
file	file
days	days
land	land
business	business
reason	reason
america	america
million	million
european	european
term	term
six	six
post	post
why	why
produced	produced
making	making
subject	subject
young	young
total	total
david	david
science	science
related	related
rock	rock
archived	archived
railway	railway
become	become
led	led
students	students
started	started
news	news
described	described
role	role
election	election
albums	albums
present	present
indian	indian
kingdom	kingdom
books	books
important	important
northern	northern
love	love
run	run
canadian	canadian
press	press
type	type
act	act
editor	editor
came	came
schools	schools
program	program
issue	issue
social	social
germany	germany
production	production
male	male
awards	awards
points	points
similar	similar
professional	professional
say	say
background	background
enough	enough
lead	lead
common	common
overlap	overlap
data	data
color	color
better	better
person	person
services	services
bgcolor	bgcolor
museum	museum
battle	battle
sports	sports
already	already
currently	currently
hall	hall
buildings	buildings
historic	historic
date	date
deleted	deleted
considered	considered
change	change
location	location
seems	seems
must	must
yes	yes
our	our
southern	southern
lost	lost
something	something
review	review
together	together
robert	robert
fact	fact
less	less
japanese	japanese
groups	groups
content	content
involved	involved
isbn	isbn
board	board
japan	japan
control	control
policy	policy
modern	modern
human	human
half	half
design	design
event	event
events	events
available	available
done	done
washington	washington
real	real
start	start
personal	personal
action	action
space	space
areas	areas
doesn	doesn
notability	notability
star	star
really	really
china	china
possible	possible
paul	paul
working	working
taken	taken
far	far
going	going
minister	minister
lake	lake
reported	reported
popular	popular
married	married
founded	founded
europe	europe
author	author
away	away
independent	independent
process	process
teams	teams
character	character
low	low
michael	michael
pages	pages
light	light
big	big
seen	seen
release	release
want	want
episode	episode
wrote	wrote
republic	republic
thomas	thomas
companies	companies
via	via
russian	russian
thanks	thanks
put	put
race	race
worked	worked
route	route
recorded	recorded
someone	someone
civil	civil
police	police
charles	charles
listed	listed
users	users
template	template
eastern	eastern
body	body
question	question
italian	italian
featured	featured
week	week
editors	editors
texas	texas
chief	chief
close	close
upon	upon
match	match
roman	roman
come	come
tour	tour
sea	sea
actually	actually
cross	cross
playing	playing
health	health
institute	institute
caps	caps
forces	forces
green	green
rights	rights
evidence	evidence
originally	originally
aircraft	aircraft
arts	arts
range	range
probably	probably
consensus	consensus
bar	bar
problem	problem
look	look
issues	issues
alumni	alumni
average	average
network	network
win	win
shows	shows
wife	wife
returned	returned
night	night
magazine	magazine
centre	centre
usually	usually
completed	completed
elected	elected
significant	significant
african	african
able	able
google	google
stage	stage
addition	addition
ireland	ireland
today	today
academy	academy
saint	saint
self	self
continued	continued
stations	stations
mother	mother
appeared	appeared
africa	africa
culture	culture
spanish	spanish
grand	grand
committee	committee
things	things
fire	fire
changed	changed
gold	gold
female	female
course	course
directed	directed
months	months
chinese	chinese
previous	previous
developed	developed
size	size
mentioned	mentioned
add	add
festival	festival
peter	peter
basketball	basketball
move	move
performance	performance
standard	standard
means	means
give	give
training	training
artist	artist
word	word
blue	blue
primary	primary
announced	announced
value	value
christian	christian
private	private
catholic	catholic
artists	artists
includes	includes
view	view
almost	almost
baseball	baseball
seven	seven
appears	appears
ever	ever
provide	provide
technology	technology
olympics	olympics
future	future
formed	formed
census	census
images	images
results	results
return	return
quality	quality
construction	construction
zealand	zealand
front	front
cover	cover
model	model
despite	despite
read	read
material	material
strong	strong
coach	coach
henry	henry
footballers	footballers
mark	mark
rev	rev
organization	organization
studies	studies
federal	federal
richard	richard
html	html
virginia	virginia
car	car
attack	attack
conference	conference
outside	outside
study	study
brother	brother
names	names
writer	writer
characters	characters
musical	musical
nothing	nothing
border	border
medical	medical
countries	countries
past	past
writing	writing
makes	makes
interest	interest
provided	provided
killed	killed
medal	medal
signed	signed
label	label
fair	fair
search	search
bay	bay
reference	reference
especially	especially
refer	refer
removed	removed
library	library
eventually	eventually
management	management
references	references
features	features
navy	navy
guitar	guitar
hill	hill
sure	sure
historical	historical
lower	lower
daughter	daughter
appointed	appointed
reading	reading
yet	yet
systems	systems
debut	debut
movement	movement
specific	specific
always	always
actor	actor
natural	natural
clear	clear
coast	coast
let	let
got	got
chicago	chicago
championships	championships
pennsylvania	pennsylvania
ten	ten
performed	performed
individual	individual
designed	designed
rule	rule
etc	etc
lists	lists
paris	paris
thought	thought
brown	brown
hand	hand
needs	needs
reliable	reliable
smith	smith
generally	generally
base	base
sometimes	sometimes
florida	florida
capital	capital
valley	valley
bank	bank
gave	gave
ground	ground
reached	reached
italy	italy
energy	energy
believe	believe
leader	leader
active	active
online	online
block	block
bridge	bridge
families	families
changes	changes
followed	followed
industry	industry
collection	collection
request	request
soon	soon
leading	leading
olympic	olympic
sold	sold
writers	writers
professor	professor
studio	studio
mexico	mexico
competition	competition
campaign	campaign
org	org
theatre	theatre
particular	particular
empire	empire
length	length
islands	islands
singer	singer
create	create
redirect	redirect
additional	additional
soviet	soviet
market	market
words	words
producer	producer
notes	notes
hockey	hockey
novel	novel
code	code
referee	referee
fourth	fourth
sport	sport
van	van
mary	mary
airport	airport
sound	sound
status	status
irish	irish
placed	placed
child	child
perhaps	perhaps
idea	idea
foreign	foreign
municipality	municipality
isn	isn
register	register
eight	eight
problems	problems
native	native
coverage	coverage
channel	channel
parliament	parliament
username	username
edition	edition
minor	minor
says	says
whose	whose
foundation	foundation
units	units
movie	movie
runs	runs
ice	ice
simply	simply
limited	limited
unit	unit
student	student
previously	previously
stated	stated
governor	governor
complete	complete
test	test
nominated	nominated
bill	bill
parts	parts
vocals	vocals
theory	theory
regional	regional
account	account
vote	vote
computer	computer
none	none
carolina	carolina
tournament	tournament
poland	poland
behind	behind
wales	wales
winning	winning
lot	lot
hospital	hospital
mid	mid
taking	taking
mountain	mountain
higher	higher
cases	cases
angeles	angeles
editing	editing
replaced	replaced
food	food
multiple	multiple
likely	likely
terms	terms
sir	sir
thing	thing
square	square
try	try
topic	topic
woman	woman
officer	officer
categories	categories
greek	greek
recent	recent
sent	sent
copyright	copyright
speed	speed
templates	templates
money	money
saw	saw
senior	senior
selected	selected
introduced	introduced
politician	politician
true	true
required	required
regular	regular
awarded	awarded
commercial	commercial
cities	cities
contains	contains
trade	trade
degree	degree
anti	anti
birth	birth
sun	sun
finished	finished
rugby	rugby
earth	earth
access	access
prior	prior
seasons	seasons
journal	journal
beginning	beginning
software	software
famous	famous
religious	religious
appear	appear
martin	martin
god	god
bit	bit
hours	hours
running	running
brought	brought
missing	missing
economic	economic
structure	structure
rural	rural
remained	remained
decision	decision
certain	certain
hit	hit
minutes	minutes
spain	spain
plays	plays
whole	whole
joseph	joseph
lord	lord
web	web
decided	decided
operations	operations
function	function
louis	louis
assembly	assembly
queen	queen
security	security
uses	uses
ohio	ohio
jan	jan
operation	operation
call	call
successful	successful
legal	legal
russia	russia
prince	prince
jewish	jewish
staff	staff
establishments	establishments
goal	goal
towards	towards
agree	agree
bad	bad
attendance	attendance
populated	populated
nature	nature
allowed	allowed
captain	captain
mount	mount
township	township
calculated	calculated
structures	structures
hard	hard
saying	saying
manager	manager
earlier	earlier
elections	elections
meet	meet
box	box
lines	lines
democratic	democratic
success	success
associated	associated
singles	singles
traditional	traditional
rest	rest
highway	highway
matter	matter
particularly	particularly
wide	wide
month	month
care	care
admin	admin
cultural	cultural
commission	commission
plan	plan
practice	practice
command	command
nomination	nomination
jersey	jersey
parties	parties
michigan	michigan
entire	entire
anyone	anyone
overlaps	overlaps
approximately	approximately
master	master
noted	noted
usa	usa
stop	stop
feature	feature
engine	engine
response	response
needed	needed
illinois	illinois
afd	afd
experience	experience
engineering	engineering
silver	silver
separate	separate
takes	takes
secretary	secretary
dutch	dutch
lee	lee
recording	recording
prime	prime
themselves	themselves
rules	rules
uploaded	uploaded
trying	trying
youth	youth
scotland	scotland
iii	iii
houses	houses
heart	heart
room	room
stone	stone
shown	shown
deal	deal
drama	drama
scores	scores
dead	dead
key	key
shot	shot
turn	turn
occupation	occupation
scottish	scottish
executive	executive
plant	plant
promoted	promoted
whom	whom
villages	villages
languages	languages
internet	internet
feel	feel
covered	covered
merge	merge
mostly	mostly
numerous	numerous
ancient	ancient
attempt	attempt
property	property
programs	programs
picture	picture
finally	finally
ships	ships
fiction	fiction
looking	looking
secondary	secondary
nations	nations
majority	majority
edward	edward
annual	annual
digital	digital
mission	mission
lived	lived
claim	claim
seat	seat
bbc	bbc
profile	profile
dance	dance
prize	prize
doing	doing
georgia	georgia
port	port
pacific	pacific
castle	castle
pass	pass
transport	transport
organizations	organizations
ratio	ratio
recently	recently
fall	fall
global	global
era	era
wing	wing
opinion	opinion
commander	commander
fort	fort
effect	effect
opening	opening
fine	fine
purpose	purpose
winter	winter
genus	genus
congress	congress
activities	activities
met	met
income	income
massachusetts	massachusetts
comes	comes
older	older
peak	peak
lack	lack
bass	bass
super	super
complex	complex
academic	academic
stars	stars
accounts	accounts
appearance	appearance
asian	asian
asked	asked
friends	friends
kind	kind
till	till
financial	financial
entry	entry
asia	asia
sense	sense
meaning	meaning
actress	actress
map	map
intended	intended
bishop	bishop
boston	boston
rate	rate
literature	literature
forest	forest
voice	voice
jack	jack
pre	pre
justice	justice
champion	champion
double	double
polish	polish
numbers	numbers
columbia	columbia
temple	temple
defeated	defeated
administration	administration
ended	ended
claims	claims
jones	jones
parish	parish
israel	israel
actors	actors
sister	sister
nine	nine
scored	scored
table	table
attended	attended
pop	pop
else	else
newspaper	newspaper
friend	friend
unknown	unknown
winner	winner
chart	chart
initially	initially
loss	loss
sites	sites
starting	starting
architecture	architecture
relations	relations
supported	supported
tracks	tracks
contract	contract
face	face
directly	directly
spent	spent
girl	girl
clearly	clearly
junior	junior
francisco	francisco
politics	politics
presented	presented
mar	mar
cause	cause
volume	volume
caused	caused
tom	tom
flight	flight
candidate	candidate
matches	matches
claimed	claimed
except	except
oil	oil
assistant	assistant
surface	surface
regiment	regiment
stories	stories
represented	represented
gets	gets
speedy	speedy
weeks	weeks
listing	listing
allow	allow
branch	branch
retired	retired
communities	communities
train	train
paper	paper
adding	adding
provides	provides
remains	remains
victoria	victoria
metal	metal
wrong	wrong
direct	direct
frank	frank
miles	miles
blocked	blocked
launched	launched
mass	mass
chairman	chairman
comedy	comedy
relationship	relationship
knowledge	knowledge
format	format
creek	creek
meeting	meeting
failed	failed
officers	officers
draft	draft
goes	goes
fight	fight
figure	figure
faculty	faculty
camp	camp
ran	ran
variety	variety
owner	owner
statistics	statistics
raised	raised
heavy	heavy
alexander	alexander
alone	alone
understand	understand
episodes	episodes
gives	gives
educational	educational
daily	daily
williams	williams
latin	latin
completely	completely
products	products
dark	dark
attention	attention
religion	religion
von	von
mind	mind
oppose	oppose
corps	corps
administrative	administrative
cut	cut
scott	scott
becoming	becoming
footballer	footballer
jean	jean
mayor	mayor
pro	pro
beach	beach
descent	descent
nearly	nearly
leaving	leaving
highly	highly
cast	cast
territory	territory
write	write
towns	towns
forms	forms
joe	joe
inside	inside
wanted	wanted
solid	solid
individuals	individuals
authority	authority
mention	mention
projects	projects
del	del
continue	continue
cost	cost
vice	vice
drive	drive
notice	notice
johnson	johnson
forced	forced
looks	looks
reasons	reasons
job	job
photo	photo
hope	hope
log	log
parents	parents
entered	entered
mike	mike
basic	basic
scientific	scientific
amount	amount
spring	spring
oxford	oxford
kong	kong
opera	opera
tried	tried
critical	critical
simple	simple
founder	founder
hong	hong
told	told
husband	husband
useful	useful
technical	technical
necessary	necessary
believed	believed
operated	operated
mountains	mountains
importance	importance
musicians	musicians
hotel	hotel
girls	girls
crew	crew
feb	feb
boy	boy
ontario	ontario
nation	nation
defense	defense
wiki	wiki
champions	champions
golden	golden
districts	districts
faith	faith
racing	racing
mainly	mainly
auto	auto
lives	lives
swedish	swedish
hot	hot
entertainment	entertainment
net	net
soccer	soccer
creation	creation
product	product
tower	tower
increased	increased
votes	votes
squadron	squadron
contemporary	contemporary
subsequently	subsequently
focus	focus
marriage	marriage
questions	questions
naval	naval
details	details
forward	forward
memorial	memorial
peace	peace
kept	kept
iran	iran
korea	korea
analysis	analysis
winners	winners
poor	poor
grade	grade
cricket	cricket
judge	judge
electric	electric
exist	exist
corporation	corporation
hold	hold
campus	campus
brazil	brazil
chris	chris
beyond	beyond
fifth	fifth
increase	increase
summary	summary
remaining	remaining
statement	statement
broadcast	broadcast
getting	getting
piano	piano
des	des
novels	novels
serving	serving
hour	hour
moving	moving
resolution	resolution
concept	concept
alternative	alternative
brothers	brothers
attacks	attacks
encyclopedia	encyclopedia
republican	republican
representatives	representatives
politicians	politicians
difficult	difficult
ability	ability
studied	studied
host	host
wall	wall
immediately	immediately
urban	urban
pakistan	pakistan
marine	marine
physical	physical
dec	dec
troops	troops
interview	interview
coming	coming
semi	semi
suggest	suggest
emperor	emperor
letter	letter
couple	couple
duke	duke
tell	tell
gallery	gallery
follow	follow
windows	windows
tree	tree
hits	hits
jazz	jazz
protection	protection
relevant	relevant
count	count
situation	situation
reviews	reviews
containing	containing
classical	classical
offered	offered
lady	lady
netherlands	netherlands
reports	reports
influence	influence
address	address
linear	linear
consider	consider
machine	machine
domain	domain
elements	elements
minnesota	minnesota
types	types
nov	nov
serve	serve
sydney	sydney
ministry	ministry
blood	blood
distance	distance
bottom	bottom
giving	giving
boys	boys
potential	potential
toronto	toronto
edited	edited
infantry	infantry
jun	jun
formerly	formerly
oct	oct
conflict	conflict
workers	workers
steve	steve
philadelphia	philadelphia
helped	helped
der	der
nationality	nationality
dispute	dispute
scene	scene
method	method
titles	titles
berlin	berlin
conditions	conditions
arms	arms
races	races
maybe	maybe
discovered	discovered
iron	iron
extended	extended
churches	churches
positive	positive
santa	santa
nom	nom
longew	longew
imperial	imperial
composed	composed
latns	latns
ball	ball
width	width
quickly	quickly
correct	correct
responsible	responsible
possibly	possibly
indiana	indiana
soldiers	soldiers
examples	examples
korean	korean
genre	genre
fish	fish
senate	senate
effects	effects
gun	gun
check	check
appearances	appearances
plans	plans
renamed	renamed
sign	sign
reporting	reporting
sweden	sweden
consists	consists
heritage	heritage
tag	tag
primarily	primarily
doctor	doctor
leaders	leaders
lies	lies
inc	inc
rivers	rivers
crime	crime
liberal	liberal
stand	stand
bob	bob
existing	existing
publishing	publishing
industrial	industrial
answer	answer
split	split
apr	apr
sex	sex
mixed	mixed
acting	acting
personnel	personnel
rail	rail
die	die
premier	premier
approach	approach
wisconsin	wisconsin
sentence	sentence
root	root
ago	ago
standards	standards
comics	comics
earned	earned
miss	miss
specifically	specifically
horse	horse
contributions	contributions
carried	carried
lieutenant	lieutenant
wood	wood
plants	plants
initial	initial
origin	origin
environment	environment
pretty	pretty
rank	rank
bus	bus
gas	gas
direction	direction
guide	guide
resources	resources
affairs	affairs
accepted	accepted
animals	animals
nor	nor
activity	activity
levels	levels
laws	laws
jim	jim
creating	creating
cambridge	cambridge
ones	ones
composer	composer
remove	remove
agency	agency
reserve	reserve
atlantic	atlantic
supreme	supreme
weight	weight
ask	ask
fighting	fighting
jackson	jackson
widely	widely
rose	rose
operating	operating
treatment	treatment
linked	linked
andrew	andrew
trial	trial
expanded	expanded
daniel	daniel
certainly	certainly
info	info
sciences	sciences
fame	fame
everything	everything
avenue	avenue
travel	travel
scale	scale
break	break
oregon	oregon
housing	housing
produce	produce
capacity	capacity
#efefef	#efefef
fictional	fictional
exchange	exchange
actions	actions
cited	cited
typically	typically
settlement	settlement
agreement	agreement
translation	translation
males	males
kansas	kansas
managed	managed
bring	bring
charge	charge
fails	fails
dedicated	dedicated
estate	estate
nearby	nearby
residents	residents
piece	piece
growth	growth
trust	trust
applied	applied
drums	drums
issued	issued
murder	murder
normal	normal
twenty	twenty
commonly	commonly
avoid	avoid
tony	tony
norwegian	norwegian
criteria	criteria
context	context
suggested	suggested
revolution	revolution
fully	fully
wars	wars
prominent	prominent
aug	aug
leaves	leaves
advanced	advanced
distribution	distribution
medicine	medicine
garden	garden
reach	reach
turkey	turkey
females	females
publications	publications
impact	impact
households	households
survey	survey
height	height
morning	morning
honor	honor
deep	deep
argument	argument
publication	publication
arthur	arthur
elizabeth	elizabeth
disambiguation	disambiguation
worth	worth
colorado	colorado
median	median
maryland	maryland
falls	falls
zone	zone
solo	solo
learning	learning
pay	pay
resolves	resolves
choice	choice
vol	vol
flag	flag
engineer	engineer
cars	cars
farm	farm
wilson	wilson
principal	principal
acquired	acquired
constructed	constructed
secret	secret
poet	poet
build	build
remain	remain
orchestra	orchestra
versions	versions
fixed	fixed
efforts	efforts
documentary	documentary
equipment	equipment
ray	ray
yellow	yellow
guard	guard
pressure	pressure
grant	grant
prison	prison
freedom	freedom
norway	norway
store	store
taylor	taylor
quarter	quarter
designated	designated
independence	independence
platform	platform
rome	rome
teacher	teacher
copy	copy
effort	effort
nuclear	nuclear
pictures	pictures
models	models
sep	sep
everyone	everyone
easily	easily
thank	thank
description	description
agreed	agreed
institutions	institutions
covers	covers
facilities	facilities
target	target
stack	stack
rationale	rationale
stat	stat
combined	combined
bronze	bronze
hosted	hosted
programming	programming
sri	sri
railroad	railroad
unique	unique
defined	defined
ocean	ocean
cell	cell
missouri	missouri
concert	concert
improve	improve
biography	biography
loan	loan
contact	contact
holy	holy
tennessee	tennessee
sub	sub
safety	safety
competed	competed
stephen	stephen
policies	policies
painting	painting
price	price
entirely	entirely
mexican	mexican
leadership	leadership
flying	flying
message	message
municipal	municipal
serious	serious
headquarters	headquarters
officially	officially
cemetery	cemetery
memory	memory
fields	fields
generation	generation
join	join
copies	copies
finals	finals
fox	fox
continues	continues
representative	representative
destroyed	destroyed
feet	feet
guy	guy
philippines	philippines
revealed	revealed
organized	organized
serves	serves
conservative	conservative
share	share
maria	maria
disease	disease
sections	sections
philosophy	philosophy
ways	ways
arrived	arrived
divided	divided
floor	floor
latd	latd
longd	longd
labour	labour
logo	logo
meets	meets
yard	yard
cancer	cancer
offer	offer
tax	tax
expected	expected
traffic	traffic
concerns	concerns
graduated	graduated
guest	guest
jews	jews
formation	formation
meant	meant
economy	economy
storm	storm
mile	mile
protected	protected
bowl	bowl
letters	letters
providing	providing
begins	begins
classic	classic
damage	damage
harry	harry
offers	offers
davis	davis
challenge	challenge
views	views
marked	marked
allows	allows
density	density
literary	literary
htm	htm
ben	ben
transportation	transportation
kentucky	kentucky
sales	sales
fleet	fleet
supporting	supporting
captured	captured
extra	extra
recognized	recognized
arizona	arizona
compared	compared
theme	theme
francis	francis
moscow	moscow
interested	interested
heard	heard
behavior	behavior
transferred	transferred
environmental	environmental
blank	blank
musician	musician
starring	starring
assigned	assigned
seats	seats
tennis	tennis
percent	percent
logs	logs
display	display
convention	convention
ring	ring
joint	joint
brian	brian
deputy	deputy
planned	planned
universities	universities
yards	yards
communist	communist
agent	agent
difference	difference
animal	animal
czech	czech
positions	positions
exactly	exactly
stay	stay
titled	titled
combat	combat
palace	palace
card	card
ordered	ordered
opposition	opposition
attempts	attempts
understanding	understanding
wrestling	wrestling
critics	critics
growing	growing
establish	establish
hands	hands
latm	latm
longm	longm
participated	participated
revert	revert
poetry	poetry
materials	materials
turkish	turkish
paid	paid
promotion	promotion
apparently	apparently
battalion	battalion
mobile	mobile
additions	additions
row	row
shortsummary	shortsummary
merged	merged
metropolitan	metropolitan
figures	figures
existence	existence
eye	eye
longs	longs
louisiana	louisiana
lewis	lewis
melbourne	melbourne
austria	austria
brigade	brigade
screen	screen
risk	risk
lats	lats
ban	ban
labor	labor
legislative	legislative
definition	definition
indeed	indeed
draw	draw
application	application
steel	steel
presence	presence
expansion	expansion
earl	earl
max	max
wild	wild
planning	planning
comic	comic
adopted	adopted
easy	easy
plus	plus
happy	happy
acts	acts
classes	classes
iowa	iowa
grew	grew
save	save
wins	wins
theater	theater
exists	exists
roles	roles
chance	chance
prevent	prevent
linecolor	linecolor
candidates	candidates
object	object
felt	felt
powers	powers
birds	birds
spread	spread
defeat	defeat
cape	cape
identified	identified
regions	regions
mine	mine
sides	sides
jul	jul
showing	showing
teaching	teaching
guidelines	guidelines
simon	simon
depth	depth
lyrics	lyrics
christmas	christmas
declined	declined
greece	greece
express	express
federation	federation
voivodeship	voivodeship
journalist	journalist
intelligence	intelligence
occurred	occurred
connection	connection
displayed	displayed
portuguese	portuguese
declared	declared
constitution	constitution
presidential	presidential
sons	sons
plot	plot
dates	dates
firm	firm
ends	ends
pilot	pilot
relatively	relatively
receive	receive
educated	educated
manchester	manchester
queensland	queensland
americans	americans
introduction	introduction
directors	directors
vehicle	vehicle
stock	stock
vehicles	vehicles
israeli	israeli
frequently	frequently
hills	hills
performing	performing
northwest	northwest
drug	drug
visit	visit
portion	portion
residence	residence
walter	walter
pov	pov
interesting	interesting
moon	moon
limit	limit
minute	minute
bell	bell
athletics	athletics
reduced	reduced
wind	wind
oklahoma	oklahoma
architect	architect
ideas	ideas
electronic	electronic
crown	crown
younger	younger
anderson	anderson
step	step
weapons	weapons
unable	unable
neutral	neutral
connected	connected
switzerland	switzerland
expatriate	expatriate
armed	armed
weekly	weekly
rating	rating
programme	programme
squad	squad
medalists	medalists
multi	multi
dynasty	dynasty
cold	cold
granted	granted
alliance	alliance
methods	methods
sam	sam
alabama	alabama
albert	albert
tropical	tropical
vietnam	vietnam
dvd	dvd
refers	refers
heat	heat
fans	fans
surrounding	surrounding
purposes	purposes
credit	credit
commons	commons
boat	boat
boxes	boxes
ethnic	ethnic
speaking	speaking
fell	fell
arena	arena
roads	roads
core	core
dog	dog
kill	kill
wikiproject	wikiproject
athletic	athletic
negative	negative
confirmed	confirmed
sixth	sixth
edge	edge
jesus	jesus
tools	tools
colonel	colonel
weak	weak
chosen	chosen
brand	brand
resulting	resulting
nfl	nfl
rise	rise
supply	supply
tradition	tradition
elementary	elementary
household	household
spirit	spirit
task	task
slightly	slightly
howard	howard
incident	incident
develop	develop
southeast	southeast
sunday	sunday
discuss	discuss
stats	stats
climate	climate
topics	topics
purchased	purchased
communications	communications
chapter	chapter
broken	broken
singapore	singapore
situated	situated
license	license
haven	haven
deaths	deaths
passing	passing
citizens	citizens
guns	guns
trees	trees
gone	gone
greatest	greatest
improved	improved
visual	visual
pope	pope
officials	officials
sat	sat
glass	glass
miller	miller
resulted	resulted
posted	posted
estimated	estimated
contain	contain
brazilian	brazilian
sexual	sexual
defence	defence
respectively	respectively
rich	rich
fast	fast
properties	properties
taught	taught
extensive	extensive
exhibition	exhibition
speech	speech
les	les
proposal	proposal
straight	straight
internal	internal
effective	effective
solution	solution
fashion	fashion
foot	foot
orange	orange
argentina	argentina
brief	brief
performances	performances
adult	adult
allowing	allowing
newly	newly
identity	identity
nominator	nominator
singers	singers
inspired	inspired
discussed	discussed
require	require
transfer	transfer
egypt	egypt
cells	cells
patrick	patrick
quebec	quebec
connecticut	connecticut
scoring	scoring
anthony	anthony
permanent	permanent
phase	phase
audience	audience
motion	motion
blues	blues
hungarian	hungarian
arab	arab
trains	trains
sets	sets
ranked	ranked
begin	begin
eyes	eyes
studios	studios
gmina	gmina
criminal	criminal
commonwealth	commonwealth
finish	finish
communication	communication
scope	scope
accused	accused
divisions	divisions
accept	accept
warning	warning
alan	alan
objects	objects
diego	diego
contest	contest
fighter	fighter
finds	finds
coaches	coaches
beat	beat
extremely	extremely
ford	ford
swiss	swiss
sorry	sorry
houston	houston
worldwide	worldwide
showed	showed
holds	holds
cathedral	cathedral
losing	losing
advance	advance
reality	reality
broadcasting	broadcasting
adam	adam
vandalism	vandalism
enemy	enemy
youtube	youtube
assessed	assessed
billion	billion
buried	buried
belgium	belgium
respect	respect
rare	rare
detroit	detroit
graduate	graduate
colleges	colleges
explain	explain
authorities	authorities
killing	killing
maximum	maximum
neither	neither
fan	fan
notify	notify
painter	painter
hamilton	hamilton
attempted	attempted
universe	universe
passes	passes
obvious	obvious
suffered	suffered
pieces	pieces
apply	apply
actresses	actresses
competitions	competitions
aid	aid
driver	driver
folk	folk
dan	dan
khan	khan
baby	baby
denmark	denmark
tokyo	tokyo
billboard	billboard
calling	calling
anne	anne
happened	happened
danish	danish
wants	wants
formula	formula
interior	interior
kevin	kevin
weather	weather
powerful	powerful
muslim	muslim
registered	registered
publisher	publisher
preceding	preceding
sounds	sounds
eric	eric
approved	approved
achieved	achieved
douglas	douglas
provincial	provincial
fund	fund
portugal	portugal
athletes	athletes
bird	bird
bands	bands
audio	audio
cat	cat
bureau	bureau
centuries	centuries
valid	valid
chemical	chemical
items	items
lane	lane
holding	holding
counties	counties
update	update
ncaa	ncaa
speak	speak
finding	finding
domestic	domestic
ali	ali
false	false
equivalent	equivalent
caught	caught
christ	christ
ending	ending
toward	toward
puerto	puerto
perform	perform
partner	partner
romania	romania
aviation	aviation
failure	failure
ward	ward
strength	strength
knight	knight
nominations	nominations
hungary	hungary
concern	concern
keeping	keeping
recordings	recordings
functions	functions
mississippi	mississippi
calls	calls
criticism	criticism
involving	involving
magic	magic
gordon	gordon
treaty	treaty
antonio	antonio
selection	selection
rear	rear
colonial	colonial
motor	motor
obtained	obtained
circuit	circuit
wish	wish
compilation	compilation
harvard	harvard
islamic	islamic
determined	determined
geography	geography
arkansas	arkansas
fuel	fuel
artillery	artillery
medieval	medieval
locations	locations
inclusion	inclusion
recognition	recognition
northeast	northeast
chamber	chamber
moment	moment
succeeded	succeeded
historian	historian
condition	condition
physics	physics
newspapers	newspapers
instance	instance
represent	represent
allen	allen
watch	watch
kitt	kitt
protect	protect
grey	grey
launch	launch
dave	dave
philip	philip
iraq	iraq
changing	changing
ukraine	ukraine
municipalities	municipalities
mix	mix
tamil	tamil
shift	shift
shared	shared
austrian	austrian
door	door
investigation	investigation
institution	institution
princess	princess
trail	trail
parks	parks
applications	applications
hundred	hundred
requirements	requirements
talking	talking
kim	kim
ltd	ltd
metres	metres
gray	gray
sector	sector
dean	dean
agricultural	agricultural
incorporated	incorporated
escape	escape
orders	orders
corner	corner
commissioned	commissioned
founding	founding
mill	mill
mrs	mrs
subjects	subjects
temperature	temperature
settled	settled
spacewatch	spacewatch
remember	remember
miami	miami
promote	promote
values	values
spot	spot
progress	progress
learn	learn
planet	planet
occupied	occupied
usage	usage
southwest	southwest
refused	refused
truth	truth
clark	clark
sufficient	sufficient
equal	equal
administrator	administrator
persons	persons
factory	factory
fought	fought
derived	derived
outstanding	outstanding
magazines	magazines
flow	flow
peer	peer
attacked	attacked
generate	generate
shape	shape
creator	creator
requires	requires
option	option
lincoln	lincoln
starts	starts
stands	stands
carry	carry
establishment	establishment
selling	selling
causes	causes
budget	budget
battles	battles
sky	sky
legend	legend
arrested	arrested
forum	forum
metro	metro
broke	broke
strike	strike
injury	injury
ryan	ryan
zero	zero
converted	converted
violence	violence
significantly	significantly
statements	statements
controlled	controlled
welsh	welsh
roger	roger
pdf	pdf
distinguished	distinguished
samuel	samuel
translated	translated
papers	papers
detail	detail
chapel	chapel
frederick	frederick
thousands	thousands
banks	banks
offensive	offensive
kings	kings
factor	factor
rename	rename
replace	replace
museums	museums
resistance	resistance
junction	junction
tries	tries
tim	tim
engines	engines
contributed	contributed
medium	medium
device	device
profit	profit
dream	dream
enter	enter
twelve	twelve
universal	universal
typical	typical
seeing	seeing
skills	skills
bought	bought
passenger	passenger
cleveland	cleveland
funding	funding
agriculture	agriculture
parent	parent
decades	decades
receiving	receiving
signal	signal
reform	reform
organisation	organisation
prix	prix
column	column
utah	utah
managers	managers
qualified	qualified
indicate	indicate
ukrainian	ukrainian
gay	gay
amateur	amateur
obviously	obviously
flora	flora
gene	gene
soul	soul
alt	alt
discussions	discussions
montreal	montreal
turns	turns
walker	walker
entrance	entrance
path	path
nice	nice
string	string
influenced	influenced
developing	developing
abandoned	abandoned
humans	humans
pair	pair
flat	flat
sample	sample
contained	contained
banned	banned
moore	moore
strongly	strongly
visited	visited
increasing	increasing
attorney	attorney
arm	arm
mathematics	mathematics
canal	canal
charts	charts
thinking	thinking
dublin	dublin
suggests	suggests
surname	surname
brain	brain
pittsburgh	pittsburgh
blog	blog
economics	economics
seventh	seventh
alex	alex
employed	employed
heavily	heavily
authors	authors
paintings	paintings
concerned	concerned
recipients	recipients
scholars	scholars
controversial	controversial
controversy	controversy
reverted	reverted
expressed	expressed
josé	josé
bodies	bodies
conservation	conservation
maps	maps
marie	marie
arguments	arguments
chain	chain
focused	focused
readers	readers
carl	carl
violation	violation
offices	offices
wave	wave
circle	circle
apart	apart
invasion	invasion
jimmy	jimmy
opportunity	opportunity
determine	determine
colspan	colspan
orthodox	orthodox
voted	voted
formal	formal
describes	describes
seconds	seconds
cycle	cycle
doubt	doubt
golf	golf
walls	walls
productions	productions
constituency	constituency
closely	closely
occurs	occurs
huge	huge
andy	andy
representing	representing
indonesia	indonesia
sell	sell
mon	mon
drawn	drawn
diocese	diocese
tank	tank
advice	advice
senator	senator
generated	generated
malaysia	malaysia
asking	asking
finland	finland
causing	causing
leads	leads
lawyer	lawyer
seattle	seattle
gain	gain
index	index
saints	saints
runner	runner
crisis	crisis
cinema	cinema
matt	matt
hollywood	hollywood
reaction	reaction
medals	medals
documents	documents
reader	reader
lawrence	lawrence
pattern	pattern
archives	archives
atlanta	atlanta
voting	voting
reviewed	reviewed
looked	looked
bear	bear
perfect	perfect
restored	restored
bruce	bruce
baltimore	baltimore
baron	baron
pan	pan
commune	commune
fantasy	fantasy
duty	duty
chair	chair
scenes	scenes
broad	broad
opposite	opposite
stuff	stuff
aged	aged
streets	streets
nick	nick
anna	anna
billy	billy
extension	extension
kent	kent
parliamentary	parliamentary
kelly	kelly
shooting	shooting
ready	ready
pick	pick
songwriter	songwriter
aware	aware
jordan	jordan
dictionary	dictionary
composition	composition
salt	salt
bangladesh	bangladesh
bot	bot
successfully	successfully
benefit	benefit
lands	lands
interests	interests
scheduled	scheduled
teachers	teachers
closing	closing
advertising	advertising
contribution	contribution
maine	maine
retirement	retirement
scientists	scientists
dam	dam
blocks	blocks
las	las
print	print
techniques	techniques
participate	participate
anniversary	anniversary
requested	requested
discovery	discovery
explained	explained
expedition	expedition
citation	citation
assist	assist
und	und
meanwhile	meanwhile
hampshire	hampshire
creative	creative
maintain	maintain
pierre	pierre
detailed	detailed
facts	facts
frame	frame
finance	finance
socialist	socialist
script	script
camera	camera
returns	returns
engaged	engaged
assistance	assistance
experienced	experienced
underground	underground
sale	sale
beautiful	beautiful
jane	jane
abc	abc
successor	successor
classification	classification
tool	tool
mining	mining
producing	producing
cabinet	cabinet
bytes	bytes
ross	ross
russell	russell
citations	citations
maintained	maintained
evening	evening
singing	singing
fifa	fifa
gender	gender
venues	venues
lakes	lakes
mail	mail
jeff	jeff
electoral	electoral
emergency	emergency
mode	mode
christopher	christopher
heads	heads
proved	proved
priest	priest
funds	funds
investment	investment
romanian	romanian
session	session
capture	capture
aspects	aspects
reduce	reduce
trophy	trophy
abuse	abuse
prefecture	prefecture
walk	walk
faced	faced
normally	normally
snow	snow
shop	shop
dakota	dakota
bush	bush
coal	coal
inhabitants	inhabitants
headed	headed
gary	gary
employees	employees
error	error
invited	invited
cable	cable
protein	protein
accident	accident
decade	decade
measure	measure
watched	watched
patients	patients
downtown	downtown
animated	animated
satellite	satellite
johnny	johnny
combination	combination
courts	courts
sequence	sequence
hook	hook
clean	clean
owners	owners
twin	twin
distributed	distributed
describe	describe
defensive	defensive
islam	islam
photos	photos
ottoman	ottoman
trained	trained
affected	affected
routes	routes
ministers	ministers
wine	wine
lanka	lanka
carlos	carlos
landing	landing
collected	collected
revival	revival
rio	rio
communes	communes
saturday	saturday
mps	mps
guess	guess
drop	drop
sarah	sarah
swimming	swimming
membership	membership
edinburgh	edinburgh
fit	fit
harris	harris
dallas	dallas
degrees	degrees
bachelor	bachelor
personally	personally
briefly	briefly
files	files
conduct	conduct
extreme	extreme
courses	courses
homes	homes
reaching	reaching
sought	sought
vision	vision
demand	demand
vertical	vertical
updated	updated
marketing	marketing
jason	jason
consisted	consisted
appeal	appeal
plane	plane
quick	quick
victor	victor
dyk	dyk
solar	solar
ages	ages
neighborhood	neighborhood
wings	wings
acid	acid
scheme	scheme
matters	matters
rfc	rfc
constant	constant
additionally	additionally
hip	hip
admins	admins
nova	nova
ceremony	ceremony
chile	chile
composers	composers
nazi	nazi
scholar	scholar
liverpool	liverpool
hero	hero
designer	designer
learned	learned
instruments	instruments
welcome	welcome
hair	hair
consecutive	consecutive
movies	movies
adjacent	adjacent
pool	pool
norman	norman
collections	collections
belgian	belgian
corporate	corporate
austin	austin
driving	driving
phone	phone
fly	fly
ian	ian
window	window
document	document
adams	adams
collaboration	collaboration
margaret	margaret
kennedy	kennedy
leg	leg
videos	videos
assume	assume
attached	attached
dry	dry
expand	expand
bible	bible
matthew	matthew
depending	depending
serbian	serbian
instrument	instrument
covering	covering
random	random
represents	represents
participants	participants
thorough	thorough
mentions	mentions
portrait	portrait
drivers	drivers
airlines	airlines
franklin	franklin
viewers	viewers
finnish	finnish
differences	differences
venue	venue
vocal	vocal
element	element
regularly	regularly
rejected	rejected
relative	relative
illegal	illegal
stewart	stewart
roof	roof
leagues	leagues
argued	argued
colour	colour
morgan	morgan
prisoners	prisoners
facebook	facebook
attend	attend
nelson	nelson
survived	survived
insurance	insurance
expert	expert
steam	steam
cards	cards
manufacturing	manufacturing
testing	testing
coastal	coastal
yorkshire	yorkshire
rescue	rescue
territories	territories
thu	thu
thailand	thailand
choose	choose
vienna	vienna
journey	journey
storage	storage
costs	costs
singh	singh
notably	notably
soldier	soldier
colony	colony
evolution	evolution
taiwan	taiwan
hurricane	hurricane
judges	judges
gardens	gardens
poems	poems
removing	removing
driven	driven
responsibility	responsibility
sentences	sentences
birmingham	birmingham
engineers	engineers
visible	visible
substantial	substantial
gulf	gulf
installed	installed
revolutionary	revolutionary
inner	inner
trip	trip
restaurant	restaurant
graham	graham
stores	stores
rice	rice
prove	prove
reasonable	reasonable
skin	skin
committed	committed
volleyball	volleyball
chose	chose
factors	factors
hundreds	hundreds
injured	injured
devices	devices
phrase	phrase
stanley	stanley
lemmon	lemmon
thompson	thompson
suicide	suicide
advantage	advantage
automatically	automatically
disc	disc
minimum	minimum
goods	goods
charges	charges
alfred	alfred
operator	operator
merely	merely
finishing	finishing
fred	fred
identify	identify
producers	producers
ann	ann
campbell	campbell
portland	portland
latest	latest
releases	releases
victims	victims
explanation	explanation
operate	operate
threat	threat
crossing	crossing
slow	slow
poets	poets
stopped	stopped
strategy	strategy
wayne	wayne
ranking	ranking
disney	disney
wright	wright
residential	residential
associate	associate
significance	significance
ruled	ruled
excellent	excellent
observed	observed
threatened	threatened
friendly	friendly
redirects	redirects
temporary	temporary
masters	masters
peninsula	peninsula
networks	networks
passengers	passengers
assumed	assumed
artistic	artistic
safe	safe
festivals	festivals
compete	compete
png	png
hunter	hunter
moths	moths
alaska	alaska
partnership	partnership
maintenance	maintenance
monitoring	monitoring
evil	evil
relief	relief
charlie	charlie
poverty	poverty
hop	hop
fri	fri
encyclopedic	encyclopedic
filled	filled
nba	nba
decide	decide
breaking	breaking
argentine	argentine
resigned	resigned
oblast	oblast
drew	drew
hawaii	hawaii
brooklyn	brooklyn
historians	historians
speaker	speaker
moth	moth
permission	permission
wounded	wounded
racial	racial
marshall	marshall
gate	gate
springs	springs
roy	roy
photography	photography
helping	helping
knights	knights
roll	roll
progressive	progressive
contrast	contrast
continuing	continuing
processes	processes
terminal	terminal
executed	executed
shall	shall
svg	svg
spouse	spouse
infrastructure	infrastructure
principle	principle
painters	painters
painted	painted
properly	properly
frequency	frequency
shaped	shaped
joining	joining
robinson	robinson
waters	waters
ridge	ridge
bridges	bridges
ceo	ceo
monument	monument
mental	mental
carter	carter
karl	karl
mac	mac
orleans	orleans
portal	portal
parallel	parallel
regardless	regardless
thirty	thirty
giant	giant
qualifying	qualifying
murray	murray
afghanistan	afghanistan
assessment	assessment
counter	counter
bears	bears
purchase	purchase
expression	expression
backing	backing
uefa	uefa
improvement	improvement
madrid	madrid
closure	closure
wheel	wheel
ambassador	ambassador
desert	desert
bringing	bringing
iranian	iranian
reign	reign
uncle	uncle
severe	severe
rain	rain
admiral	admiral
fishing	fishing
existed	existed
raise	raise
broadway	broadway
principles	principles
grow	grow
tests	tests
roughly	roughly
tech	tech
trouble	trouble
rico	rico
paragraph	paragraph
bat	bat
prepared	prepared
measures	measures
robin	robin
hired	hired
fear	fear
merit	merit
participation	participation
massive	massive
designs	designs
agencies	agencies
technique	technique
alberta	alberta
egyptian	egyptian
clerk	clerk
knew	knew
narrow	narrow
adapted	adapted
commissioner	commissioner
rapid	rapid
credited	credited
dating	dating
businesses	businesses
bomb	bomb
capable	capable
poem	poem
stages	stages
honorary	honorary
dragon	dragon
charged	charged
propose	propose
modified	modified
fired	fired
mlb	mlb
send	send
proof	proof
practices	practices
arabic	arabic
attractions	attractions
mouth	mouth
fix	fix
licensed	licensed
symbol	symbol
organ	organ
damaged	damaged
warren	warren
exception	exception
costa	costa
unfortunately	unfortunately
jerusalem	jerusalem
replacement	replacement
indians	indians
soundtrack	soundtrack
virgin	virgin
thousand	thousand
vancouver	vancouver
legislation	legislation
beauty	beauty
credits	credits
buy	buy
organisations	organisations
serbia	serbia
christianity	christianity
opinions	opinions
cavalry	cavalry
tribe	tribe
richmond	richmond
chess	chess
channels	channels
claiming	claiming
exact	exact
baker	baker
allied	allied
involvement	involvement
anime	anime
referring	referring
donald	donald
sisters	sisters
willing	willing
requests	requests
unusual	unusual
impossible	impossible
colors	colors
cook	cook
drawing	drawing
wikimedia	wikimedia
jonathan	jonathan
removal	removal
moves	moves
indicates	indicates
admitted	admitted
ownership	ownership
shore	shore
monitored	monitored
nebraska	nebraska
regulations	regulations
crash	crash
guitarist	guitarist
supports	supports
abbey	abbey
deleting	deleting
nevada	nevada
barry	barry
tone	tone
indigenous	indigenous
personality	personality
reception	reception
transit	transit
buffalo	buffalo
flowers	flowers
bond	bond
jay	jay
adventure	adventure
definitely	definitely
guinea	guinea
horror	horror
rangers	rangers
pointed	pointed
apple	apple
popularity	popularity
occasionally	occasionally
coalition	coalition
franchise	franchise
starred	starred
critic	critic
journals	journals
rolling	rolling
percentage	percentage
silent	silent
laboratory	laboratory
microsoft	microsoft
movements	movements
charter	charter
suitable	suitable
alternate	alternate
offering	offering
missions	missions
hlist	hlist
experimental	experimental
rooms	rooms
concluded	concluded
reputation	reputation
accurate	accurate
versus	versus
websites	websites
interpretation	interpretation
tagged	tagged
endemic	endemic
chemistry	chemistry
achieve	achieve
knows	knows
manga	manga
journalists	journalists
forests	forests
cbs	cbs
comprehensive	comprehensive
symphony	symphony
promotional	promotional
electrical	electrical
tags	tags
meters	meters
jerry	jerry
tigers	tigers
commerce	commerce
remix	remix
addressed	addressed
phil	phil
automatic	automatic
gang	gang
printed	printed
oak	oak
warner	warner
tend	tend
quote	quote
separated	separated
bishops	bishops
glasgow	glasgow
essentially	essentially
wait	wait
input	input
battery	battery
favor	favor
benjamin	benjamin
apparent	apparent
shopping	shopping
patrol	patrol
eagle	eagle
mainstream	mainstream
angel	angel
martial	martial
restoration	restoration
delhi	delhi
hans	hans
indicated	indicated
morris	morris
railways	railways
centers	centers
mills	mills
helpful	helpful
delivered	delivered
components	components
victorian	victorian
legislature	legislature
tourism	tourism
treated	treated
kids	kids
barbara	barbara
essay	essay
circumstances	circumstances
repeated	repeated
plain	plain
superior	superior
strategic	strategic
similarly	similarly
duties	duties
effectively	effectively
considering	considering
arranged	arranged
ken	ken
grammar	grammar
amendment	amendment
alleged	alleged
relation	relation
habitat	habitat
spoken	spoken
shell	shell
mounted	mounted
entries	entries
conflicts	conflicts
philippine	philippine
montana	montana
appearing	appearing
triple	triple
boundary	boundary
caribbean	caribbean
hosts	hosts
signs	signs
seriously	seriously
bristol	bristol
mitchell	mitchell
industries	industries
colombia	colombia
comparison	comparison
basin	basin
eleven	eleven
ill	ill
putting	putting
pradesh	pradesh
charity	charity
output	output
dna	dna
carbon	carbon
boats	boats
desc	desc
architectural	architectural
representation	representation
commentary	commentary
rising	rising
visitors	visitors
markets	markets
plate	plate
giants	giants
processing	processing
landscape	landscape
dick	dick
hunt	hunt
summit	summit
psychology	psychology
ride	ride
greatly	greatly
guardian	guardian
terminus	terminus
losses	losses
balance	balance
democracy	democracy
submarine	submarine
nicholas	nicholas
usual	usual
peru	peru
eighth	eighth
instrumental	instrumental
hindu	hindu
defender	defender
riding	riding
arrival	arrival
evans	evans
turning	turning
imply	imply
prose	prose
cargo	cargo
hidden	hidden
volunteer	volunteer
bio	bio
holder	holder
sugar	sugar
daughters	daughters
wildlife	wildlife
fun	fun
integrated	integrated
partners	partners
rates	rates
grace	grace
feed	feed
childhood	childhood
accompanied	accompanied
milan	milan
photographs	photographs
honour	honour
soil	soil
server	server
manual	manual
concrete	concrete
possibility	possibility
ghost	ghost
confused	confused
tunnel	tunnel
larry	larry
styles	styles
elevation	elevation
muhammad	muhammad
considerable	considerable
inter	inter
lose	lose
phoenix	phoenix
sweet	sweet
waste	waste
operational	operational
tall	tall
qualify	qualify
constitutional	constitutional
sporting	sporting
peoples	peoples
acceptable	acceptable
fruit	fruit
decisions	decisions
depression	depression
perspective	perspective
midfielder	midfielder
crystal	crystal
monastery	monastery
resident	resident
cincinnati	cincinnati
tied	tied
surgery	surgery
steps	steps
carrier	carrier
stream	stream
alice	alice
kick	kick
strange	strange
predecessor	predecessor
bernard	bernard
nigeria	nigeria
pain	pain
influential	influential
punk	punk
wooden	wooden
suggestion	suggestion
interaction	interaction
retained	retained
achievement	achievement
mechanical	mechanical
drugs	drugs
missed	missed
trinity	trinity
classified	classified
minority	minority
businessman	businessman
grown	grown
coat	coat
powered	powered
alive	alive
nbc	nbc
nhl	nhl
keith	keith
bobby	bobby
harbor	harbor
behaviour	behaviour
croatian	croatian
maritime	maritime
terry	terry
virtual	virtual
indoor	indoor
periods	periods
spiritual	spiritual
croatia	croatia
lions	lions
archbishop	archbishop
luis	luis
merchant	merchant
azerbaijan	azerbaijan
lots	lots
contested	contested
editorial	editorial
initiative	initiative
charlotte	charlotte
pure	pure
borders	borders
persian	persian
marks	marks
armenian	armenian
romantic	romantic
replacing	replacing
talent	talent
unlikely	unlikely
panel	panel
jump	jump
animation	animation
agents	agents
employment	employment
trading	trading
parker	parker
statue	statue
dated	dated
wonder	wonder
filed	filed
provinces	provinces
friday	friday
jobs	jobs
cuba	cuba
aside	aside
são	são
scientist	scientist
schedule	schedule
waiting	waiting
familiar	familiar
suspect	suspect
disagree	disagree
suggestions	suggestions
turner	turner
forming	forming
formally	formally
locomotives	locomotives
barcelona	barcelona
consistent	consistent
recommended	recommended
desire	desire
happens	happens
patient	patient
bulgaria	bulgaria
vincent	vincent
hear	hear
texts	texts
belief	belief
visitor	visitor
vessels	vessels
basically	basically
continental	continental
hole	hole
fail	fail
passage	passage
wedding	wedding
archaeological	archaeological
layer	layer
designation	designation
clan	clan
revenue	revenue
seeking	seeking
couples	couples
entering	entering
suit	suit
soft	soft
weekend	weekend
approval	approval
democrats	democrats
crimes	crimes
collins	collins
expatriates	expatriates
horses	horses
wear	wear
visiting	visiting
supporters	supporters
cash	cash
dennis	dennis
resource	resource
sculpture	sculpture
practical	practical
harrison	harrison
pink	pink
oliver	oliver
limits	limits
cooper	cooper
illustrated	illustrated
sur	sur
hell	hell
statistical	statistical
referenced	referenced
wolf	wolf
warriors	warriors
incidents	incidents
fresh	fresh
editions	editions
roots	roots
signature	signature
clinical	clinical
premiered	premiered
volumes	volumes
worst	worst
adults	adults
contribute	contribute
necessarily	necessarily
immediate	immediate
feeling	feeling
theories	theories
essential	essential
completion	completion
conclusion	conclusion
technologies	technologies
strip	strip
bound	bound
praised	praised
stayed	stayed
hull	hull
diamond	diamond
origins	origins
empty	empty
eliminated	eliminated
valuable	valuable
cite	cite
doubles	doubles
branches	branches
honors	honors
brick	brick
experiences	experiences
beijing	beijing
tie	tie
lgbt	lgbt
liberty	liberty
repeatedly	repeatedly
siege	siege
baptist	baptist
ron	ron
hebrew	hebrew
affect	affect
portrayed	portrayed
decline	decline
coaching	coaching
alpha	alpha
equipped	equipped
identical	identical
submitted	submitted
enterprise	enterprise
touch	touch
transmission	transmission
platforms	platforms
cave	cave
filmed	filmed
inch	inch
cool	cool
bulgarian	bulgarian
debuted	debuted
liga	liga
manhattan	manhattan
destruction	destruction
activist	activist
weapon	weapon
clay	clay
keyboards	keyboards
dangerous	dangerous
viewed	viewed
email	email
biology	biology
bold	bold
bowling	bowling
compare	compare
treaties	treaties
affiliated	affiliated
sock	sock
assault	assault
monthly	monthly
foster	foster
cousin	cousin
urls	urls
hispanic	hispanic
logic	logic
craig	craig
trivial	trivial
pioneer	pioneer
muslims	muslims
lay	lay
rated	rated
absence	absence
amsterdam	amsterdam
publishers	publishers
tribes	tribes
percussion	percussion
runners	runners
themes	themes
#the	#the
benefits	benefits
guards	guards
flows	flows
attributed	attributed
stubs	stubs
athens	athens
herbert	herbert
celebrated	celebrated
sponsored	sponsored
raf	raf
delaware	delaware
neil	neil
pole	pole
ref	ref
historically	historically
tail	tail
tours	tours
stable	stable
decides	decides
vessel	vessel
identification	identification
delta	delta
telling	telling
writes	writes
mediterranean	mediterranean
volunteers	volunteers
reply	reply
stuart	stuart
marvel	marvel
luke	luke
grave	grave
odd	odd
hearing	hearing
uss	uss
mall	mall
penalty	penalty
solutions	solutions
secure	secure
hugh	hugh
steven	steven
sole	sole
architects	architects
characteristics	characteristics
falling	falling
spin	spin
clinton	clinton
villa	villa
select	select
metric	metric
criticized	criticized
surviving	surviving
roberts	roberts
standings	standings
biological	biological
lloyd	lloyd
munich	munich
belongs	belongs
adelaide	adelaide
belong	belong
harold	harold
norfolk	norfolk
butler	butler
rival	rival
acoustic	acoustic
posts	posts
adaptation	adaptation
greg	greg
reporter	reporter
url	url
absolutely	absolutely
nobody	nobody
scholarship	scholarship
vast	vast
exit	exit
facing	facing
dual	dual
belt	belt
noticed	noticed
patent	patent
mathematical	mathematical
rarely	rarely
submission	submission
demographics	demographics
crowd	crowd
rick	rick
governments	governments
bonus	bonus
tourist	tourist
mystery	mystery
click	click
settlements	settlements
walking	walking
voters	voters
rifle	rifle
component	component
civilian	civilian
partial	partial
encouraged	encouraged
birthday	birthday
eddie	eddie
christians	christians
denver	denver
petersburg	petersburg
researchers	researchers
partly	partly
photographer	photographer
runtime	runtime
jon	jon
obama	obama
seemed	seemed
clock	clock
violin	violin
highways	highways
holiday	holiday
distinction	distinction
artwork	artwork
makeup	makeup
catherine	catherine
font	font
farmers	farmers
occasions	occasions
guideline	guideline
photograph	photograph
struggle	struggle
timestamp	timestamp
produces	produces
yale	yale
options	options
pen	pen
procedure	procedure
jacob	jacob
convicted	convicted
touring	touring
transition	transition
anglo	anglo
legacy	legacy
denied	denied
relationships	relationships
ottawa	ottawa
derby	derby
surrounded	surrounded
libraries	libraries
competing	competing
speakers	speakers
grades	grades
hudson	hudson
administrators	administrators
sacred	sacred
signing	signing
rob	rob
citizen	citizen
dogs	dogs
argue	argue
believes	believes
annually	annually
cardinal	cardinal
nepal	nepal
intersection	intersection
discussing	discussing
reveals	reveals
defeating	defeating
disputes	disputes
beam	beam
overseas	overseas
perry	perry
nickname	nickname
ruling	ruling
syria	syria
wells	wells
contributing	contributing
ultimate	ultimate
ranks	ranks
danny	danny
retail	retail
favorite	favorite
vermont	vermont
begun	begun
download	download
trusted	trusted
appointment	appointment
ballet	ballet
jefferson	jefferson
anywhere	anywhere
sand	sand
angle	angle
sessions	sessions
recreation	recreation
wearing	wearing
kenya	kenya
accessible	accessible
ralph	ralph
thread	thread
disruptive	disruptive
spend	spend
ninth	ninth
arrest	arrest
choir	choir
trials	trials
mines	mines
injuries	injuries
rapidly	rapidly
rounds	rounds
competitive	competitive
opportunities	opportunities
meetings	meetings
commented	commented
wang	wang
woods	woods
exercise	exercise
jacques	jacques
objective	objective
demolished	demolished
preferred	preferred
resort	resort
pedro	pedro
robot	robot
venezuela	venezuela
segment	segment
studying	studying
edwards	edwards
aim	aim
dancing	dancing
eagles	eagles
demonstrated	demonstrated
tribute	tribute
continuous	continuous
encourage	encourage
spider	spider
acted	acted
convinced	convinced
heroes	heroes
describing	describing
rocks	rocks
bed	bed
gap	gap
reflect	reflect
mars	mars
participating	participating
cooperation	cooperation
obtain	obtain
gothic	gothic
protest	protest
hunting	hunting
frequent	frequent
conversion	conversion
stress	stress
manufacturers	manufacturers
checkuser	checkuser
innings	innings
traditionally	traditionally
jose	jose
adventures	adventures
tiger	tiger
totally	totally
voyage	voyage
concentration	concentration
sing	sing
rocket	rocket
electricity	electricity
shadow	shadow
boxing	boxing
senators	senators
doc	doc
stanford	stanford
machines	machines
vegas	vegas
saved	saved
jury	jury
calendar	calendar
noble	noble
tommy	tommy
guilty	guilty
leo	leo
affair	affair
handle	handle
extinct	extinct
responded	responded
shares	shares
scotia	scotia
manufacturer	manufacturer
tales	tales
implementation	implementation
truck	truck
spelling	spelling
item	item
load	load
customers	customers
adds	adds
spaces	spaces
cap	cap
orphaned	orphaned
ferry	ferry
prefer	prefer
push	push
lie	lie
berkeley	berkeley
lebanon	lebanon
madison	madison
throne	throne
attracted	attracted
lion	lion
retrieved	retrieved
manor	manor
promoting	promoting
saudi	saudi
serial	serial
abroad	abroad
rogers	rogers
lights	lights
grandfather	grandfather
gauge	gauge
concerts	concerts
elder	elder
renaissance	renaissance
uniform	uniform
chase	chase
aka	aka
computers	computers
brisbane	brisbane
susan	susan
raymond	raymond
flower	flower
col	col
thai	thai
disaster	disaster
survive	survive
involves	involves
clothing	clothing
murphy	murphy
sharp	sharp
explains	explains
yugoslavia	yugoslavia
buddhist	buddhist
publicly	publicly
meat	meat
literally	literally
spam	spam
telephone	telephone
moral	moral
sung	sung
partially	partially
lawyers	lawyers
citing	citing
interviews	interviews
brunswick	brunswick
radar	radar
spending	spending
grove	grove
tea	tea
elite	elite
bright	bright
improving	improving
sierra	sierra
heaven	heaven
athlete	athlete
aspect	aspect
answers	answers
ted	ted
consumer	consumer
funded	funded
exclusive	exclusive
ibn	ibn
manuel	manuel
allies	allies
reviewer	reviewer
missile	missile
mechanism	mechanism
helen	helen
withdrawn	withdrawn
intention	intention
mini	mini
casualties	casualties
establishing	establishing
diseases	diseases
rhythm	rhythm
pat	pat
catch	catch
poll	poll
listclass	listclass
deck	deck
newcastle	newcastle
antarctic	antarctic
leeds	leeds
lasted	lasted
ranges	ranges
listings	listings
ordinary	ordinary
insects	insects
suffering	suffering
flash	flash
worship	worship
boundaries	boundaries
blind	blind
pakistani	pakistani
assuming	assuming
interstate	interstate
patterns	patterns
arrangement	arrangement
globe	globe
honours	honours
gross	gross
gilbert	gilbert
applies	applies
gradually	gradually
managing	managing
experiment	experiment
radical	radical
gov	gov
legs	legs
opponent	opponent
diameter	diameter
supplies	supplies
pitch	pitch
utility	utility
cleanup	cleanup
opponents	opponents
regime	regime
revised	revised
plenty	plenty
genera	genera
diplomatic	diplomatic
germans	germans
seal	seal
gregory	gregory
corresponding	corresponding
concepts	concepts
sword	sword
purple	purple
pending	pending
virus	virus
populations	populations
bull	bull
drummer	drummer
presents	presents
holland	holland
congressional	congressional
bias	bias
merger	merger
remote	remote
sean	sean
messages	messages
rebellion	rebellion
premiere	premiere
physician	physician
victim	victim
con	con
cloud	cloud
angels	angels
noise	noise
heading	heading
duo	duo
beer	beer
palestinian	palestinian
us$	us$
copper	copper
jurisdiction	jurisdiction
implemented	implemented
improvements	improvements
ski	ski
hms	hms
loop	loop
renaming	renaming
drum	drum
dramatic	dramatic
saskatchewan	saskatchewan
talks	talks
earthquake	earthquake
rhode	rhode
hat	hat
requirement	requirement
den	den
tanks	tanks
presidents	presidents
societies	societies
min	min
defending	defending
alcohol	alcohol
dominated	dominated
sang	sang
eat	eat
graphics	graphics
constituencies	constituencies
asp	asp
coffee	coffee
batting	batting
chancellor	chancellor
destroy	destroy
tons	tons
cruz	cruz
warsaw	warsaw
exclusively	exclusively
connections	connections
rush	rush
heights	heights
playstation	playstation
outcome	outcome
apartment	apartment
cardinals	cardinals
fill	fill
recipient	recipient
correctly	correctly
traditions	traditions
fundamental	fundamental
thin	thin
chan	chan
resolved	resolved
mario	mario
departments	departments
dame	dame
shield	shield
fighters	fighters
ivan	ivan
writings	writings
bosnia	bosnia
sentenced	sentenced
violent	violent
harbour	harbour
margin	margin
auckland	auckland
postal	postal
pirates	pirates
collective	collective
diesel	diesel
liberation	liberation
confederate	confederate
devil	devil
activists	activists
sultan	sultan
rider	rider
amazon	amazon
florence	florence
marc	marc
arnold	arnold
shah	shah
reduction	reduction
contents	contents
genetic	genetic
somerset	somerset
locally	locally
milk	milk
romance	romance
intellectual	intellectual
latino	latino
failing	failing
mason	mason
pete	pete
advisory	advisory
arbitration	arbitration
interface	interface
hitler	hitler
default	default
accessed	accessed
lifetime	lifetime
sheffield	sheffield
departure	departure
hindi	hindi
anglican	anglican
suggesting	suggesting
mistake	mistake
embassy	embassy
murdered	murdered
sox	sox
sleep	sleep
suspended	suspended
sum	sum
mythology	mythology
bengal	bengal
confusion	confusion
oscar	oscar
programmes	programmes
therapy	therapy
occasion	occasion
exposed	exposed
assisted	assisted
possession	possession
defend	defend
devoted	devoted
graphic	graphic
warfare	warfare
milwaukee	milwaukee
informed	informed
anonymous	anonymous
reverse	reverse
soap	soap
territorial	territorial
lisa	lisa
paulo	paulo
northwestern	northwestern
playoffs	playoffs
boss	boss
nasa	nasa
quoted	quoted
byzantine	byzantine
idaho	idaho
poster	poster
geographic	geographic
rebounds	rebounds
congo	congo
venture	venture
worse	worse
hoax	hoax
restricted	restricted
advocate	advocate
doors	doors
naming	naming
situations	situations
instructions	instructions
sullivan	sullivan
tables	tables
leaf	leaf
shoot	shoot
substitute	substitute
restaurants	restaurants
contributor	contributor
spoke	spoke
errors	errors
enjoyed	enjoyed
framework	framework
rocky	rocky
kerala	kerala
shakespeare	shakespeare
quantum	quantum
immigration	immigration
mirror	mirror
certified	certified
assets	assets
potentially	potentially
presentation	presentation
cotton	cotton
sitting	sitting
tournaments	tournaments
syndrome	syndrome
checked	checked
forty	forty
sourcing	sourcing
journalism	journalism
upload	upload
unsuccessful	unsuccessful
towers	towers
conductor	conductor
hospitals	hospitals
bone	bone
essex	essex
rebuilt	rebuilt
wellington	wellington
ideal	ideal
raw	raw
sharing	sharing
labels	labels
leonard	leonard
watson	watson
governors	governors
posting	posting
harvey	harvey
bases	bases
hello	hello
rabbi	rabbi
hardware	hardware
ensemble	ensemble
monster	monster
pitcher	pitcher
emphasis	emphasis
recovery	recovery
respond	respond
aaron	aaron
lesser	lesser
qualification	qualification
organic	organic
exposure	exposure
palestine	palestine
thoughts	thoughts
needing	needing
maurice	maurice
immigrants	immigrants
variant	variant
lap	lap
legitimate	legitimate
autonomous	autonomous
wallace	wallace
succession	succession
throw	throw
monday	monday
reserves	reserves
donated	donated
increases	increases
kid	kid
guidance	guidance
delivery	delivery
joan	joan
fifty	fifty
slave	slave
feedback	feedback
columbus	columbus
stones	stones
manage	manage
cgi	cgi
initiated	initiated
favour	favour
printing	printing
variable	variable
theology	theology
todd	todd
parameters	parameters
traveled	traveled
canton	canton
han	han
reed	reed
celtic	celtic
characteristic	characteristic
commanded	commanded
searching	searching
inappropriate	inappropriate
switch	switch
ties	ties
tube	tube
otto	otto
debt	debt
outdoor	outdoor
navigation	navigation
eligible	eligible
experts	experts
expensive	expensive
tier	tier
gospel	gospel
newton	newton
essays	essays
shanghai	shanghai
conventional	conventional
campaigns	campaigns
formations	formations
feelings	feelings
bath	bath
venice	venice
#aaa	#aaa
cats	cats
variations	variations
emerged	emerged
socks	socks
connecting	connecting
flood	flood
documented	documented
custom	custom
touchdown	touchdown
profession	profession
layout	layout
academics	academics
settlers	settlers
merging	merging
sony	sony
competitors	competitors
phillips	phillips
grass	grass
reservoir	reservoir
artificial	artificial
novelist	novelist
tip	tip
prague	prague
abu	abu
faces	faces
guitars	guitars
aspx	aspx
laura	laura
fellows	fellows
internationally	internationally
attacking	attacking
johann	johann
dreams	dreams
hughes	hughes
suburb	suburb
understood	understood
specialized	specialized
warned	warned
pearl	pearl
chorus	chorus
dependent	dependent
restrictions	restrictions
killer	killer
oakland	oakland
romanized	romanized
trio	trio
influences	influences
blocking	blocking
mtv	mtv
wikipedians	wikipedians
cattle	cattle
gear	gear
gabriel	gabriel
skating	skating
fifteen	fifteen
palm	palm
wikis	wikis
tale	tale
demonstrate	demonstrate
vary	vary
liquid	liquid
cycling	cycling
princeton	princeton
respective	respective
voices	voices
friedrich	friedrich
jet	jet
horn	horn
erected	erected
burning	burning
worker	worker
atmosphere	atmosphere
characterized	characterized
syrian	syrian
welfare	welfare
java	java
monitor	monitor
graduating	graduating
columns	columns
repair	repair
bin	bin
stick	stick
dollars	dollars
organised	organised
parameter	parameter
truly	truly
resolve	resolve
parade	parade
backed	backed
awareness	awareness
depends	depends
define	define
spencer	spencer
republicans	republicans
conspiracy	conspiracy
dies	dies
clarke	clarke
rough	rough
pine	pine
equation	equation
feels	feels
democrat	democrat
permitted	permitted
cutting	cutting
button	button
attending	attending
brands	brands
queens	queens
abraham	abraham
neck	neck
forever	forever
est	est
drink	drink
sheriff	sheriff
miguel	miguel
aires	aires
irrelevant	irrelevant
poorly	poorly
montgomery	montgomery
vanity	vanity
gift	gift
riders	riders
functional	functional
crossed	crossed
diverse	diverse
numbered	numbered
quotes	quotes
slowly	slowly
attitude	attitude
mouse	mouse
justin	justin
protests	protests
gods	gods
amounts	amounts
variation	variation
smart	smart
prices	prices
prayer	prayer
terrorism	terrorism
beta	beta
durham	durham
counts	counts
iraqi	iraqi
detective	detective
josh	josh
placing	placing
somebody	somebody
linking	linking
compositions	compositions
oval	oval
extensively	extensively
filming	filming
perfectly	perfectly
indianapolis	indianapolis
funeral	funeral
recovered	recovered
southeastern	southeastern
farmer	farmer
protestant	protestant
cameron	cameron
focuses	focuses
indonesian	indonesian
mixing	mixing
mumbai	mumbai
nashville	nashville
danger	danger
rally	rally
narrative	narrative
camps	camps
surprise	surprise
manufactured	manufactured
deployed	deployed
kate	kate
molecular	molecular
unnecessary	unnecessary
isle	isle
theorem	theorem
homepage	homepage
colonies	colonies
cyprus	cyprus
wake	wake
brings	brings
winds	winds
magnetic	magnetic
conversation	conversation
sussex	sussex
gates	gates
ram	ram
plastic	plastic
electronics	electronics
restore	restore
stockholm	stockholm
inn	inn
buses	buses
connect	connect
wmflabs	wmflabs
forth	forth
guests	guests
radiation	radiation
receives	receives
lancashire	lancashire
playoff	playoff
cork	cork
generals	generals
intermediate	intermediate
verifiable	verifiable
cheers	cheers
filipino	filipino
reaches	reaches
oriented	oriented
hamburg	hamburg
creates	creates
orbit	orbit
massacre	massacre
dialogue	dialogue
illness	illness
dress	dress
codes	codes
dawn	dawn
isolated	isolated
nancy	nancy
violations	violations
perth	perth
tenure	tenure
ladies	ladies
autumn	autumn
ratings	ratings
incorrect	incorrect
scout	scout
difficulty	difficulty
pupils	pupils
wealth	wealth
hart	hart
toured	toured
allegations	allegations
regulation	regulation
watching	watching
lodge	lodge
eggs	eggs
disputed	disputed
citizenship	citizenship
specialist	specialist
tasks	tasks
intent	intent
instruction	instruction
ceased	ceased
pride	pride
banner	banner
friendship	friendship
panama	panama
corruption	corruption
sunk	sunk
harm	harm
ernest	ernest
pilots	pilots
pursue	pursue
tape	tape
emigrants	emigrants
cancelled	cancelled
revenge	revenge
revision	revision
dominant	dominant
fee	fee
computing	computing
examination	examination
chen	chen
matrix	matrix
das	das
biographical	biographical
kiss	kiss
valign	valign
nationalist	nationalist
luck	luck
crosses	crosses
bid	bid
appreciate	appreciate
enemies	enemies
mercury	mercury
interactive	interactive
math	math
debuts	debuts
preserve	preserve
nobel	nobel
grande	grande
keeps	keeps
structural	structural
marry	marry
airports	airports
veterans	veterans
airline	airline
axis	axis
execution	execution
cult	cult
reducing	reducing
colin	colin
chester	chester
ticket	ticket
belonging	belonging
entity	entity
judicial	judicial
explicitly	explicitly
bombing	bombing
recognised	recognised
originated	originated
applicable	applicable
founders	founders
wilhelm	wilhelm
suddenly	suddenly
parking	parking
absolute	absolute
françois	françois
locomotive	locomotive
preparation	preparation
nintendo	nintendo
declaration	declaration
presumably	presumably
burial	burial
governing	governing
jamaica	jamaica
knowing	knowing
vladimir	vladimir
beating	beating
avg	avg
methodist	methodist
utf	utf
challenges	challenges
kenneth	kenneth
evolved	evolved
celebration	celebration
discipline	discipline
bearing	bearing
belonged	belonged
fauna	fauna
manuscript	manuscript
experiments	experiments
chiefs	chiefs
compound	compound
tampa	tampa
arabia	arabia
associations	associations
equally	equally
shut	shut
targets	targets
alien	alien
depicted	depicted
sergeant	sergeant
subsidiary	subsidiary
thirteen	thirteen
thick	thick
extend	extend
dismissed	dismissed
neo	neo
wire	wire
phd	phd
measured	measured
fat	fat
visits	visits
linux	linux
teach	teach
flights	flights
verse	verse
bennett	bennett
warm	warm
dynamic	dynamic
shaw	shaw
breaks	breaks
grandson	grandson
monuments	monuments
lying	lying
lords	lords
michel	michel
treat	treat
raid	raid
congregation	congregation
temperatures	temperatures
testament	testament
drinking	drinking
companion	companion
manila	manila
km²	km²
punjab	punjab
imagine	imagine
consideration	consideration
veteran	veteran
doctors	doctors
carries	carries
ruler	ruler
wise	wise
shipping	shipping
afc	afc
worthy	worthy
registration	registration
directory	directory
wyoming	wyoming
manitoba	manitoba
vietnamese	vietnamese
ronald	ronald
cuban	cuban
burns	burns
justify	justify
divine	divine
suppose	suppose
sequel	sequel
fate	fate
rovers	rovers
cole	cole
oral	oral
trans	trans
boards	boards
span	span
bryan	bryan
santiago	santiago
episcopal	episcopal
terrorist	terrorist
okay	okay
waves	waves
invented	invented
landed	landed
sandy	sandy
acres	acres
paint	paint
actively	actively
indication	indication
stops	stops
excellence	excellence
integration	integration
thinks	thinks
bibliography	bibliography
farming	farming
nonsense	nonsense
marathon	marathon
beliefs	beliefs
redundant	redundant
freestyle	freestyle
aerial	aerial
preservation	preservation
altitude	altitude
freely	freely
simultaneously	simultaneously
psychological	psychological
fernando	fernando
cultures	cultures
taxes	taxes
marcus	marcus
stakes	stakes
dominican	dominican
franz	franz
coins	coins
oxygen	oxygen
civic	civic
hardly	hardly
isaac	isaac
spell	spell
craft	craft
inspiration	inspiration
pairs	pairs
vector	vector
arc	arc
professionals	professionals
vii	vii
contrary	contrary
accusations	accusations
approaches	approaches
baronet	baronet
slaves	slaves
mad	mad
spectrum	spectrum
client	client
dozen	dozen
travels	travels
symbols	symbols
plaza	plaza
banking	banking
inherited	inherited
legion	legion
symptoms	symptoms
