que	qui
que	que
del	du
los	les
por	par
con	avec
las	les
una	une
categoría	catégorie
para	pour
como	comme
fue	fut
más	plus
sus	ses
sus	vos
también	également
también	aussi
entre	entre
the	the
pero	mais
años	années
dos	deux
son	sont
sobre	sur
año	année
desde	depuis
esta	cette
enlaces	liens
externos	externes
ciudad	ville
ser	être
parte	partie
durante	pendant
sin	sans
donde	où
san	san
era	ère
era	était
nacional	national
primera	première
team	team
cuando	lorsque
cuando	quand
seed	seed
nombre	nom
estados	états
utc	utc
siglo	siècle
después	après
españa	espagne
otros	autres
unidos	unis
puede	peut
estado	état
lugar	lieu
primer	premier
así	ainsi
población	population
muy	très
nueva	nouvelle
fueron	furent
fueron	étaient
historia	histoire
club	club
eran	étaient
universidad	université
forma	forme
tres	trois
grupo	groupe
general	général
guerra	guerre
familia	famille
todo	tout
sur	sud
mayor	major
mayor	aîné
según	selon
tiempo	temps
provincia	province
partido	parti
contra	contre
municipio	municipalité
todos	tous
juan	jean
josé	joseph
bajo	bas
serie	série
cada	chaque
fútbol	football
equipo	equipement
norte	nord
río	fleuve
méxico	mexique
han	han
han	ont
argentina	argentine
inglés	anglais
nuevo	nouveau
septiembre	septembre
octubre	octobre
discusión	discussion
gobierno	gouvernement
condado	comté
final	finale
final	final
vida	vie
personas	personnes
español	espagnol
centro	centre
julio	juillet
lincoln	lincoln
país	pays
web	web
internacional	international
internacional	internationale
santa	santa
antes	avant
oficial	officier
mundo	monde
embargo	embargo
tanto	tant
mayo	mai
algunos	certains
temporada	saison
hacia	vers
mejor	mieux
mejor	meilleur
luego	ensuite
luego	puis
día	jour
madrid	madrid
enero	janvier
número	nombre
agosto	août
diciembre	décembre
artículo	article
noviembre	novembre
estos	ces
abril	avril
total	total
región	région
sistema	système
maría	marie
real	real
real	réal
página	page
esto	ceci
esto	cela
mundial	mondial
música	musique
presidente	président
casa	maison
sólo	seulement
álbum	album
cuenta	compte
junio	juin
febrero	février
ella	elle
pueden	peuvent
varios	divers
varios	plusieurs
francia	france
solo	seul
solo	seulement
chile	chili
tipo	type
iglesia	église
película	film
entonces	alors
banda	bande
cuatro	quatre
zona	zone
televisión	télévision
principal	principal
carlos	carlos
rey	roi
edición	édition
tenía	avait
futbolistas	footballeurs
bien	bien
segundo	deuxième
mar	mer
poco	peu
orden	ordre
agua	eau
tierra	terre
título	titre
ellos	ils
ellos	eux
earth	earth
división	division
canción	chanson
fecha	date
república	république
trabajo	travail
especie	espèce
luis	luis
caso	cas
obras	œuvres
obras	oeuvres
color	couleur
distrito	district
superficie	surface
copa	coupe
asteroid	asteroid
near	near
línea	ligne
francisco	françois
siguiente	suivant
grandes	grands
censo	recensement
liga	ligue
estas	ces
align	align
muerte	mort
medio	moyen
política	politique
menos	moins
largo	long
buenos	bons
hijo	fils
hecho	fait
algunas	certaines
carrera	carrière
poder	pouvoir
departamento	département
localidades	localités
reino	royaume
central	central
todas	toutes
york	york
ejemplo	exemple
género	genre
padre	père
isbn	isbn
campo	champ
isla	île
hacer	faire
ante	ante
conocido	connu
http	http
países	pays
frente	front
antonio	antoine
época	époque
director	directeur
días	jours
partir	partir
versión	version
research	research
actual	actuel
momento	moment
lista	liste
jpg	jpg
densidad	densité
campeonato	championnat
tienen	ont
ejército	armée
estación	gare
observatorio	observatoire
actualmente	actuellement
desarrollo	développement
escuela	école
programa	programme
información	informations
importante	important
último	dernier
canciones	chansons
uso	utilisation
juegos	jeux
localidad	localité
base	base
punto	point
posición	position
alemania	allemagne
partidos	matchs
grupos	groupes
john	john
miembros	membres
capital	capitale
primeros	premiers
teatro	théâtre
datos	données
laboratorio	laboratoire
libro	livre
estudios	studios
estudios	études
diferentes	différents
barcelona	barcelone
nivel	niveau
llamado	appelé
mayoría	majorité
unión	union
edad	âge
toda	toute
artículos	articles
juego	jeu
arte	art
especies	espèces
europa	europe
estilo	style
cine	cinéma
proyecto	projet
center	center
sea	soyez
sea	sea
selección	sélection
costa	côte
puesto	poste
origen	origine
código	code
museo	musée
puntos	points
perú	pérou
militar	militaire
américa	amérique
producción	production
italia	italie
tener	avoir
wikipedia	wikipédia
plantas	plantes
debe	doit
siempre	toujours
metros	mètres
oro	or
casi	presque
construcción	construction
local	local
francés	français
cultura	culture
santiago	santiago
cerca	proche
estudio	studio
principales	principaux
usuario	utilisateur
com	com
finalmente	enfin
finalmente	finalement
cinco	cinq
anterior	précédent
batalla	bataille
derecho	droit
peak	peak
imagen	image
gracias	merci
kitt	kitt
puerto	port
torneo	tournoi
mucho	beaucoup
social	social
millones	millions
comunidad	communauté
fin	fin
acuerdo	accord
lado	côté
colombia	colombie
servicio	service
rock	rock
películas	films
ver	voir
fuera	dehors
pesar	peser
popular	populaire
tal	tal
tal	tel
alto	alto
alto	haut
cuerpo	corps
disco	disque
sociedad	société
tema	thème
dirección	adresse
hombres	hommes
última	dernière
original	original
new	new
estadio	stade
miguel	michel
ley	loi
oeste	ouest
mujeres	femmes
obs	obs
incluso	même
cambio	changement
jugador	joueur
instituto	institut
público	public
miembro	membre
superior	supérieure
superior	supérieur
media	medias
california	californie
parque	parc
tan	tan
tan	tellement
archivo	fichier
archivo	archives
radio	radio
ahora	maintenant
parís	paris
sería	serait
world	world
cruz	croix
cabo	cap
brasil	brésil
red	réseau
aquí	ici
canal	canal
movimiento	mouvement
revista	revue
revista	magazine
éxito	succès
relación	relation
elecciones	elections
plaza	plaza
plaza	place
grande	grand
distribución	distribution
compañía	compagnie
islas	îles
proceso	processus
alrededor	autour
territorio	territoire
encuentran	trouvent
dice	dit
hombre	homme
león	lion
voz	voix
década	décennie
madre	mère
iii	iii
organización	organisation
monte	mont
decir	dire
goles	buts
victoria	victoire
victoria	victoria
sede	siège
importantes	importants
resultado	résultat
china	chine
xix	xix
calle	rue
papel	papier
van	van
medios	médias
aparece	apparaît
empresa	entreprise
fernando	fernando
don	don
mapa	carte
civil	civil
venezuela	venezuela
educación	éducation
término	terme
llamada	appel
ciudades	villes
alta	haute
alta	alta
igual	pareil
igual	égal
usa	usa
londres	londres
tercera	troisième
edificio	bâtiment
fuerzas	forces
posible	possible
antiguo	ancien
natural	naturel
álbumes	albums
mujer	femme
fuerza	force
altura	hauteur
etc	etc
garcía	garcia
for	for
servicios	services
villa	villa
conocida	connue
campeón	champion
autor	auteur
personajes	personnages
conjunto	ensemble
eso	ça
alemán	allemand
único	unique
actor	acteur
parece	semble
antigua	antigua
antigua	ancienne
especial	spécial
interior	intérieur
plata	argent
lemmon	lemmon
japón	japon
control	contrôle
consejo	conseil
menor	mineure
menor	mineur
seis	six
libre	libre
llegar	arriver
valle	vallée
festival	festival
personaje	personnage
principalmente	principalement
david	david
castillo	château
publicado	posté
cantante	chanteur
referencia	référence
inglaterra	angleterre
resto	reste
común	commun
deporte	sport
espacio	espace
asociación	partenariat
asociación	association
acción	action
actores	acteurs
hermano	frère
fundación	fondation
blanco	blanc
profesional	professionnel
episodio	épisode
episodio	episode
cultural	culturel
principios	principes
imperio	empire
nunca	jamais
prefijo	préfixe
municipios	municipalités
from	from
problemas	problèmes
modelo	modèle
svg	svg
actividad	activité
joven	jeune
formación	formation
lugares	lieux
incluyendo	incluant
planta	plante
período	période
montañas	montagnes
ronda	ronda
clase	classe
especialmente	particulièrement
oficina	bureau
alcalde	maire
longitud	longueur
temas	thèmes
políticos	politiciens
deportivo	sportif
arquitectura	architecture
creación	création
barrio	quartier
argentino	argentin
libros	livres
novela	roman
jorge	georges
razas	races
academia	académie
jefe	chef
defensa	défense
características	caractéristiques
honor	honneur
incluye	inclus
incluye	comprend
incluye	inclut
existen	existent
amor	amour
fuente	fontaine
nuevos	nouveaux
martín	martín
situación	situation
nombrado	nommé
existe	existe
ellas	elles
derechos	droits
ministro	ministre
series	séries
texto	texte
escritores	écrivains
actriz	actrice
capacidad	capacité
artes	arts
cantidad	quantité
fuentes	fontaines
fuentes	polices
vista	vista
luz	lumière
baja	basse
border	border
paz	paix
noche	nuit
muestra	échantillon
rusia	russie
personal	personnel
robert	robert
aeropuerto	aéroport
apoyo	soutien
semana	semaine
palacio	palais
pacífico	pacifique
escritor	écrivain
castilla	castille
profesor	professeur
roma	rome
diseño	design
casos	cas
negro	noir
camino	chemin
ayuda	aide
nombres	noms
podría	pourrait
causa	cause
horario	horaire
ciencias	sciences
últimos	derniers
tamaño	taille
principio	principe
nacimiento	naissance
nada	rien
etapa	étape
pequeño	petit
zonas	zones
referencias	références
ediciones	éditions
dios	dieu
debut	debut
debut	débuts
presente	présent
guitarra	guitare
australia	australie
qué	quoi
pablo	paul
elementos	éléments
elementos	eléments
relaciones	relations
compuesto	composé
horas	heures
partes	parties
text	text
militares	militaires
torre	tour
dado	donné
actividades	activités
cantón	canton
federal	fédéral
federal	fédérale
participación	participation
fuerte	fort
italiano	italien
primeras	premières
posee	possède
jugadores	joueurs
seguridad	sécurité
administración	administration
empresas	entreprises
mercado	marché
gonzález	gonzález
lucha	lutte
estructura	structure
jesús	jésus
ocupación	occupation
nacido	né
enrique	henri
literatura	littérature
armas	armes
energía	énergie
idioma	langue
valencia	valence
cabeza	tête
gobernador	gouverneur
córdoba	cordoue
mes	mois
situado	situé
diferencia	différence
objetivo	objectif
objetivo	cible
ruta	itinéraire
economía	économie
histórico	historique
india	inde
flores	fleurs
visita	visite
conde	comte
fase	phase
william	william
resultados	résultats
niños	enfants
tales	tales
https	https
pequeña	petite
presenta	présente
campaña	campagne
dar	donner
dar	dar
fernández	fernández
colegio	collège
occidental	occidental
aproximadamente	approximativement
aproximadamente	environ
tropas	troupes
sección	section
presencia	présence
permite	permet
sentido	sens
uruguay	uruguay
ficha	fiche
ficha	onglet
tenían	avaient
top	top
siete	sept
ets	mst
animales	animaux
ríos	rivières
catalina	catherine
you	you
may	may
bar	bar
medalla	médaille
función	fonction
usuarios	utilisateurs
programas	programmes
calidad	qualité
artistas	artistes
similar	similaire
nuestra	notre
independencia	indépendance
buena	bonne
sistemas	systèmes
significa	signifie
virgen	vierge
transporte	transport
pueblos	peuples
coordenadas	coordonnées
valor	valeur
unidad	unité
crear	créer
imágenes	images
inicio	accueil
salud	santé
contiene	contient
sierra	sierra
será	sera
idea	idée
minutos	minutes
diego	diego
verano	été
sol	soleil
teoría	théorie
revolución	révolution
entrada	entrée
mejores	meilleurs
mejores	meilleures
mando	commandement
james	james
ciencia	science
dirigida	adressée
dirigida	dirigée
records	records
sector	secteur
importancia	importance
ataque	attaque
flora	flore
comunicación	communication
puente	pont
humanos	humains
mitad	moitié
realidad	réalité
cámara	caméra
escudo	bouclier
pérez	pérez
aguas	eaux
acceso	accès
clasificación	classement
clasificación	classification
mano	main
sigue	continue
problema	problème
trabajos	travaux
elegido	élu
elegido	choisi
elegido	elu
independiente	indépendant
futbolista	footballeur
comercial	commercial
metal	métal
diario	quotidien
palabra	mot
carácter	caractère
falta	manque
reina	reine
domingo	dimanche
libertad	liberté
vía	voie
xviii	xviii
unidades	unités
capitán	capitaine
bgcolor	bgcolor
sevilla	séville
video	vidéo
considerado	considéré
comisión	commission
lima	lima
alberto	alberto
comienza	commence
velocidad	vitesse
felipe	philippe
objetos	objets
ministerio	ministère
creado	créé
xvi	xvi
oriental	oriental
hermanos	frères
edificios	bâtiments
tierras	terres
michael	michael
británico	britannique
áfrica	afrique
izquierda	gauche
cambios	changements
canadá	canada
alfonso	alphonse
alfonso	alfonso
lanzado	lancé
bandera	drapeau
verde	vert
templo	temple
raza	race
avenida	avenue
regional	régionale
regional	régional
biblioteca	bibliothèque
rojo	rouge
títulos	titres
blancos	blancs
diez	dix
ángel	ange
ecuador	équateur
señor	seigneur
señor	monsieur
productos	produits
portugal	portugal
salvador	sauveur
manos	mains
carretera	route
escrito	ecrit
escrito	écrit
industria	industrie
entrenador	entraîneur
palabras	mots
padres	parents
padres	pères
policía	police
líder	leader
fondo	fond
productor	producteur
gira	tournée
gira	tourne
técnica	technique
ninguna	aucune
príncipe	prince
press	press
encontrar	trouver
artista	artiste
formas	formes
von	von
rafael	raphaël
jun	jun
catedral	cathédrale
generalmente	habituellement
generalmente	généralement
ayuntamiento	mairie
saludos	salutations
temporadas	saisons
colección	collection
cadena	chaîne
music	music
reyes	rois
combate	combat
azul	bleu
líneas	lignes
pasado	passé
páginas	pages
medida	mesure
influencia	influence
lago	lac
conoce	rencontrez
condiciones	conditions
oficiales	officiers
left	left
hospital	hôpital
ocho	huit
fuego	feu
piedra	pierre
federación	fédération
constitución	constitution
tratado	traité
razón	raison
mil	mille
pop	pop
distancia	distance
estudiantes	etudiants
jul	jul
internet	internet
episodios	épisodes
propiedad	propriété
marca	marque
tipos	types
baloncesto	basket
ene	ene
contenido	contenu
anteriores	précédents
sala	salle
estrella	étoile
rosa	rose
jóvenes	jeunes
realizado	réalisé
formato	format
prueba	test
peso	poids
cómo	comment
washington	washington
mal	mal
jersey	jersey
locales	locaux
der	der
marco	marco
sep	sep
llega	arrive
daniel	daniel
eduardo	édouard
oct	oct
duque	duc
amigo	ami
evitar	éviter
emperador	empereur
santos	santos
obispo	évêque
mediados	mi
toma	prise
toma	prend
campos	champs
nov	nov
mexicano	mexicain
kilómetros	kilomètres
justicia	justice
ago	ago
bastante	assez
love	love
señora	madame
deben	doivent
dic	déc
ana	anne
naturales	naturelles
alejandro	alexandre
publicación	publication
figura	figure
soldados	soldats
blanca	blanche
aves	oiseaux
peter	peter
pie	pied
hora	heure
amigos	amis
particular	particulier
maestro	maître
cuba	cuba
asia	asie
casas	maisons
motor	moteur
efecto	effet
completo	complet
crecimiento	croissance
doctor	docteur
pequeños	petits
autores	auteurs
junta	junte
europeo	européen
grado	degré
facultad	faculté
cataluña	catalogne
extremo	extrême
tradicional	traditionnel
derecha	droite
niño	enfant
banco	banque
contrato	contrat
pintura	peinture
ruso	russe
cuenca	bassin
batería	batterie
diputados	députés
pasa	passe
máximo	maximum
deportes	sports
representa	représente
recursos	ressources
misión	mission
compositor	compositeur
futuro	futur
ángeles	anges
utilizado	utilisé
vicente	vincent
tecnología	technologie
with	with
trabajar	travailler
ramón	ramón
fiesta	fête
smith	smith
jardín	jardin
madera	bois
inferior	inférieur
inferior	inférieure
clubes	clubs
solid	solid
incluyen	incluent
frontera	frontière
hab	hab
atención	attention
digital	numérique
torres	torres
doble	double
comandante	commandant
corazón	coeur
secretario	secrétaire
letras	paroles
lenguas	langues
vivo	vivant
xvii	xvii
encuentro	rencontre
obtener	obtenir
originalmente	initialement
naturaleza	nature
existencia	existence
man	man
guatemala	guatemala
aragón	aragon
rico	riche
sonido	son
usar	utiliser
mensajes	messages
mesa	table
granada	grenade
antiguos	anciens
pasar	passer
objeto	objet
generales	généraux
formado	formé
apertura	ouverture
geografía	géographie
análisis	analyse
protección	protection
géneros	genres
familias	familles
notas	notes
american	american
proyectos	projets
white	white
funciones	fonctions
corona	couronne
apareció	apparu
clima	climat
guillermo	guillaume
prensa	presse
haya	hêtre
escena	scène
provincial	provinciale
versiones	versions
www	www
isabel	isabelle
puerta	porte
mario	mario
romano	romain
griego	grec
thomas	thomas
all	all
tuvieron	eurent
habla	parle
cierto	vrai
crisis	crise
efectos	effets
memoria	mémoire
orquesta	orchestre
siglos	siècles
montaña	montagne
#aaa	#aaa
austria	autriche
llegada	arrivée
construido	construit
martin	martin
berlín	berlin
llama	appelle
llama	flamme
directamente	directement
lanzamiento	lancement
comité	comité
javier	javier
capilla	chapelle
probablemente	probablement
larga	longue
colspan	colspan
bolivia	bolivie
poeta	poète
tradición	tradition
podía	pouvait
provincias	provinces
autónoma	autonome
hojas	feuilles
ricardo	richard
tomar	prendre
necesario	nécessaire
filosofía	philosophie
periodista	journaliste
texas	texas
jugar	jouer
operación	opération
papa	pape
latinos	latins
firma	signature
nacionalidad	nationalité
patrimonio	patrimoine
regiones	régions
poesía	poésie
hermana	soeur
decide	décide
alianza	alliance
respuesta	réponse
google	google
metro	métro
marina	marine
eventos	evénements
exterior	extérieur
músicos	musiciens
visto	vu
suiza	suisse
coronel	colonel
parroquia	paroisse
física	physique
dan	dan
anteriormente	précédemment
grecia	grèce
zaragoza	saragosse
exposición	exposition
industrial	industriel
fundada	fondée
enfermedad	maladie
nba	nba
colonia	cologne
pequeñas	petites
nación	nation
show	show
extensión	extension
aparición	apparition
aparición	émergence
operaciones	opérations
concepto	concept
calles	rues
hechos	faits
ambiente	ambiance
pronto	bientôt
gestión	gestion
salida	sortie
capítulo	chapitre
acciones	actions
pertenece	appartient
cristo	christ
medicina	médecine
evolución	evolution
evolución	évolution
modelos	modèles
venta	vente
tomó	prit
fundador	fondateur
piano	piano
procedencia	provenance
roberto	roberto
ganar	gagner
pintor	peintre
evento	événement
campeonatos	championnats
rosario	rosaire
menores	mineurs
pertenecían	appartenaient
hispanos	hispaniques
conocimiento	connaissance
conocer	connaître
términos	termes
debajo	dessous
generación	génération
bronce	bronze
tabla	table
pareja	couple
producto	produit
territorios	territoires
gol	but
institución	institution
ingeniero	ingénieur
luna	lune
reconocimiento	reconnaissance
península	péninsule
organizaciones	organisations
bahía	baie
asamblea	assemblée
cerro	cerro
enlace	lien
till	till
traducción	traduction
contaba	comptait
tracking	tracking
fundado	fondé
paraguay	paraguay
ganador	vainqueur
ganador	gagnant
estrellas	étoiles
sangre	sang
resistencia	résistance
neat	neat
conflicto	conflit
software	logiciel
volumen	volume
vuelve	reviens
xxi	xxi
humano	humain
dirigido	dirigé
consecuencia	conséquence
colaboración	collaboration
aparecen	apparaissent
colores	couleurs
per	per
materiales	matériaux
carta	charte
centros	centres
categorías	catégories
curso	cours
fiestas	fêtes
simplemente	simplement
japonés	japonais
franco	franc
temperatura	température
propuesta	proposition
eds	eds
decreto	décret
decisión	décision
cara	visage
carolina	caroline
lee	lee
botánica	botanique
editor	éditeur
polonia	pologne
experiencia	expérience
abierto	ouvert
participantes	participants
instituciones	institutions
monasterio	monastère
castro	castro
sean	sean
amerindios	amérindiens
suecia	suède
inicialmente	initialement
nota	note
concurso	concours
seguir	suivre
marqués	marquis
altitud	altitude
dólares	dollars
planeta	planète
monumento	monument
israel	israël
marcha	marche
representación	représentation
turismo	tourisme
publicaciones	publications
ingeniería	ingénierie
frecuencia	fréquence
semanas	semaines
basado	basé
saber	savoir
olímpico	olympique
piezas	pièces
participar	participer
poner	mettre
corea	corée
borrado	effacement
carmen	carmen
creada	créée
religión	religion
técnicas	techniques
estaciones	stations
escuelas	écoles
completamente	complètement
relacionados	connexes
vuelo	vol
xiii	xiii
parlamento	parlement
titular	titulaire
deja	laisse
florida	floride
descrito	décrit
rápidamente	rapidement
nave	vaisseau
posibilidad	possibilité
destaca	souligne
html	html
anderson	anderson
directo	direct
sucesor	successeur
presidencia	présidence
totalmente	complètement
totalmente	entièrement
totalmente	totalement
oficialmente	officiellement
volver	retour
autoridades	autorités
pista	piste
iglesias	églises
composición	composition
método	méthode
concierto	concert
cuarta	quatrième
agricultura	agriculture
par	paire
capaz	capable
viejo	vieux
tratamiento	traitement
palomar	palomar
especiales	spéciaux
nueve	neuf
bosque	forêt
ganado	bétail
carga	charge
quiere	veut
necesidad	besoin
diócesis	diocèse
dejar	laisser
registro	registre
registro	enregistrement
duración	durée
complejo	complexe
acto	acte
life	life
indica	indique
indica	indica
bandas	bandes
nicolás	nicolas
gnis	gnis
arquitecto	architecte
convierte	convertit
solar	solaire
playa	plage
rango	rang
cantantes	chanteurs
arriba	haut
latina	latine
latina	latina
femenino	féminin
instalaciones	installations
vive	vivez
cosa	chose
derrota	défaite
vii	vii
king	king
sola	seule
césar	césar
urbano	urbain
destacan	soulignent
forman	forman
oriente	orient
campeones	champions
leyes	lois
estructuras	structures
entrevista	entretien
niveles	niveaux
arco	arc
ficción	fiction
right	right
socialista	socialiste
difícil	difficile
one	one
novelas	romans
conocidos	connus
super	super
discos	disques
simple	simple
listas	listes
sebastián	sébastien
diputado	député
ideas	idées
ojos	yeux
continuó	continua
músico	musicien
números	nombres
destino	destination
vasco	basque
contacto	contact
reforma	réforme
carreras	carrières
single	single
expedición	expédition
invierno	hiver
nadie	personne
diferente	différent
park	park
barrios	quartiers
navarra	navarre
relevancia	pertinence
ancho	largeur
boca	bouche
panamá	panama
universal	universal
universal	universel
completa	complète
dando	donnant
variedad	variété
dominio	domaine
trabajadores	travailleurs
valores	valeurs
movimientos	mouvements
océano	océan
promedio	moyenne
árabe	arabe
aplicación	application
famoso	célèbre
interpretación	interprétation
competición	compétition
terreno	terrain
respectivamente	respectivement
similares	similaires
similares	semblables
construir	construire
toledo	tolède
noticias	nouvelles
miss	miss
normalmente	habituellement
normalmente	normalement
trayectoria	trajectoire
piloto	pilote
abogado	avocat
chicago	chicago
figuras	figures
clásico	classique
ópera	opéra
candidato	candidat
debería	devrait
desarrollado	développé
designado	désigné
activo	actif
irlanda	irlande
detrás	derrière
xii	xii
descripción	description
málaga	malaga
presión	pression
henry	henry
conciertos	concerts
vecinos	voisins
lorenzo	laurent
federico	frédéric
competencia	compétence
competencia	concurrence
sky	sky
punta	pointe
fórmula	formule
núcleo	noyau
illinois	illinois
galería	galerie
humana	humaine
cambiar	changer
nelson	nelson
asturias	asturies
verdad	vérité
joaquín	joaquín
juventud	jeunesse
golpe	coup
avión	avion
masa	masse
bosques	forêts
bienes	biens
egipto	égypte
textos	textes
presentación	présentation
escribir	ecrire
escribir	écrire
reserva	réservation
live	live
árboles	arbres
denominación	dénomination
hábitat	habitat
lenguaje	langage
asistencia	assistance
judíos	juifs
expresión	expression
inicial	initiale
ejecutivo	exécutif
portugués	portugais
bélgica	belgique
órdenes	ordres
ignacio	ignacio
torneos	tournois
corto	court
populares	populaires
usando	utilisant
hotel	hôtel
clara	clara
normal	normale
normal	normal
búsqueda	recherche
sello	sceau
revistas	magazines
teniente	lieutenant
álvarez	alvarez
mark	mark
mendoza	mendoza
residencia	résidence
jazz	jazz
indígenas	indigènes
indígenas	autochtones
massachusetts	massachusetts
jack	jack
café	café
hierro	fer
nuestro	notre
latín	latin
oposición	opposition
árbol	arbre
global	global
escala	échelle
bueno	bon
muertos	morts
valladolid	valladolid
bogotá	bogota
reales	réels
comunidades	communautés
marcos	cadres
marcos	marcos
vivir	vivre
die	die
united	united
gabriel	gabriel
debía	devait
votación	vote
biografía	biographie
vino	vin
alonso	alonso
caída	chute
visión	vision
arena	sable
límite	limite
entrar	entrer
noruega	norvège
canales	canaux
data	data
regular	régulier
promoción	promotion
salir	sortir
autoridad	autorité
bellas	belles
caracas	caracas
demasiado	trop
accidente	accident
manga	manga
medidas	mesures
dejando	laissant
críticas	critiques
bajas	basses
aviones	avions
conquista	conquête
células	cellules
alemanes	allemands
laguna	lagune
montevideo	montevideo
protagonista	protagoniste
pérdida	perte
alma	âme
caballero	chevalier
retiro	retraite
retiro	retrait
enciclopedia	encyclopédie
jaime	jaime
dinastía	dynastie
aspectos	aspects
salón	salon
ataques	attaques
tony	tony
breve	bref
breve	brève
zip	zip
universo	univers
imperial	impérial
sitios	sites
bot	bot
são	são
emisión	émission
múltiples	multiples
homenaje	hommage
guardia	garde
miles	miles
rural	rural
pantalla	écran
convento	couvent
grabado	gravure
considerada	considérée
corriente	courant
quinto	quintus
legislatura	législature
puertas	portes
ruiz	ruiz
disponible	disponible
mantiene	maintient
tribunal	tribunal
profesores	professeurs
profesores	enseignants
posiciones	positions
últimas	dernières
honduras	honduras
conferencia	conférence
tom	tom
dvd	dvd
comentarios	commentaires
royal	royal
convertirse	devenir
científico	scientifique
plano	plan
oportunidad	opportunité
documentos	documents
viene	vient
anual	annuelle
anual	annuel
elemento	élément
time	time
actos	actes
west	west
species	species
agustín	augustin
vega	vega
brown	brown
flota	flotte
clave	clé
css	css
atlántico	atlantique
alexander	alexander
condición	condition
jones	jones
construida	construite
moscú	moscou
hernández	hernandez
hernández	hernández
profesionales	professionnels
aumento	augmentation
encontrado	trouvé
mejorar	améliorer
comunes	communs
víctor	victor
youtube	youtube
públicos	audiences
caja	boîte
guerras	guerres
rowspan	rowspan
territorial	territoriale
var	var
responsable	responsable
cortes	coupures
cortes	cortes
guadalajara	guadalajara
dedicado	dédié
org	org
instrumentos	instruments
ciclo	cycle
incluido	inclus
señal	signal
logra	accomplit
williams	williams
murcia	murcia
vehículos	véhicules
und	und
hungría	hongrie
civiles	civils
liberal	libéral
catalán	catalan
intención	intention
tropical	tropicale
ejemplos	exemples
secundaria	secondaire
masculino	masculin
altos	hauts
xiv	xiv
realmente	vraiment
doce	douze
americano	américain
burgos	burgos
recientemente	récemment
instrumento	instrument
salamanca	salamanque
ayudar	aider
portada	couverture
identidad	identité
pasajeros	passagers
suficiente	suffisant
suficiente	assez
mezcla	mélange
buscar	rechercher
infantería	infanterie
culto	culte
historias	histoires
duda	doute
big	big
actuales	actuels
pies	pieds
ida	ida
presentan	présentent
utilizan	utilisent
metropolitana	métropolitaine
url	url
comunista	communiste
leyenda	légende
comedia	comédie
barco	bateau
mañana	demain
tomás	tomás
fotografía	photographie
etiqueta	étiquette
ohio	ohio
cable	câble
mensaje	message
hugo	hugues
altas	hautes
décadas	décennies
poderes	pouvoirs
permanente	permanente
permanente	permanent
anime	anime
antiguas	anciennes
química	chimie
plataforma	plateforme
razones	raisons
poblaciones	populations
potencia	puissance
espíritu	esprit
pro	pro
artístico	artistique
house	house
tren	train
juvenil	juvénile
misiones	missions
misiones	quêtes
princesa	princesse
college	college
entrega	livraison
valign	valign
invasión	invasion
límites	limites
enseñanza	enseignement
asteroides	astéroïdes
reconocido	reconnu
reunión	réunion
ocupa	occupe
estándar	standard
representantes	représentants
frank	frank
programación	programmation
entidad	entité
animal	animal
recibido	reçu
escultura	sculpture
saga	saga
destacar	souligner
motivos	motifs
espacios	espaces
introducción	introduction
fuertes	fortes
bases	bases
bretaña	bretagne
chino	chinois
viii	viii
entorno	environnement
récord	record
fauna	faune
raíz	racine
profundidad	profondeur
crea	créez
científicos	scientifiques
universidades	universités
termina	termine
ciudadanos	citoyens
símbolo	symbole
copias	copies
virginia	virginie
primaria	primaire
distritos	districts
rápido	rapide
rápido	vite
list	list
moderno	moderne
zelanda	zélande
moreno	moreno
utilizando	utilisant
paulo	paulo
pobreza	pauvreté
fachada	façade
error	erreur
ministros	ministres
ventas	ventes
conservación	conservation
scott	scott
contexto	contexte
propiedades	propriétés
historiador	historien
enfermedades	maladies
prácticamente	pratiquement
cola	queue
constante	constante
asesinato	meurtre
cádiz	cadix
natal	natal
recibir	recevoir
juntos	ensemble
individuales	individuels
fábrica	usine
machos	mâles
title	title
hacienda	hacienda
chan	chan
chilena	chilienne
restauración	restauration
roca	roche
prisión	prison
dedicada	dédiée
pintores	peintres
filipinas	philippines
intervención	intervention
juicio	procès
juicio	jugement
escenas	scènes
europeos	européens
documental	documentaire
ascendencia	ascendance
expansión	expansion
convertido	converti
entrenadores	entraîneurs
tradicionales	traditionnels
pan	pain
quinta	cinquième
trono	trône
inmediatamente	immédiatement
familiar	familier
riesgo	risque
desambiguación	homonymie
hablar	parler
windows	windows
ermita	ermitage
caza	chasse
reacción	réaction
humanidad	humanité
guerrero	guerrier
tramo	tranche
uefa	uefa
representante	représentant
rugby	rugby
chris	chris
dakota	dakota
galicia	galice
max	max
pensilvania	pennsylvanie
caribe	caraïbes
perfil	profil
escocia	écosse
png	png
definición	définition
simon	simon
amarillo	jaune
piel	peau
sergio	serge
primavera	printemps
mariano	mariano
gas	gaz
that	that
solución	solution
diferencias	différences
dominicana	dominicaine
dimensiones	dimensions
objetivos	objectifs
fusión	fusion
atrás	arrière
coro	chœur
eje	axe
mary	mary
regimiento	régiment
formando	formant
nacidos	nés
php	php
canto	chant
licencia	licence
idiomas	langues
directa	directe
viena	vienne
bolívar	bolivar
bolívar	bolívar
posiblemente	possiblement
continente	continent
corrientes	courants
poemas	poèmes
presentado	présenté
facebook	facebook
palma	palma
palma	paume
enemigo	ennemi
cielo	ciel
dinamarca	danemark
excepto	sauf
minnesota	minnesota
producir	produire
pico	pico
conserva	conserve
arma	arme
cementerio	cimetière
resolución	résolution
peña	peña
violencia	violence
describe	décrit
terminología	terminologie
adaptación	adaptation
bob	bob
individual	individuel
once	onze
descubiertos	découverts
esperanza	espoir
consumo	consommation
medieval	médiéval
teresa	thérèse
agente	agent
alumnos	élèves
cuentos	contes
impacto	impact
alfredo	alfredo
trabajando	travaillant
emilio	emilio
kansas	kansas
blue	blue
secreto	secret
colombiano	colombien
peligro	danger
arroyo	arroyo
rama	branche
argentinos	argentins
característica	caractéristique
raúl	raúl
morales	morales
estudiar	étudier
comentario	commentaire
ramírez	ramirez
circuito	circuit
sexual	sexuelle
jackson	jackson
enemigos	ennemis
fácil	facile
silva	silva
compositores	compositeurs
diámetro	diamètre
victorias	victoires
puestos	postes
podían	pouvaient
guía	guide
podrían	pourraient
arturo	arthur
superiores	supérieurs
frase	phrase
renta	revenu
negocios	affaires
ben	ben
gustavo	gustavo
monumentos	monuments
funcionamiento	fonctionnement
víctimas	victimes
terminar	terminer
guitarrista	guitariste
turquía	turquie
walter	walter
young	young
cristianos	chrétiens
gutiérrez	gutiérrez
cantabria	cantabrie
descubierto	découvert
cáncer	cancer
métodos	méthodes
delantero	attaquant
indiana	indiana
puebla	puebla
trabaja	travaille
min	min
caballeros	messieurs
caballeros	chevaliers
minas	minas
comportamiento	comportement
originales	originaux
nuclear	nucléaire
billboard	billboard
escritos	écrits
santander	santander
viento	vent
group	group
normas	normes
sectores	secteurs
cónyuge	conjoint
espectadores	spectateurs
salas	salles
peruano	péruvien
liberación	libération
quería	voulait
atenas	athènes
momentos	moments
fifa	fifa
aplicaciones	applications
air	air
georgia	géorgie
hielo	glace
caballo	cheval
steve	steve
significado	signification
cinturón	ceinture
cordillera	cordillère
crítico	critique
sirvió	servit
interpretado	interprété
mis	mes
motores	moteurs
posibles	possibles
ganadores	gagnants
pilotos	pilotes
mike	mike
foto	photo
wilson	wilson
joe	joe
sueño	sommeil
sueño	rêve
guinea	guinée
informe	rapport
treinta	trente
tráfico	trafic
órgano	orgue
medallas	médailles
archivos	fichiers
fechas	dates
directores	directeurs
físico	physicien
democracia	démocratie
mediterráneo	méditerranée
opción	option
perdido	perdu
notable	remarquable
legal	légal
enorme	énorme
enorme	enorme
constitucional	constitutionnel
plazo	délai
católicos	catholiques
escritura	écriture
estadísticas	statistiques
documento	document
iowa	iowa
oscar	oscar
transmisión	transmission
carne	viande
poetas	poètes
ucrania	ukraine
desarrollar	développer
enviado	envoyé
muestran	montrent
street	street
vehículo	véhicule
círculo	cercle
harry	harry
alimentos	aliments
participa	participez
casado	marié
agencia	agence
popularidad	popularité
votar	voter
pinturas	peintures
terminal	terminal
iniciativa	initiative
ffffff	ffffff
redes	filets
redes	réseaux
london	london
localización	localisation
fortaleza	forteresse
deriva	dérive
electrónica	electronique
electrónica	électronique
your	your
herrera	herrera
buques	navires
diccionario	dictionnaire
profesión	profession
consulta	consultez
historiadores	historiens
mitología	mythologie
debate	débat
perder	perdre
componentes	composants
belleza	beauté
descubre	découvrez
jiménez	jiménez
ácido	acide
infancia	enfance
líderes	leaders
predecesor	prédécesseur
oscuro	sombre
segundos	secondes
cañón	canon
net	net
zamora	zamora
relativamente	relativement
columna	colonne
high	high
danza	danse
veinte	vingt
periodistas	journalistes
asunción	assomption
factores	facteurs
barcos	bateaux
salvo	sauf
chica	fille
pensamiento	pensée
leer	lire
declaración	déclaration
mala	mauvaise
mala	mala
asesinado	assassiné
asesinado	tué
argumento	argument
online	online
portal	portail
médicos	médecins
sacerdote	prêtre
night	night
buenas	bonnes
nicaragua	nicaragua
regionales	régionales
regionales	régionaux
rodrigo	rodrigo
arzobispo	archevêque
mancha	tache
conocidas	connues
retirado	retraité
retirado	retiré
inteligencia	intelligence
disney	disney
relevante	pertinent
fox	fox
serían	seraient
paseo	promenade
menciona	mentionne
green	green
obtiene	obtient
brian	brian
romero	romarin
espera	attends
espera	attendez
compañías	compagnies
diseñado	conçu
reciente	récent
reciente	récente
intereses	intérêts
senado	sénat
mercedes	mercedes
christian	christian
johnson	johnson
edward	edward
coros	chorales
post	post
valenciana	valencienne
den	den
orígenes	origines
aliados	alliés
rally	rallye
detalles	détails
salto	saut
bilbao	bilbao
rivera	rivera
roger	roger
colonial	colonial
competiciones	compétitions
dictadura	dictature
tenga	ayez
medina	medina
difusión	diffusion
company	company
ejecución	exécution
ensayo	essai
lucas	lucas
independientes	indépendants
joan	joan
boston	boston
reglas	règles
viernes	vendredi
suerte	chance
golfo	golfe
nobles	nobles
augusto	auguste
radical	radical
tratar	traiter
yucatán	yucatan
establecido	établi
bruselas	bruxelles
mandato	mandat
trenes	trains
feria	foire
comida	nourriture
seguro	assurance
seguro	sûr
fotos	photos
amistad	amitié
entra	entrez
hill	hill
extranjeros	étrangers
artillería	artillerie
concentración	concentration
contar	compter
máquina	machine
lagos	lacs
montes	monts
hot	hot
manual	manuel
coche	voiture
brasileño	brésilien
miranda	miranda
ceremonia	cérémonie
columbia	columbia
lejos	loin
conflictos	conflits
fallecidos	décédés
alicante	alicante
pregunta	question
drama	drame
juez	juge
requiere	exige
requiere	nécessite
this	this
afirma	affirme
ala	aile
ala	ala
continental	continental
taylor	taylor
sexo	sexe
presentes	présents
miami	miami
celebración	célébration
day	day
mínimo	minimum
macdonald	macdonald
milán	milan
tomo	tome
descenso	descente
viajes	voyage
bloqueo	blocage
empleados	employés
batallas	batailles
agrupación	groupement
fenómeno	phénomène
continuar	continuer
paredes	murs
jurado	jury
can	can
muñoz	muñoz
permiten	permettent
empleo	emploi
usos	utilisations
confederación	confédération
upper	upper
suárez	suárez
cabezas	têtes
terremoto	séisme
casco	casque
factor	facteur
hollywood	hollywood
suma	somme
oxford	oxford
deseo	désir
ejemplares	exemplaires
gonzalo	gonzalo
ausencia	absence
lanza	lance
wheeler	wheeler
coalición	coalition
naves	vaisseaux
realización	réalisation
interna	interne
personalidad	personnalité
félix	félix
bill	bill
flor	fleur
alas	ailes
jardines	jardins
muro	mur
grados	degrés
santuario	sanctuaire
destrucción	destruction
empresario	entrepreneur
entrenamiento	entraînement
propietario	propriétaire
nacida	née
llegan	arrivent
claramente	clairement
molina	molina
cañones	canons
pasos	étapes
descubrimiento	découverte
retirada	retrait
ciclista	cycliste
catálogo	catalogue
revisión	révision
tarea	tâche
extranjero	étranger
anna	anna
divisiones	divisions
vieja	vieille
abandonar	quitter
abandonar	abandonner
espectáculo	spectacle
organismos	organismes
indios	indiens
irán	iran
grave	grave
héctor	hector
habana	havane
punk	punk
caracteriza	caractérise
organismo	organisme
encuentros	rencontres
ford	ford
columnas	colonnes
clásicos	classiques
incluida	incluse
comunicaciones	communications
elena	hélène
productores	producteurs
racing	racing
secciones	sections
guzmán	guzmán
tesis	thèse
conexión	connexion
secretaría	secrétariat
bautista	baptiste
embajada	ambassade
invitado	invité
colón	colomb
best	best
tenis	tennis
individuos	individus
finalizar	terminer
exposiciones	expositions
museos	musées
little	little
explica	explique
cambridge	cambridge
lectura	lecture
álvaro	álvaro
extiende	étend
wiley	wiley
colorado	colorado
transición	transition
muere	meurt
muere	meurs
recientes	récents
recientes	récentes
cristina	cristina
rutas	routes
rival	rival
norma	norma
posesión	possession
encontraban	trouvaient
estudiante	étudiant
taller	atelier
alcance	portée
laura	laure
pdf	pdf
privado	privé
esfuerzo	effort
piedras	pierres
capa	couche
lateral	latéral
editores	éditeurs
daños	dommages
daños	dégâts
ernesto	ernesto
exclusivamente	exclusivement
magnitud	magnitude
cueva	grotte
alternativa	alternative
discurso	discours
activa	active
entidades	entités
tareas	tâches
moneda	devise
relacionado	connexe
aldea	village
soporte	support
occidente	occident
gloria	gloire
incluir	inclure
prado	prado
católico	catholique
incluía	incluait
editado	édité
times	times
caballería	cavalerie
representan	représentent
rebelión	rébellion
definitivamente	définitivement
asistente	assistant
fallecido	décédé
canadiense	canadien
alex	alex
ritmo	rythme
andes	andes
guionista	scénariste
mallorca	majorque
vocal	voyelle
entertainment	entertainment
tío	tonton
tío	oncle
senador	sénateur
viven	vivent
costas	côtes
organizado	organisé
adultos	adultes
dispone	dispose
carreteras	routes
declarado	déclaré
gobiernos	gouvernements
special	special
quito	quito
cardenal	cardinal
perro	chien
establecimiento	etablissement
dura	dure
capítulos	chapitres
precisamente	précisément
archipiélago	archipel
gregorio	grégoire
tocar	toucher
ramas	branches
publica	publiez
publica	publie
morir	mourir
insecto	insecte
cartagena	cartagena
autonomía	autonomie
cocina	cuisine
asociado	associé
pesca	pêche
sucesión	succession
primo	cousin
proteger	protéger
presidencial	présidentielle
pacientes	patients
finlandia	finlande
laterales	latéraux
estrecho	détroit
estrecho	étroit
ampliamente	largement
papeles	papiers
determinar	déterminer
fabricación	fabrication
poema	poème
lados	côtés
saludo	salutation
indonesia	indonésie
prentice	prentice
marino	marin
ramos	ramos
ray	ray
batallón	bataillon
gastronomía	gastronomie
académico	académique
virus	virus
umbral	seuil
potencial	potentiel
extra	extra
pilar	pilar
utilizados	utilisés
moral	morale
moral	moral
cierre	fermeture
vargas	vargas
carl	carl
paisaje	paysage
noble	noble
aviación	aviation
rendimiento	performances
rendimiento	rendement
escultor	sculpteur
usada	utilisée
antigüedad	ancienneté
antigüedad	antiquité
penal	pénal
davis	davis
sam	sam
recuperar	récupérer
resumen	résumé
medellín	medellin
serbia	serbie
shift	maj
arcos	arcs
integrado	intégrée
integrado	intégré
existentes	existantes
existentes	existants
errores	erreurs
raíces	racines
responsabilidad	responsabilité
cuentan	comptent
amenaza	menace
ojo	œil
cero	zéro
separación	séparation
convención	convention
habilidades	compétences
bbc	bbc
pago	paiement
tendencia	tendance
animación	animation
instalación	installation
marcas	marques
vietnam	vietnam
índice	index
gana	gagne
hectáreas	hectares
terror	terreur
próximo	prochain
saddle	saddle
explotación	exploitation
pena	peine
realizadas	réalisées
comparación	comparaison
producen	produisent
define	définit
tiro	tir
navarro	navarro
solitario	solitaire
wisconsin	wisconsin
cursos	cours
dioses	dieux
disposición	disposition
dolor	douleur
num	num
fácilmente	facilement
boys	boys
magdalena	madeleine
cadenas	chaînes
serán	seront
petición	pétition
wiki	wiki
criterios	critères
out	out
hermanas	sœurs
interpretada	interprétée
disponibles	disponibles
estadística	statistique
herramientas	outils
blackwell	blackwell
gil	gil
escapar	échapper
espada	épée
will	will
sexto	sixième
matar	tuer
ninguno	aucun
vertical	vertical
vertical	verticale
oficinas	bureaux
kong	kong
contemporánea	contemporaine
disciplina	discipline
cech	cech
aparecer	apparaître
who	who
gigante	géant
cristiano	chrétien
moyle	moyle
revolucionario	révolutionnaire
obispos	évêques
derrotado	vaincu
participaciones	participations
ichthyology	ichthyology
candidatura	candidature
ortiz	ortiz
cuadros	tableaux
vegetación	végétation
voluntad	volonté
habiendo	ayant
necesidades	besoins
eliminar	supprimer
vandalismo	vandalisme
científicamente	scientifiquement
karl	karl
ven	viens
mención	mention
esfuerzos	efforts
dolores	dolores
doña	doña
actuar	agir
producciones	productions
andrea	andrea
gris	gris
oviedo	oviedo
lewis	lewis
margarita	marguerite
regresa	reviens
brigada	brigade
graves	graves
championship	championship
béisbol	baseball
redacción	rédaction
junior	junior
tomando	prenant
depende	dépend
combinación	combinaison
aventuras	aventures
combustible	carburant
eric	eric
inaugurado	inauguré
embajador	ambassadeur
compra	achat
obligado	obligé
desierto	désert
compuestos	composés
lisboa	lisbonne
juana	jeanne
agentes	agents
creador	créateur
power	power
venecia	venise
ensayos	essais
barroco	baroque
rev	rev
alba	alba
considerar	considérer
ingenieros	ingénieurs
insectos	insectes
pistas	pistes
trinidad	trinité
mamíferos	mammifères
cinta	ruban
retrato	portrait
calor	chaleur
stone	stone
are	are
colonias	colonies
goya	goya
mejora	amélioration
flandes	flandre
republicano	républicain
lord	lord
twitter	twitter
acompañado	accompagné
talleres	ateliers
jim	jim
peor	pire
bottom	bottom
anillo	anneau
blues	blues
parejas	couples
basílica	basilique
nieto	nieto
verdadera	vraie
hans	hans
estrategia	stratégie
causas	causes
virtual	virtuel
integración	intégration
temporal	temporaire
clausura	clôture
obteniendo	obtenant
tenerife	tenerife
útil	utile
lunes	lundi
grammy	grammy
minuto	minute
estilos	styles
probable	probable
estatua	statue
supremo	suprême
equivalente	équivalent
campus	campus
volúmenes	volumes
tomado	pris
estancia	séjour
jan	jan
anexos	annexes
matemáticas	mathématiques
descendientes	descendants
caballos	chevaux
boy	boy
back	back
retablo	retable
lara	lara
hidalgo	hidalgo
marruecos	maroc
amiga	amie
hola	bonjour
hola	salut
gales	galles
defensor	défenseur
tokio	tokyo
sir	sir
euros	euros
ciclismo	cyclisme
alpes	alpes
semillas	graines
pierde	perd
pasión	passion
home	home
variante	variante
acero	acier
héroe	héros
collette	collette
malden	malden
aumentar	augmenter
patria	patrie
prisioneros	prisonniers
actitud	attitude
bibliotecario	bibliothécaire
pre	pre
pre	pré
mecánica	mécanique
moda	mode
recuperación	récupération
otoño	automne
lanzada	lancée
rebotes	rebonds
tienda	magasin
temperaturas	températures
campañas	campagnes
obtenido	obtenu
nintendo	nintendo
vera	vera
reducir	réduire
long	long
cuento	conte
imposible	impossible
mencionado	mentionné
prácticas	pratiques
draft	draft
audio	audio
hong	hong
crónica	chronique
toro	taureau
solista	soliste
reducción	réduction
tribu	tribu
ligeramente	légèrement
fotografías	photographies
nuestros	nos
congo	congo
presidentes	présidents
kim	kim
jurisdicción	juridiction
candidatos	candidats
dibujos	dessins
investigadores	chercheurs
mérida	mérida
bibliografía	bibliographie
ejercicio	exercice
rioja	rioja
apariencia	apparence
oferta	offre
variedades	variétés
ventaja	avantage
revela	dévoile
revela	révèle
peruana	péruvienne
remix	remix
literario	littéraire
libertadores	libertadores
humor	humour
influencias	influences
bomba	pompe
verlag	verlag
delante	devant
mostrar	afficher
adolfo	adolfo
cien	cent
arquitectos	architectes
ganadora	gagnante
arkansas	arkansas
cooperación	coopération
editar	modifier
editar	éditer
alan	alan
das	das
orientación	orientation
preparación	préparation
integrada	intégrée
mérito	mérite
consenso	consensus
jerusalén	jérusalem
himno	hymne
chrysomelidae	chrysomelidae
bella	bella
visual	visuel
múnich	munich
bloque	bloc
presupuesto	budget
desconocido	inconnu
ligas	ligues
almirante	amiral
eléctrico	électrique
calendario	calendrier
siria	syrie
play	play
pensar	penser
tono	tonalité
tono	sonnerie
adn	adn
representado	représenté
confianza	confiance
colecciones	collections
exilio	exil
funciona	fonctionne
dejado	laissé
not	not
excelente	excellente
excelente	excellent
determinado	déterminé
veracruz	veracruz
ido	allé
publicidad	publicité
inauguración	vernissage
inauguración	inauguration
polaco	polonais
hipótesis	hypothèses
hipótesis	hypothèse
atacar	attaquer
parques	parcs
centrales	centrales
progreso	progrès
nosotros	nous
ávila	avila
selva	jungle
ibérica	ibérique
debían	devaient
florencia	florence
elegir	choisir
tripulación	équipage
defender	défendre
marcelo	marcelo
secuencia	séquence
millas	milles
millas	miles
situaciones	situations
permitir	autoriser
permitir	permettre
genérico	générique
samuel	samuel
porcentaje	pourcentage
mata	tue
uniforme	uniforme
satélite	satellite
aventura	aventure
compone	compose
sal	sel
body	body
ruinas	ruines
parecido	ressemblance
aceite	huile
playstation	playstation
giovanni	giovanni
jaén	jaén
eliminado	supprimé
eliminado	éliminé
microsoft	microsoft
ariel	ariel
regla	règle
douglas	douglas
tumba	tombe
tumba	tombeau
empleado	employé
belgrano	belgrano
bulgaria	bulgarie
sun	sun
alias	alias
kevin	kevin
venezolano	vénézuélien
ideal	idéal
alrededores	environs
mecanismo	mécanisme
wrestling	wrestling
atp	atp
trama	trame
renacimiento	renaissance
dama	dame
diputación	diputación
dificultades	difficultés
argumentos	arguments
mauricio	maurice
inversión	investissement
asociaciones	partenariats
andré	andré
flujo	flux
eva	ève
italianos	italiens
conceptos	concepts
east	east
placa	plaque
mtv	mtv
duró	dura
rosas	roses
logrado	réussi
psicología	psychologie
indígena	indigène
criterio	critère
fiscal	procureur
hoja	feuille
aprendizaje	apprentissage
grabar	graver
blog	blog
onda	onde
capaces	capables
interesante	intéressant
abc	abc
reformas	réformes
fenner	fenner
gray	gray
variantes	variantes
luisa	louise
representar	représenter
publicados	publiés
old	old
creando	créant
respeto	respect
correo	courrier
eliminación	suppression
símbolos	symboles
cerámica	céramique
guadalupe	guadeloupe
variable	variable
tecnologías	technologies
abre	ouvre
caracteres	caractères
llevaba	portait
petróleo	pétrole
intercambio	échange
psoe	psoe
absoluta	absolue
palmarés	palmarès
vendido	vendu
unirse	rejoindre
duro	dur
arizona	arizona
cristianismo	christianisme
huevos	oeufs
dibujo	dessin
frío	froid
tradicionalmente	traditionnellement
decisiones	décisions
esculturas	sculptures
emplea	emploie
tango	tango
patio	patio
conocimientos	connaissances
angel	angel
administrativo	administratif
añadir	ajouter
dúo	duo
brillante	brillant
reconocida	reconnue
existía	existait
leche	lait
nápoles	naples
pagar	payer
soldado	soldat
teorías	théories
jose	jose
puertos	ports
cincuenta	cinquante
salta	saute
ribera	rive
almería	almeria
croacia	croatie
tormenta	tempête
transformación	transformation
ejércitos	armées
francis	francis
genera	génère
cáceres	cáceres
rebeldes	rebelles
visitantes	visiteurs
colo	colo
cabrera	cabrera
ropa	vêtements
propuesto	proposé
máquinas	machines
síndrome	syndrome
soledad	solitude
localizado	localisé
tiendas	magasins
cuello	cou
nick	nick
propuestas	propositions
procesión	procession
compromiso	engagement
consecuencias	conséquences
mateo	matthieu
abuelo	papy
núñez	núñez
novia	mariée
contienen	contiennent
tucumán	tucumán
filas	rangs
anexo	annexe
heridos	blessés
activos	actifs
viva	vive
quince	quinze
minerales	minéraux
miedo	peur
colombiana	colombienne
vapor	vapeur
parecen	semblent
nazi	nazi
comenzar	commencer
servir	servir
death	death
stephen	stephen
alimentación	alimentation
navidad	noël
aprobación	approbation
intelectual	intellectuelle
intelectual	intellectuel
navegación	navigation
pertenecen	appartiennent
desaparición	disparition
resolver	résoudre
andrew	andrew
cuentas	comptes
desaparecidos	disparus
lluvia	pluie
interno	interne
tradiciones	traditions
académicos	académiques
industriales	industriels
creciente	croissant
marcador	marqueur
marcador	signet
celebrado	célébré
crucero	croisière
apariciones	apparitions
ocupar	occuper
videos	vidéos
directora	directrice
coste	coût
polo	pôle
sporting	sporting
nebraska	nebraska
proteínas	protéines
eurovisión	eurovision
fundadores	fondateurs
maya	maya
bruce	bruce
coruña	corogne
depresión	dépression
firmado	signé
clientes	clients
barra	barre
destruir	détruire
limitada	limitée
tus	tes
sesión	session
sesión	séance
protagonistas	protagonistes
tribus	tribus
cientos	centaines
siglas	acronymes
siglas	sigles
teclados	claviers
union	union
daba	donnait
invitados	invités
carbono	carbone
johnny	johnny
sony	sony
wild	wild
plazas	places
leonardo	leonardo
prefectura	préfecture
específicamente	spécifiquement
occidentales	occidentaux
existente	existante
existente	existant
techo	plafond
implica	implique
doctorado	doctorat
jimmy	jimmy
incendio	incendie
intentos	tentatives
hitler	hitler
marta	marta
culturas	cultures
costumbres	coutumes
riqueza	richesse
largas	longues
altar	autel
triple	triple
infraestructura	infrastructure
dispositivo	périphérique
josep	josep
what	what
song	song
solicitud	demande
silla	chaise
informática	informatique
fronteras	frontières
bartolomé	barthélemy
construcciones	constructions
maíz	maïs
emmy	emmy
johann	johann
gato	chat
azúcar	sucre
sueco	suédois
albacete	albacete
millón	million
lesión	lésion
sonidos	sons
salvar	sauver
atlanta	atlanta
nobel	nobel
friedrich	friedrich
composiciones	compositions
individuo	individu
dividido	divisé
alcalá	alcalá
men	men
medallistas	médaillés
trece	treize
crimen	crime
first	first
esclavos	esclaves
comics	comics
aguilar	aguilar
vuelos	vols
abrir	ouvrir
conocen	connaissent
largos	longs
valparaíso	valparaiso
inmediato	immédiat
aparentemente	apparemment
trujillo	trujillo
band	band
procedimiento	procédure
comienzan	commencent
automóviles	automobiles
periodismo	journalisme
sábado	samedi
network	network
elizabeth	elizabeth
perspectiva	perspective
cuevas	grottes
suprema	suprême
decoración	décoration
paraná	paraná
gama	gamme
inc	inc
foro	forum
copia	copie
retorno	retour
sands	sands
lógica	logique
soto	soto
segura	sûre
cuarenta	quarante
costo	coût
extinción	extinction
típico	typique
conferencias	conférences
ajedrez	échecs
habitación	chambre
señales	signaux
trabajado	travaillé
tensión	tension
conciencia	conscience
seminario	séminaire
juárez	juarez
técnicos	techniciens
palmas	palmas
vidas	vies
órganos	organes
jefes	chefs
entradas	entrées
monterrey	monterrey
miller	miller
contemporáneo	contemporain
seco	sèche
seco	sec
howard	howard
lisa	lisa
huracán	ouragan
cumbre	sommet
mexicanos	mexicains
residentes	résidents
patrick	patrick
conservador	conservateur
rueda	roue
valles	vallées
raión	raïon
completar	compléter
pacto	pacte
llamar	appeler
contribuciones	contributions
opiniones	opinions
segovia	segovia
brazos	bras
british	british
moore	moore
consejero	conseiller
cámaras	caméras
website	website
interpretar	interpréter
isidro	isidro
off	off
empezaron	commencèrent
documentación	documentation
autopista	autoroute
circunstancias	circonstances
parcial	partiel
parcial	partielle
clan	clan
séptimo	septième
juniors	juniors
billy	billy
impuestos	impôts
reloj	horloge
delta	delta
singles	singles
extremadura	estrémadure
intensidad	intensité
toronto	toronto
definir	définir
liberales	libéraux
gabinete	cabinet
villas	villas
equilibrio	équilibre
esquina	coin
allen	allen
inmigrantes	immigrants
órbita	orbite
aceptado	accepté
designados	désignés
gótico	gothique
airlines	airlines
conservan	gardent
conservan	conservent
vázquez	vázquez
della	della
soviético	soviétique
anthony	anthony
pos	pos
goleador	buteur
atletismo	athlétisme
heavy	heavy
silencio	silence
trofeo	trophée
was	was
dicen	disent
ocupado	occupé
pobres	pauvres
reconstrucción	reconstruction
tratados	traités
particulares	particuliers
presa	barrage
oportunidades	opportunités
nevada	nevada
calderón	calderón
monarquía	monarchie
percusión	percussion
circular	circulaire
lobo	loup
biología	biologie
móvil	mobile
dividida	divisée
víctima	victime
teología	théologie
nobleza	noblesse
escultores	sculpteurs
gimnasia	gymnastique
refugio	refuge
automóvil	automobile
renuncia	renonciation
renuncia	démission
open	open
jugado	joué
filósofo	philosophe
rasgos	traits
cantar	chanter
end	end
decía	disait
pino	pin
pamplona	pampelune
sofía	sofia
lucía	lucie
antioquia	antioquia
ortega	ortega
absoluto	absolu
herramienta	outil
águila	aigle
camiseta	maillot
registrado	enregistré
cabello	cheveux
reinos	royaumes
mix	mix
permiso	permission
diversidad	diversité
andy	andy
testamento	testament
alfred	alfred
cortos	courts
julia	julia
fracaso	échec
vélez	vélez
óblast	oblast
drogas	drogues
fans	fans
cantidades	quantités
persecución	persécution
centenario	centenaire
mac	mac
consideraba	considérait
cuerdas	cordes
selecciones	sélections
anti	anti
artificial	artificiel
bay	bay
villanueva	villanueva
muestras	échantillons
like	like
pertenecía	appartenait
obrero	ouvrier
issn	issn
demócrata	démocrate
traducido	traduit
cerebro	cerveau
sombra	ombre
mercados	marchés
toneladas	tonnes
indican	indiquent
senadores	sénateurs
cambiado	changé
ganadería	élevage
deuda	dette
dark	dark
chilenos	chiliens
bell	bell
ciclistas	cyclistes
fuertemente	fortement
proporciona	fournit
vientos	vents
experimental	expérimental
bancos	banques
seleccionado	sélectionné
indio	indien
dudas	doutes
partículas	particules
cali	cali
parcialmente	partiellement
bravo	bravo
específico	spécifique
country	country
pastor	berger
pastor	pasteur
iván	ivan
traje	costume
monarca	monarque
escuadra	escouade
circulación	circulation
formal	formel
gobernación	gouvernorat
cerrado	fermé
detalle	détail
tim	tim
desaparecido	disparu
simpson	simpson
pekín	pékin
yugoslavia	yougoslavie
meta	meta
vegas	vegas
ampliación	élargissement
ibn	ibn
localiza	localise
doctrina	doctrine
dead	dead
cobre	cuivre
separado	séparé
créditos	crédits
coral	corail
creados	créés
posibilidades	possibilités
paciente	patient
arias	arias
great	great
memorias	mémoires
tailandia	thaïlande
pobre	pauvre
calcio	calcium
pasan	passent
velasco	velasco
precios	prix
talento	talent
frecuentes	fréquent
captura	capture
cervantes	cervantes
próxima	prochaine
antena	antenne
parada	arrêt
dientes	dents
reemplazado	remplacé
marvel	marvel
epíteto	épithète
heart	heart
temática	thématique
marcado	marquage
puentes	ponts
volcán	volcan
mora	mora
rodolfo	rodolfo
reproducción	reproduction
estima	estime
canaria	canaria
platino	platine
field	field
gala	gala
charlie	charlie
hockey	hockey
fósiles	fossiles
presentaciones	présentations
tablas	tables
representaciones	représentations
ofensiva	offensive
rector	recteur
roy	roy
coches	voitures
unesco	unesco
designación	désignation
incidente	incident
alicia	alicia
alicia	alice
abogados	avocats
funcionarios	fonctionnaires
esperar	attendre
atlas	atlas
russell	russell
rumania	roumanie
exactamente	exactement
mira	regarde
leo	léo
leo	leo
opciones	options
alcaldes	maires
cortés	courtois
oliver	oliver
nova	nova
localizada	localisée
legislación	législation
soria	soria
warner	warner
last	last
bernard	bernard
rené	rené
matt	matt
instrucción	instruction
modalidad	modalité
accidentes	accidents
poseía	possédait
emitido	émis
venezolana	vénézuélienne
delegación	délégation
sugiere	suggère
palencia	palencia
apoyar	soutenir
casada	mariée
misa	messe
reconoce	reconnaît
marrón	marron
value	value
magia	magie
núcleos	noyaux
simples	simples
houston	houston
hard	hard
campamento	camp
siguieron	suivirent
participan	participent
dorado	doré
celular	cellulaire
ryan	ryan
armando	armando
diarios	quotidiens
directiva	directive
armenia	arménie
mina	mina
gráfico	graphique
amateur	amateur
consultado	consulté
gracia	grâce
franklin	franklin
viuda	veuve
salazar	salazar
pirineos	pyrénées
acta	acta
rescate	sauvetage
aceptar	accepter
actúa	agissez
actúa	agit
relieve	relief
considerable	considérable
integral	intégrale
organizar	organiser
reducido	réduit
athletic	athletic
paula	paula
sobrino	neveu
come	mange
guayaquil	guayaquil
perros	chiens
cliente	client
profundo	profond
ruedas	roues
fontsize	fontsize
inmigración	immigration
aguirre	aguirre
channel	channel
down	down
gallego	galicien
asociados	associés
mariscal	maréchal
naranja	orange
autobuses	autobus
embalse	réservoir
americanos	américains
ducado	duché
aficionados	amateurs
representada	représentée
condados	comtés
marc	marc
gordon	gordon
multitud	foule
heredero	héritier
generar	générer
cubre	couvre
orilla	rivage
finalista	finaliste
cátedra	chaire
licenciado	licencié
espiritual	spirituel
basados	basés
violín	violon
carnaval	carnaval
playas	plages
síntesis	synthèse
way	way
aceptadas	acceptées
aceptadas	acceptés
clark	clark
sacerdotes	prêtres
shorts	shorts
basadas	basées
evaluación	évaluation
inaugurada	inaugurée
modos	modes
inscripción	inscription
homónimo	homonyme
descubrir	découvrir
enfoque	approche
mejoras	améliorations
publicar	publier
judío	juif
abadía	abbaye
vándalo	vandale
crédito	crédit
irak	irak
roque	roque
queen	queen
visitante	visiteur
deberían	devraient
institucional	institutionnel
operador	opérateur
negociaciones	négociations
serrano	serrano
inclinación	inclinaison
federales	fédéraux
amante	amant
wayne	wayne
holanda	hollande
arroz	riz
dificultad	difficulté
jugaba	jouait
sicilia	sicile
dave	dave
sustituido	remplacé
hilo	fil
belga	belge
terminado	fini
terminado	terminé
propone	propose
cabildo	cabildo
dragón	dragon
organizada	organisée
armamento	armement
profunda	profonde
napoleón	napoléon
recepción	réception
parroquias	paroisses
igualdad	égalité
conductor	conducteur
orleans	orléans
krasnodar	krasnodar
sabor	saveur
síntomas	symptômes
detenido	détenu
legión	légion
golden	golden
nominado	nominé
festivales	festivals
elegidos	élus
vale	ok
pabellón	pavillon
christopher	christopher
springer	springer
túnel	tunnel
jason	jason
missouri	missouri
baviera	bavière
soberanía	souveraineté
expertos	experts
necesarios	nécessaires
alaska	alaska
asesino	tueur
prima	cousine
bolsa	bourse
elegida	élue
elegida	choisie
paralelo	parallèle
demostrar	démontrer
demostrado	démontré
fragmentos	fragments
acuerdos	accords
ballet	ballet
wikimedia	wikimedia
viajar	voyager
toros	taureaux
escenarios	scénarios
crece	pousse
diálogo	dialogue
observa	observe
diplomático	diplomate
malasia	malaisie
adams	adams
socio	partenaire
condesa	comtesse
mencionar	mentionner
ross	ross
cumple	remplit
identificación	identification
good	good
electricidad	électricité
sesiones	séances
tránsito	transit
robin	robin
filial	filiale
atmósfera	atmosphère
madonna	madonna
explicar	expliquer
hacían	faisaient
colectivo	collectif
vacío	vide
requisitos	exigences
movie	movie
pontificia	pontificale
diana	diana
family	family
únicos	uniques
nieve	neige
pares	paires
comunistas	communistes
colina	colline
cuerda	corde
reporta	signalez
espectáculos	spectacles
aplica	applique
promocional	promotionnel
chicas	filles
vizcaya	gascogne
jane	jane
sentimientos	sentiments
aparato	appareil
eschmeyer	eschmeyer
variables	variables
project	project
poderoso	puissant
nacionalista	nationaliste
combates	combats
alcanzando	atteignant
jeff	jeff
haga	faites
barón	baron
salinas	salinas
venganza	vengeance
sajonia	saxe
socks	socks
official	official
clínica	clinique
harvard	harvard
observación	observation
bajista	bassiste
explosión	explosion
bruno	bruno
armado	armé
acusado	accusé
renovación	rénovation
renovación	renouvellement
diosa	déesse
acepta	accepte
metropolitano	métropolitain
ventana	fenêtre
rusos	russes
reservas	réservations
variaciones	variations
ventanas	fenêtres
sat	sat
beneficio	bénéfice
descarga	téléchargement
visitar	visiter
herencia	héritage
gijón	gijón
juntas	ensemble
aeronaves	aéronefs
madagascar	madagascar
extremos	extrêmes
plato	assiette
eugenio	eugenio
claude	claude
dir	dir
añade	ajoute
gravedad	gravité
planos	plans
líquido	liquide
pozo	puits
plataformas	plateformes
jonathan	jonathan
pecho	poitrine
constelación	constellation
explicación	explication
conclusión	conclusion
prestigio	prestige
campesinos	paysans
kelly	kelly
aumenta	augmente
biblia	bible
antología	anthologie
inspiración	inspiration
impresión	impression
fría	froide
teléfono	téléphone
ideología	idéologie
costumbre	coutume
patricia	patricia
huelva	huelva
ball	ball
logros	réalisations
comprar	acheter
enterrado	enterré
herido	blessé
formados	formés
cubierto	couvert
mental	mentale
mental	mental
franz	franz
polémica	polémique
crónicas	chroniques
principado	principauté
relativa	relative
suelos	sols
database	database
destacando	soulignant
parecía	semblait
oaxaca	oaxaca
unida	unie
consiguiendo	obtenant
recurso	ressource
rubio	blond
méndez	mendez
vivían	vivaient
vela	voile
creek	creek
voleibol	volleyball
conjuntos	ensembles
demuestra	démontre
rolling	rolling
bafta	bafta
personalidades	personnalités
experiencias	expériences
austin	austin
sesenta	soixante
cannes	cannes
litoral	littoral
fases	phases
orgánica	organique
book	book
piensa	pense
piensa	réfléchis
carbón	charbon
mozart	mozart
set	set
sufre	souffre
perdidos	perdus
pesado	lourd
sorpresa	surprise
descendencia	descendance
descendencia	progéniture
badajoz	badajoz
romance	romance
escuadrón	escadron
oxígeno	oxygène
jueves	jeudi
cráter	cratère
distinción	distinction
abandonado	abandonné
instancia	instance
reuniones	réunions
mármol	marbre
instrucciones	instructions
pascual	pascual
jalisco	jalisco
muralla	muraille
disolución	dissolution
vivía	vivait
hispano	hispanique
interpretando	interprétant
milenio	millénaire
ligero	léger
sagrado	sacré
empresarios	entrepreneurs
húngaro	hongrois
matriz	matrice
books	books
sara	sara
marshall	marshall
wilhelm	wilhelm
coordinación	coordination
sarmiento	sarmiento
condenado	condamné
caliente	chaud
reúne	réunit
reúne	rassemble
represión	répression
deciden	décident
hembras	femelles
corredor	coureur
radiación	rayonnement
radiación	radiation
baker	baker
bad	bad
tito	tito
corporation	corporation
ine	ine
estética	esthétique
visitas	visites
otto	otto
condes	comtes
colonos	colons
configuración	configuration
boda	mariage
gobernadores	gouverneurs
ganados	gagnés
permitía	permettait
mecanismos	mécanismes
entrantes	entrantes
entrantes	entrants
construidos	construits
gen	gène
lleno	plein
colaborador	collaborateur
colaborador	contributeur
sentencia	jugement
congregación	congrégation
incorpora	incorpore
abandono	abandon
clasificados	classés
trazado	tracé
kennedy	kennedy
defensores	défenseurs
gay	gay
bóveda	voûte
check	check
sueños	rêves
vamos	allez
anualmente	annuellement
lector	lecteur
básicamente	fondamentalement
puntuación	ponctuation
ángulo	angle
oral	orale
oral	oral
básico	basique
precisión	précision
protegido	protégé
recomienda	recommande
socialistas	socialistes
postura	posture
provoca	provoque
sarah	sarah
socios	partenaires
oración	prière
arteria	artère
pri	pri
protegidas	protégées
visible	visible
grant	grant
templos	temples
anfibios	amphibiens
islam	islam
adyacentes	adjacents
misiles	missiles
aprobado	approuvé
apodo	surnom
emergencia	urgence
intérprete	interprète
canta	chante
constantemente	constamment
limitado	limité
nombrada	nommée
enviar	envoyer
soul	soul
intendente	intendant
preguntas	questions
wwe	wwe
estadios	stades
reciben	reçoivent
vigilancia	surveillance
planificación	planification
bibliotecarios	bibliothécaires
montreal	montréal
barrera	barrière
permitiendo	permettant
aprender	apprendre
pictures	pictures
pakistán	pakistan
catalunya	catalunya
baby	baby
imprenta	imprimerie
tesoro	trésor
macedonia	macédoine
ofrecen	offrent
pianista	pianiste
facilitar	faciliter
bits	bits
patrona	patronne
sancho	sancho
continuo	continuum
continuo	continu
vecino	voisin
exploración	exploration
exploración	balayage
consejos	conseils
parámetros	paramètres
guitarras	guitares
componente	composant
corrupción	corruption
externa	externe
ebro	ebre
us$	us$
lawrence	lawrence
signo	signe
espejo	miroir
finalidad	finalité
iso	iso
sinfonía	symphonie
virtud	vertu
teclado	clavier
matemático	mathématicien
feliz	joyeux
feliz	heureux
recoge	ramasse
mapas	cartes
molecular	moléculaire
cúpula	coupole
ciudadano	citoyen
cónsul	consul
existir	exister
protocolo	protocole
malvinas	malouines
dallas	dallas
capturado	capturé
huesca	huesca
batman	batman
continuidad	continuité
hablando	parlant
restaurante	restaurant
tanques	chars
informes	rapports
misterio	mystère
harris	harris
expresa	exprime
planetas	planètes
proteína	protéine
espalda	dos
signos	signes
administrador	administrateur
noches	nuits
estrecha	étroite
extraño	étrange
vigo	vigo
mantienen	maintiennent
venus	vénus
determinada	déterminée
hamilton	hamilton
cirugía	chirurgie
segmento	segment
destruido	détruit
genus	genus
servidor	serveur
portero	portier
aplicar	appliquer
diablo	diablo
diablo	diable
java	java
transferencia	transfert
quinteto	quintette
reconocer	reconnaître
more	more
intérpretes	interprètes
internos	internes
llena	pleine
jueces	juges
alcohol	alcool
cubano	cubain
rodeado	entouré
beatriz	béatrice
estable	stable
about	about
inspirado	inspiré
subir	monter
uci	uci
concesión	concession
arqueología	archéologie
iniciales	initiales
praga	prague
tigre	tigre
linux	linux
light	light
protesta	protestation
protesta	manif
detener	arrêter
genética	génétique
monumental	monumental
responde	répond
lyon	lyon
celebran	célèbrent
celebran	fêtent
palo	bâton
varía	varie
cat	cat
ondas	ondes
sufrido	souffert
protestas	protestations
contratado	embauché
contratado	engagé
abundante	abondant
llaman	appellent
conservatorio	conservatoire
correcta	correcte
colonización	colonisation
islandia	islande
controversia	controverse
incorporación	incorporation
diseñador	concepteur
diseñador	designer
oklahoma	oklahoma
orlando	orlando
anillos	anneaux
leyendas	légendes
morgan	morgan
contribución	contribution
banderas	drapeaux
originario	originaire
acb	acb
voluntarios	volontaires
germán	germán
indicar	indiquer
domínguez	domínguez
sustitución	remplacement
sustitución	substitution
horacio	horatio
distinciones	distinctions
literalmente	littéralement
emisiones	émissions
emisiones	emissions
supuestamente	prétendument
western	western
isaac	isaac
bosnia	bosnie
químico	chimiste
destinos	destinations
urss	urss
reacciones	réactions
challenger	challenger
queso	fromage
leopoldo	léopold
ponce	ponce
externo	externe
gary	gary
inca	inca
identificar	identifier
ian	ian
hip	hip
smiths	smiths
concilio	concile
escuchar	ecouter
escuchar	écouter
hop	hop
catorce	quatorze
gráficos	graphiques
ferrer	ferrer
taiwán	taïwan
natación	natation
frases	phrases
anuncio	annonce
tubo	tube
freshwater	freshwater
flamenco	flamand
refleja	reflète
cálculo	calcul
get	get
cifras	chiffres
carter	carter
quebec	québec
kentucky	kentucky
lorena	lorraine
entrevistas	interviews
conduce	conduit
bibliotecas	bibliothèques
propietarios	propriétaires
hierba	herbe
responsables	responsables
convenciones	conventions
extremadamente	extrêmement
cubana	cubaine
review	review
hernán	hernán
hablan	parlent
publicadas	publiées
iniciado	initié
manifiesto	manifeste
fantasma	fantôme
centímetros	centimètres
commons	commons
soluciones	solutions
revuelta	révolte
implicados	impliqués
especialidad	spécialité
contraste	contraste
castellón	castellón
carlo	carlo
generaciones	générations
bello	bello
arreglos	arrangements
esencial	essentiel
nombramiento	nomination
jerez	jerez
abreviado	abrégé
esquema	schéma
piratas	pirates
sirven	servent
ecuación	équation
permanecer	rester
recibiendo	recevant
faro	phare
jon	jon
phil	phil
almacenamiento	stockage
especializado	spécialisé
tarragona	tarragone
asignado	attribué
asignado	assigné
fire	fire
neutral	neutre
walker	walker
conversión	conversion
separados	séparés
omar	omar
descanso	repos
sinónimo	synonyme
violación	viol
presentador	présentateur
quintana	quintana
utah	utah
platos	plats
débil	faible
broadway	broadway
trabajaba	travaillait
crímenes	crimes
valdés	valdés
free	free
vila	vila
derivados	dérivés
chihuahua	chihuahua
contando	comptant
vivos	vivants
gerardo	gerardo
australiano	australien
asteroide	astéroïde
superfamilia	superfamille
dimensión	dimension
atentado	attentat
creía	croyait
afganistán	afghanistan
restaurantes	restaurants
perry	perry
comer	manger
heridas	blessures
diagnóstico	diagnostic
montana	montana
privados	privés
onu	onu
francesco	francesco
celebrar	célébrer
intelectuales	intellectuels
macho	mâle
steven	steven
décimo	dixième
clasificaciones	classements
bach	bach
viña	vigne
capas	couches
interacción	interaction
murray	murray
perfecto	parfait
mhz	mhz
jordi	jordi
girls	girls
trigo	blé
persa	persan
tennessee	tennessee
civilización	civilisation
complejos	complexes
mariana	mariana
turco	turc
creen	croient
enfrentamientos	affrontements
iluminación	éclairage
convocado	convoqué
mineral	minéral
sustancias	substances
entero	entier
impulso	impulsion
lectores	lecteurs
castellana	castellana
elevación	élévation
móviles	mobiles
integra	integra
rotación	rotation
estabilidad	stabilité
dependiente	dépendant
dependiente	dépendante
curva	courbe
alabama	alabama
maestría	maîtrise
hidrógeno	hydrogène
krai	kraï
people	people
criminal	criminel
year	year
tejidos	tissus
fabricante	fabricant
adquisición	acquisition
cuadrado	carré
existían	existaient
expulsado	expulsé
guerreros	guerriers
positivo	positif
combatir	combattre
iguales	égaux
impuesto	impôt
modificación	modification
ginebra	genève
luces	lumières
interiores	intérieurs
juveniles	juvéniles
sindicato	syndicat
inclusión	inclusion
rick	rick
suspensión	suspension
desplazamiento	déplacement
reconocidos	reconnus
pedido	commande
históricamente	historiquement
font	font
jordan	jordan
huelga	grève
eddie	eddie
claudia	claudia
apple	apple
benjamin	benjamin
capitales	capitales
just	just
llamaba	appelait
serena	serena
declarada	déclarée
unam	unam
salsa	sauce
salvaje	sauvage
baleares	baléares
bryan	bryan
alfabeto	alphabet
manuscrito	manuscrit
petersburgo	pétersbourg
horizontal	horizontal
vestido	robe
octavo	huitième
palestina	palestine
ampliar	agrandir
orstom	orstom
cartel	affiche
maryland	maryland
arm	arm
granja	ferme
patas	pattes
presentada	présentée
masters	masters
oficio	métier
dream	dream
liderazgo	leadership
mostrando	montrant
space	space
célula	cellule
lineal	linéaire
franquicia	franchise
tervuren	tervuren
expulsión	expulsion
linda	mignonne
genes	gènes
perón	peron
observaciones	remarques
pepe	pepe
rivales	rivaux
rayo	foudre
físicos	physiciens
organiza	organise
bombas	pompes
cecilia	cécile
marte	mars
retratos	portraits
loco	fou
formaba	formait
harrison	harrison
stewart	stewart
argelia	algérie
sound	sound
rechazo	rejet
parker	parker
describir	décrire
xavier	xavier
chipre	chypre
guy	guy
expresiones	expressions
songs	songs
ruptura	rupture
filósofos	philosophes
thys	thys
adolescente	adolescent
inés	inès
prototipo	prototype
dinámica	dynamique
variación	variation
latitud	latitude
trío	trio
usted	vous
sabía	savait
alfa	alpha
caudal	débit
ann	ann
irlandés	irlandais
asiático	asiatique
audenaerde	audenaerde
edgar	edgar
anchura	largeur
botanical	botanical
marciales	martiaux
barry	barry
utilidad	utilitaire
manchester	manchester
beatles	beatles
higgins	higgins
celebrada	tenue
receptor	récepteur
construidas	construites
personalmente	personnellement
valenciano	valencien
xbox	xbox
maugé	maugé
tramos	tranches
contemporáneos	contemporains
ken	ken
campeona	championne
automáticamente	automatiquement
pacheco	pacheco
abraham	abraham
colaboradores	collaborateurs
lost	lost
caras	visages
supercopa	supercoupe
turín	turin
lesiones	blessures
disminución	diminution
aceptación	acceptation
parra	parra
facilidad	facilité
land	land
cedido	cédé
definido	défini
soviéticos	soviétiques
figueroa	figueroa
adquirido	acquis
pérdidas	pertes
fantasía	fantaisie
fenómenos	phénomènes
mini	mini
master	master
africano	africain
let	let
robinson	robinson
otomano	ottoman
over	over
finanzas	finances
boxeo	boxe
ocupada	occupée
renault	renault
raymond	raymond
iron	iron
comparte	partage
comparte	partagez
jerry	jerry
árbitro	arbitre
antropología	anthropologie
favorable	favorable
bizantino	byzantin
significativa	significative
fiel	fidèle
derivado	dérivé
derivado	dérivée
rodaje	tournage
escalera	escalier
heinrich	heinrich
reglamento	règlement
arabia	arabie
gigantes	géants
paisajes	paysages
cuesta	coûte
mito	mythe
dei	dei
grabados	gravures
robot	robot
cárdenas	cárdenas
cuota	quota
roland	roland
obreros	ouvriers
primarias	primaires
interpretaciones	interprétations
hembra	femelle
gold	gold
procedimientos	procédures
dominante	dominant
fred	fred
rob	rob
chaco	chaco
facultades	facultés
recuerdos	souvenirs
mantenido	maintenu
popularmente	populairement
específicos	spécifiques
wright	wright
falla	faille
romper	briser
huerta	huerta
seguimiento	suivi
difíciles	difficiles
cerveza	bière
proyección	projection
chiapas	chiapas
contenía	contenait
bloqueado	verrouillé
bloqueado	bloqué
maneras	façons
salen	sortent
infierno	enfer
gastos	dépenses
depósito	dépôt
lucio	lucius
montenegro	monténégro
emma	emma
terry	terry
jornadas	journées
lobos	loups
especialista	spécialiste
pendiente	pente
realista	réaliste
yacimiento	gisement
century	century
cortas	courtes
definitivo	définitif
comenzando	commençant
paraíso	paradis
testimonio	témoignage
malta	malte
balonmano	handball
bloques	blocs
positiva	positive
separa	sépare
turner	turner
vidal	vidal
polvo	poudre
componen	composent
balón	ballon
declara	déclare
alegría	joie
luxemburgo	luxembourg
prusia	prusse
declaraciones	déclarations
cronología	chronologie
cría	élevage
ilustraciones	illustrations
ron	rhum
estrada	estrada
singular	singulière
singular	singulier
vital	vital
comenzado	commencé
phoenix	phoenix
semi	semi
maine	maine
varsovia	varsovie
masacre	massacre
vinos	vins
nominada	nominée
denuncia	plainte
denuncia	dénonciation
decidir	décider
frutas	fruits
periodos	périodes
graham	graham
duquesa	duchesse
delito	délit
metales	métaux
sufrir	souffrir
renfe	renfe
golf	golf
creencias	croyances
baltimore	baltimore
reputación	réputation
toman	prennent
party	party
norman	norman
humberto	humberto
participante	participant
conexiones	connexions
jugados	joués
aurora	aurore
htm	htm
ámsterdam	amsterdam
ilustración	illustration
potosí	potosí
constituyente	constituant
convertir	convertir
emite	émet
llanura	plaine
levantamiento	soulèvement
hebreo	hébreu
propaganda	propagande
thompson	thompson
jay	jay
placas	plaques
culpa	blâme
causar	causer
singapur	singapour
desarrollan	développent
comerciantes	commerçants
bank	bank
hamburgo	hambourg
ordenado	ordonné
pereira	pereira
proporción	proportion
fiat	fiat
interfaz	interface
vuelven	reviennent
correa	sangle
colaborar	collaborer
arquidiócesis	archidiocèse
episcopal	épiscopale
circuitos	circuits
magallanes	magellan
distribuye	distribue
concacaf	concacaf
auxiliar	auxiliaire
corteza	écorce
sensación	sensation
afluentes	affluents
suave	doux
have	have
constantes	constantes
cbs	cbs
jamaica	jamaïque
censura	censure
rebelde	rebelle
roll	roll
paco	paco
nancy	nancy
marítima	maritime
crimea	crimée
liberado	libéré
encuesta	sondage
afecta	affecte
enciclopédico	encyclopédique
pokémon	pokémon
generalidad	généralité
medir	mesurer
asume	assume
dieta	diète
aparente	apparent
aparente	apparente
discusiones	discussions
stanley	stanley
panorama	panorama
realistas	réalistes
rin	rhin
duelo	deuil
duelo	duel
legend	legend
seattle	seattle
rectangular	rectangulaire
acústica	acoustique
innovación	innovation
hueso	os
donald	donald
rincón	coin
jacob	jacob
ordenador	ordinateur
seguros	assurances
correr	courir
hms	hms
telecomunicaciones	télécommunications
arequipa	arequipa
iris	iris
maldonado	maldonado
cantando	chantant
examen	examen
depósitos	dépôts
ocasionalmente	occasionnellement
invitada	invitée
gov	gov
homer	homer
liverpool	liverpool
rap	rap
respondió	répondit
asistir	assister
turistas	touristes
darío	darius
imdb	imdb
autobús	bus
actuando	agissant
confusión	confusion
lituania	lituanie
tendencias	tendances
secretos	secrets
tommy	tommy
probabilidad	probabilité
disc	disc
amistoso	amical
entretenimiento	divertissement
temprano	tôt
euphorbia	euphorbe
direcciones	adresses
soprano	soprano
now	now
atletas	athlètes
sonic	sonic
asumir	assumer
espectro	spectre
conducción	conduite
gobernantes	gouvernants
inteligente	intelligent
manhattan	manhattan
partió	partit
cia	cia
dosis	dose
conocía	connaissait
antártida	antarctique
unen	unissent
citas	citations
aprobada	approuvée
filadelfia	philadelphie
decidido	décidé
baden	baden
falso	faux
enfrenta	affronte
humedad	humidité
atracción	attraction
tabasco	tabasco
formaciones	formations
destruida	détruite
testigo	témoin
afluente	affluent
bros	bros
kilómetro	kilomètre
bobby	bobby
lugo	lugo
reptiles	reptiles
logo	logo
sustancia	substance
holandés	hollandais
holandés	néerlandais
estocolmo	stockholm
nasa	nasa
mercurio	mercure
gilbert	gilbert
escobar	escobar
moléculas	molécules
regulación	régulation
sargento	sergent
alturas	hauteurs
creencia	croyance
aterrizaje	atterrissage
campbell	campbell
danny	danny
ventajas	avantages
martes	mardi
requieren	exigent
requieren	nécessitent
arsenal	arsenal
sociología	sociologie
nigeria	nigeria
nigeria	nigéria
constantinopla	constantinople
gibraltar	gibraltar
consola	console
sentimiento	sentiment
cargas	charges
complutense	complutense
when	when
márquez	marquez
flash	flash
reality	reality
castillos	châteaux
fuga	fuite
fuga	fugue
cleveland	cleveland
experto	expert
frontal	frontal
aprovechando	profitant
borgoña	bourgogne
huevo	œuf
tragedia	tragédie
ubicados	situés
lagunas	lacunes
beta	bêta
contaminación	pollution
charlotte	charlotte
azteca	aztèque
patrones	patrons
how	how
boeing	boeing
transmisiones	transmissions
aliado	allié
ama	aime
mediodía	midi
traducciones	traductions
pulgadas	pouces
arnold	arnold
ladrillo	brique
calvo	chauve
barbara	barbara
creer	croire
compartir	partager
niñas	filles
dependencia	dépendance
detective	détective
probar	essayer
mónica	monica
arroyos	ruisseaux
volante	volant
sabio	sage
budapest	budapest
cráneo	crâne
provocando	provoquant
velocidades	vitesses
madison	madison
caridad	charité
leftarm	leftarm
situadas	situées
estero	estero
philip	philip
armados	armés
three	three
manuscritos	manuscrits
rivas	rivas
necesariamente	nécessairement
tve	tve
incluían	incluaient
demonio	démon
note	notez
emitida	émise
carrillo	carrillo
nazis	nazis
lérida	lérida
valdivia	valdivia
luisiana	louisiane
televisa	televisa
materias	matières
estándares	standards
boletín	bulletin
potencias	puissances
ejemplar	exemplaire
express	express
normales	normales
normales	normaux
estelar	stellaire
montaje	montage
demo	démo
considerando	considérant
enviados	envoyés
fotógrafo	photographe
kent	kent
larry	larry
asesinados	assassinés
combatientes	combattants
oponente	adversaire
activamente	activement
giuseppe	giuseppe
pura	pure
forestal	forestier
viola	viole
track	track
parodia	parodie
evangelio	évangile
honda	honda
eléctricos	électriques
loira	loire
esfera	sphère
muertes	décès
intenso	intense
alvarado	alvarado
ibáñez	ibáñez
litros	litres
constituido	constitué
name	name
consulado	consulat
autorización	autorisation
belén	bethléem
próximos	prochains
discografía	discographie
rangers	rangers
esquí	ski
envía	envoie
envía	envoyez
prisionero	prisonnier
causando	causant
teorema	théorème
golpes	coups
mega	méga
mega	mega
herbert	herbert
recorre	parcourt
dinosaurios	dinosaures
brevemente	brièvement
ética	éthique
encontrados	trouvés
correspondencia	correspondance
monjes	moines
formatos	formats
vaticano	vatican
bombardeo	bombardement
respuestas	réponses
cooper	cooper
duero	douro
august	august
cambiando	changeant
típicos	typiques
lento	lent
summer	summer
dramaturgo	dramaturge
seudónimo	pseudonyme
sacro	sacro
apoyado	appuyé
apoyado	soutenu
independientemente	indépendamment
astronómico	astronomique
col	col
ludwig	ludwig
velázquez	velázquez
líbano	liban
túnez	tunisie
cena	dîner
pescado	poisson
republicanos	républicains
magic	magic
lujo	luxe
electrones	électrons
wood	wood
european	european
vacaciones	vacances
murallas	remparts
descendiente	descendant
eta	eta
pts	pts
cóndor	condor
coronado	couronné
manifestación	manifestation
mansión	manoir
suplente	suppléant
convencional	conventionnel
asesinatos	meurtres
fieles	fidèles
southern	southern
concha	coquille
implementación	implémentation
correctamente	correctement
perdida	perdue
ciudadanía	citoyenneté
significativo	significative
significativo	significatif
desastre	désastre
warren	warren
elías	elias
ltd	ltd
identificado	identifié
ejecutar	exécuter
plástico	plastique
armadura	armure
guipúzcoa	guipúzcoa
dedicados	dédiés
bebé	bébé
hits	hits
tenor	ténor
mortal	mortel
tallos	tiges
casino	casino
leipzig	leipzig
delegado	délégué
adoptado	adopté
colinas	collines
apolo	apollon
membrana	membrane
etnia	ethnie
ruido	bruit
ricos	riches
radar	radar
wagner	wagner
quieren	veulent
teatros	théâtres
añadido	ajouté
fabricantes	fabricants
trabajan	travaillent
pilares	piliers
guarnición	garnison
edwards	edwards
fábricas	usines
roman	roman
oliva	olive
conservadores	conservateurs
contener	contenir
secos	secs
escape	échappement
escape	escape
shakespeare	shakespeare
für	für
under	under
eugenia	eugenia
desarrollados	développés
alternativas	alternatives
entiende	comprenez
extracción	extraction
profundamente	vivement
profundamente	profondément
fresco	frais
nacionalismo	nationalisme
cruzar	traverser
disciplinas	disciplines
responder	répondre
galaxia	galaxie
dependencias	dépendances
produciendo	produisant
abu	abou
bola	boule
lázaro	lazare
wolf	wolf
certificado	certificat
certificado	certifié
vigor	vigueur
rita	rita
usaba	utilisait
uss	uss
escándalo	scandale
sólido	solide
kiev	kiev
serpiente	serpent
testigos	témoins
economista	économiste
códigos	codes
prevención	prévention
solares	solaires
progresivo	progressif
estudia	étudie
paloma	colombe
folk	folk
ira	colère
atractivo	attractif
volar	voler
entregado	livré
etiopía	éthiopie
dick	dick
jefferson	jefferson
celeste	céleste
palermo	palerme
asientos	sièges
dominios	domaines
falsa	fausse
tribunales	tribunaux
bond	bond
cerdo	porc
dorsal	dorsale
woman	woman
blood	blood
danés	danois
cajas	boîtes
pacific	pacific
ring	ring
fiebre	fièvre
geometría	géométrie
pink	pink
doblaje	doublage
hoteles	hôtels
blas	blas
bull	bull
ayala	ayala
derrotas	défaites
macizo	massif
sacramento	sacramento
neil	neil
documentales	documentaires
canciller	chancelier
collins	collins
aldeas	villages
silvia	silvia
inmaculada	immaculée
desafío	défi
soberano	souverain
emi	emi
normandía	normandie
temporalmente	temporairement
ánimo	courage
chart	chart
divina	divine
hablantes	locuteurs
ilustres	illustres
prieto	prieto
oso	ours
cruzada	croisade
teruel	teruel
nat	nat
mostrado	montré
formaban	formaient
via	via
excentricidad	excentricité
rivadavia	rivadavia
levante	levant
mirada	regard
hará	fera
marquesado	marquisat
sri	sri
games	games
departamental	départemental
plumas	plumes
consideración	considération
cerrar	fermer
molino	moulin
tronco	tronc
cuarteto	quatuor
nativo	natif
cook	cook
marquesa	marquise
anatomía	anatomie
monstruo	monstre
escribiendo	écrivant
dedos	doigts
denis	denis
anunciado	annoncé
vitoria	vitoria
estonia	estonie
bacterias	bactéries
ortodoxa	orthodoxe
extendido	étendu
arácnidos	arachnides
ilegal	illégal
apóstol	apôtre
ejecutado	exécuté
escocés	écossais
crecer	grandir
luchas	luttes
apreciar	apprécier
discutir	discuter
gabriela	gabriela
radios	rayons
coordinador	coordonnateur
coordinador	coordinateur
miércoles	mercredi
poseer	posséder
terrorismo	terrorisme
linares	linares
side	side
poderosa	puissante
lunar	lunaire
precipitaciones	précipitations
adquiere	acquiert
defecto	défaut
viajeros	voyageurs
sobrevivir	survivre
ferrari	ferrari
adolescentes	adolescents
callao	callao
confirmado	confirmé
here	here
brooklyn	brooklyn
comunica	communique
lienzo	toile
taekwondo	taekwondo
solidaridad	solidarité
gard	gard
evans	evans
accesible	accessible
aporte	apport
georg	georg
certificados	certificats
castigo	punition
castigo	châtiment
complejidad	complexité
head	head
gallo	coq
nuestras	nos
matthew	matthew
salomón	salomon
nbc	nbc
exportación	exportation
susana	susana
hambre	faim
residuos	déchets
socialismo	socialisme
américas	amériques
directorio	répertoire
cruza	croise
leones	lions
amy	amy
prohibición	interdiction
dean	dean
alusión	allusion
leonor	éléonore
habitan	habitent
irregular	irrégulier
irregular	irrégulière
consecutivos	consécutifs
consecutivos	consécutives
escudos	boucliers
operar	opérer
terapia	thérapie
instalado	installé
barro	boue
acompañada	accompagnée
stuttgart	stuttgart
riesgos	risques
eco	eco
eco	écho
acosta	acosta
vienen	viennent
never	never
class	class
presentadora	présentatrice
comisario	commissaire
decenas	dizaines
campana	cloche
