pib	pib
tía	tatie
rivalidad	rivalité
húmedo	humide
embajadores	ambassadeurs
hospitales	hôpitaux
morelos	morelos
astronomía	astronomie
alcanzan	atteignent
leal	loyale
terroristas	terroristes
guido	guido
comisiones	commissions
detención	détention
algoritmo	algorithme
inversiones	investissements
criaturas	créatures
lloyd	lloyd
mercancías	marchandises
margaret	margaret
hills	hills
ten	ten
jennifer	jennifer
tela	tissu
lorca	lorca
serra	serra
refugiados	réfugiés
marcel	marcel
dylan	dylan
harold	harold
god	god
descubridor	découvreur
énfasis	emphase
combinado	combiné
almagro	almagro
revisar	réviser
potter	potter
circo	cirque
vecina	voisine
modificado	modifié
radial	radial
angola	angola
contactos	contacts
vivas	vivantes
conservado	conservé
exploradores	explorateurs
exploradores	éclaireurs
comparten	partagent
hudson	hudson
pampa	pampa
flauta	flûte
hormigón	béton
pinto	pinto
odio	haine
cauca	cauca
celta	celtique
consultas	consultations
consultas	requêtes
comprobar	vérifier
prosa	prose
radicales	radicaux
condena	condamne
condena	condamnation
connecticut	connecticut
discípulo	disciple
saboya	savoie
juzgado	jugé
religiones	religions
lealtad	loyauté
morris	morris
paolo	paolo
start	start
funcional	fonctionnel
guevara	guevara
cayo	caius
melbourne	melbourne
máscara	masque
activista	activiste
michelle	michelle
galardonado	primé
novelista	romancier
avanzar	avancer
puro	pur
tomas	tomas
separada	séparée
comprensión	compréhension
comprensión	comprendre
blake	blake
mónaco	monaco
distinguir	distinguer
rodeada	entourée
ontario	ontario
trilogía	trilogie
chocolate	chocolat
calzada	chaussée
tumbas	tombes
conservar	conserver
berkeley	berkeley
inmediata	immédiate
use	use
riego	arrosage
podrán	pourront
piernas	jambes
típicamente	typiquement
dramático	dramatique
músculo	muscle
sul	sul
atleta	athlète
val	val
franquista	franquiste
croata	croate
perdón	pardon
paquete	paquet
busto	buste
desconocida	inconnue
especialistas	spécialistes
opuesto	opposé
mono	mono
trastornos	affections
afectados	touchés
rehabilitación	réhabilitation
revelación	révélation
aluminio	aluminium
satélites	satellites
infección	infection
pasaba	passait
noveno	neuvième
mezquita	mosquée
she	she
habrían	auraient
kurt	kurt
contratos	contrats
guardias	gardes
definida	définie
regente	régent
terrorista	terroriste
only	only
desarrollando	développant
superficial	superficielle
superficial	superficiel
abundancia	abondance
arms	arms
marfil	ivoire
redactor	rédacteur
gaspar	gaspar
conspiración	complot
ejerce	exerce
verbo	verbe
excelencia	excellence
funcionario	fonctionnaire
explorador	explorateur
cumpleaños	anniversaire
ernst	ernst
uruguaya	uruguayenne
kate	kate
taxonomía	taxonomie
útiles	utiles
mixto	mixte
melodía	mélodie
estimación	estimation
luigi	luigi
afc	afc
albania	albanie
costarricense	costaricien
comunicado	communiqué
dieciséis	seize
ucraniano	ukrainien
detenidos	détenus
esencia	essence
seúl	séoul
conversaciones	conversations
percepción	perception
fijo	fixe
descripciones	descriptions
fundar	fonder
bachillerato	baccalauréat
full	full
silver	silver
presentaba	présentait
wii	wii
pila	pile
regularmente	régulièrement
caos	chaos
módulo	module
eslovenia	slovénie
soccerway	soccerway
turcos	turcs
garganta	gorge
prohibido	interdite
prohibido	interdit
mitre	mitre
noruego	norvégien
there	there
rítmica	rythmique
dulces	bonbons
permanencia	permanence
watson	watson
anglo	anglo
grueso	épais
exceso	excès
obtención	obtention
triángulo	triangle
bart	bart
clero	clergé
habsburgo	habsbourg
relativo	relatif
cama	lit
comenta	commente
terminando	terminant
piedad	pitié
utilizaba	utilisait
camilo	camilo
ram	ram
michoacán	michoacán
realismo	réalisme
espinosa	espinosa
conversación	conversation
dante	dante
pionero	pionnier
clasificar	classer
emisoras	diffuseurs
espinas	épines
cretácico	crétacé
ted	ted
habitaciones	chambres
myspace	myspace
constituida	constituée
arbustos	arbustes
aeropuertos	aéroports
urbanización	urbanisation
mencionados	mentionnés
supervivencia	survie
pistola	pistolet
ascensión	ascension
cover	cover
dennis	dennis
migración	migration
hunter	hunter
ola	ola
ilustre	illustre
martha	martha
adición	additif
dialecto	dialecte
gramática	grammaire
limpieza	nettoyage
explorer	explorer
foraminíferos	foraminifères
marcar	marquer
oceanía	océanie
cáucaso	caucase
after	after
varela	varela
wang	wang
policías	flics
arcade	arcade
threatened	threatened
púrpura	pourpre
eclesiástica	ecclésiastique
llevaban	portaient
expresar	exprimer
jacinto	jacinto
uribe	uribe
reconquista	reconquête
minoría	minorité
medicamentos	médicaments
crean	créent
bebida	boisson
mitchell	mitchell
aceptada	acceptée
favorito	favori
tiende	tend
transforma	transforme
élite	élite
futuros	futurs
contreras	contreras
ncaa	ncaa
negativo	négatif
cordero	agneau
andaluz	andalou
amparo	amparo
provocar	provoquer
leonard	leonard
ibm	ibm
austral	austral
coma	mangez
coma	virgule
oscuridad	obscurité
caracol	escargot
estatuas	statues
days	days
cazadores	chasseurs
castellanos	castellanos
urbanismo	urbanisme
vendidos	vendus
hércules	hercule
trastorno	trouble
restricciones	restrictions
producidas	produites
capillas	chapelles
traición	trahison
amenazas	menaces
rumores	rumeurs
heredia	heredia
sandra	sandra
sombrero	chapeau
sentir	sentir
sentir	ressentir
residencial	résidentiel
mit	mit
herzegovina	herzégovine
abel	abel
armonía	harmonie
cadáver	cadavre
inter	inter
distingue	distingue
obligación	obligation
sweet	sweet
years	years
distancias	distances
pensó	pensa
bordes	bordures
bordes	bords
fracción	fraction
cintas	rubans
kenia	kenya
homosexualidad	homosexualité
allende	allende
picos	pics
defensas	défenses
orquídeas	orchidées
agrega	ajoute
invitación	invitation
patagonia	patagonie
cívica	civique
terra	terra
presentando	présentant
mágico	magique
transmitir	transmettre
richter	richter
ritual	rituel
corpus	corpus
exclusivo	exclusif
príncipes	princes
round	round
pete	pete
muerta	morte
ritmos	rythmes
industry	industry
menéndez	menéndez
bebidas	boissons
stanford	stanford
tallo	tige
newton	newton
dell	dell
cartago	carthage
wikipedistas	wikipédiens
ion	ion
datan	datent
incapaz	incapable
aparatos	appareils
greg	greg
arañas	araignées
bush	bush
automática	automatique
consciente	conscient
lola	lola
take	take
honores	honneurs
monje	moine
aragonés	aragonais
esencialmente	essentiellement
juegan	jouent
fragmento	fragment
nombra	nomme
anales	annales
claustro	cloître
choque	choc
azerbaiyán	azerbaïdjan
sierras	scies
romeo	roméo
auditorio	auditorium
transmitido	transmis
eslovaquia	slovaquie
afectado	affecté
hablado	parlé
círculos	cercles
interesado	intéressé
fragata	frégate
narrador	narrateur
unir	unir
intermedio	intermédiaire
human	human
luke	luke
hermann	hermann
remo	aviron
sacrificio	sacrifice
intenciones	intentions
promesa	promesse
ejecutados	exécutés
todd	todd
consultar	consulter
cilindros	cylindres
walt	walt
belgrado	belgrade
baterías	batteries
daría	donnerait
abuso	abus
estrategias	stratégies
intersección	intersection
conquistar	conquérir
almas	âmes
stuart	stuart
superficies	surfaces
buscan	cherchent
buscan	recherchent
deseos	souhaits
brujas	bruges
continentales	continentaux
atlantic	atlantic
causado	causé
transmite	transmet
incorporado	incorporé
enfermo	malade
polar	polaire
avanzado	avancé
llamas	flammes
ortografía	orthographe
grace	grace
away	away
poniente	westeros
caro	cher
caro	caro
esgrima	escrime
our	our
emitir	émettre
óptica	optique
ingredientes	ingrédients
párrafo	paragraphe
pizarro	pizarro
reconocen	reconnaissent
mago	mage
mago	magicien
montero	montero
topónimo	toponyme
buscaba	cherchait
eliminados	éliminés
suicidio	suicide
wolfgang	wolfgang
enormes	énormes
slam	slam
alerta	alerte
levantar	soulever
naturalista	naturaliste
jujuy	jujuy
osorio	osorio
rodea	entoure
wide	wide
amenazada	menacée
superado	surpassé
susan	susan
bailarina	danseuse
borja	borja
nido	nid
reemplazar	remplacer
fibra	fibre
colaboraciones	collaborations
secuencias	séquences
acompaña	accompagne
olga	olga
cohete	fusée
vancouver	vancouver
pontevedra	pontevedra
horizonte	horizon
extraordinario	extraordinaire
folclore	folklore
prevenir	prévenir
cano	cano
compartido	partagé
fan	fan
cineasta	cinéaste
malas	mauvaises
afirmación	affirmation
sombras	ombres
violeta	violette
itunes	itunes
poblada	peuplée
inflorescencia	inflorescence
osvaldo	osvaldo
guayana	guyane
ejes	axes
ejes	essieux
alejandra	alejandra
siding	siding
helicóptero	hélicoptère
wall	wall
circunscripción	circonscription
posesiones	possessions
aplicada	appliquée
sindicatos	syndicats
testimonios	témoignages
keith	keith
liberar	libérer
determina	détermine
incidentes	incidents
nervioso	nerveux
paraguayo	paraguayen
convierten	convertissent
clinton	clinton
puntas	pointes
octavos	huitièmes
constantino	constantin
denominaciones	dénominations
feat	feat
reflexión	réflexion
pietro	pietro
again	again
júpiter	jupiter
cualidades	qualités
hurtado	hurtado
justin	justin
jessica	jessica
transferido	transféré
tanzania	tanzanie
zapata	zapata
expone	expose
promovido	promu
antofagasta	antofagasta
orbital	orbitale
raf	raf
querer	vouloir
oregón	oregon
ref	réf
ref	ref
haití	haïti
asistentes	assistants
rachel	rachel
ciclos	cycles
confluencia	confluence
identifica	identifie
cuero	cuir
entran	entrent
corredores	courtiers
corredores	coureurs
tranvía	tramway
escolta	escorte
terminales	terminaux
desfile	défilé
barras	barres
dublín	dublin
celebraciones	célébrations
hispania	hispanie
galerías	galeries
artificiales	artificiels
piscina	piscine
tienden	tendent
patente	brevet
convocatoria	convocation
nacionalistas	nationalistes
biografías	biographies
mundos	mondes
institutos	instituts
chelsea	chelsea
concedido	accordé
marx	marx
plural	pluriel
nudos	noeuds
nudos	nœuds
biológica	biologique
khan	khan
anarquistas	anarchistes
knight	knight
billetes	billets
coreano	coréen
organizados	organisés
ecuaciones	équations
tardío	tardif
atacado	attaqué
privilegios	privilèges
balada	ballade
enríquez	enríquez
disfrutar	profiter
finaliza	termine
perfecta	parfaite
guanajuato	guanajuato
suite	suite
caracterizado	caractérisé
detectar	détecter
incendios	incendies
ronald	ronald
revolucionarios	révolutionnaires
mejía	mejía
costos	coûts
láser	laser
marsella	marseille
danzas	danses
vinculado	lié
kiss	kiss
conducir	conduire
pirámide	pyramide
ecuatorial	équatoriale
inscripciones	inscriptions
materna	maternelle
eficiente	efficace
álava	alava
humanidades	humanités
agregado	ajouté
algodón	coton
sultán	sultan
saavedra	saavedra
inundaciones	inondations
hopkins	hopkins
portland	portland
coronación	couronnement
adolf	adolf
inspector	inspecteur
calibre	calibre
grey	grey
terrible	terrible
serbio	serbe
checoslovaquia	tchécoslovaquie
triste	triste
templado	tempéré
arica	arica
maracaibo	maracaibo
mártir	martyr
mártir	martyre
frecuencias	fréquences
germánico	germanique
talk	talk
analizar	analyser
benjamín	benjamin
ocupan	occupent
view	view
plomo	plomb
ciudadana	citoyenne
bruja	sorcière
sudán	soudan
horror	horreur
eficacia	efficacité
roberts	roberts
creciendo	grandissant
traductor	traducteur
monroe	monroe
ufc	ufc
supervisión	supervision
rumano	roumain
tonos	sonneries
ecología	écologie
merece	mérite
automático	automatique
atracciones	attractions
pintado	peint
desaparece	disparaît
zúñiga	zúñiga
parlamentario	parlementaire
vicario	vicaire
martí	martí
renunciar	démissionner
renunciar	renoncer
budismo	bouddhisme
interesantes	intéressants
activistas	activistes
anton	anton
tigres	tigres
camerún	cameroun
ambientes	ambiances
atentados	attentats
olimpia	olympie
milicias	milices
oído	oreille
supuesta	supposée
supuesta	prétendue
adaptado	adapté
resurrección	résurrection
pensando	pensant
ratón	souris
bolonia	bologne
tubos	tubes
presas	barrages
grove	grove
march	march
kids	kids
sensibilidad	sensibilité
culpable	coupable
dibujante	dessinateur
aguilera	aguilera
sosa	soude
querían	voulaient
financiación	financement
protestantes	protestants
determinación	détermination
marcando	marquant
estela	sillage
supl	suppl
adopción	adoption
hit	hit
report	report
act	act
elche	elche
carrasco	carrasco
citar	citer
tabaco	tabac
godoy	godoy
llegaba	arrivait
santana	santana
jerarquía	hiérarchie
limón	citron
traducir	traduire
lanka	lanka
temor	craintes
recoger	ramasser
aislamiento	isolement
campanario	clocher
cooperativa	coopérative
asturiano	asturien
hook	hook
valentín	valentin
clube	clube
conmebol	conmebol
lana	laine
cabina	cabine
eliminatoria	qualif
vocación	vocation
teléfonos	téléphones
otan	otan
marcial	martial
astrónomo	astronome
primitiva	primitive
nepal	népal
fusil	fusil
presentadores	présentateurs
servidores	serveurs
primitivo	primitif
soler	soler
lozano	lozano
caracterizan	caractérisent
frías	froides
bomberos	pompiers
copenhague	copenhague
raven	raven
esclavitud	esclavage
ocupaba	occupait
escucha	ecoute
escucha	écoute
manchas	taches
deep	deep
decadencia	décadence
permanentes	permanents
sanz	sanz
prepara	prépare
model	model
luciano	luciano
finalización	finalisation
che	che
monasterios	monastères
contribuir	contribuer
avellaneda	avellaneda
efectivos	effectifs
servido	servi
lourdes	lourdes
empleada	employée
sucesivamente	successivement
rito	rite
rompe	casse
helen	helen
colin	colin
sonata	sonate
enfermos	malades
cairo	caire
estimado	estimé
carro	chariot
homosexuales	homosexuels
fantasy	fantasy
pascua	pâques
duques	ducs
lope	lope
monseñor	monseigneur
enseñanzas	enseignements
escasez	rareté
escasez	pénurie
criatura	créature
ernest	ernest
etimología	étymologie
coco	coco
traductores	traducteurs
bohemia	bohême
emblema	emblème
mayer	mayer
filtro	filtre
colectivos	collectifs
stalin	staline
parámetro	paramètre
génova	gênes
pétalos	pétales
spencer	spencer
size	size
craig	craig
representaba	représentait
karen	karen
misioneros	missionnaires
milagros	miracles
semanal	hebdomadaire
telecinco	telecinco
creadas	créées
registrados	enregistrés
catamarca	catamarca
garcia	garcia
alt	alt
vampiro	vampire
afirman	affirment
ultimate	ultimate
toulouse	toulouse
controlado	contrôlée
controlado	contrôlé
josh	josh
fruta	fruits
ralph	ralph
insignia	insigne
especializados	spécialisés
abandonada	abandonnée
ródano	rhône
barranco	ravin
suena	sonne
dictador	dictateur
vaca	vache
ward	ward
divididos	divisés
terminan	finissent
valverde	valverde
hábitos	habitudes
bestia	bête
quejas	plaintes
pájaro	oiseau
tracción	traction
residente	résident
discriminación	discrimination
see	see
pierna	jambe
intervenciones	interventions
edades	âges
diagrama	diagramme
iniciada	initiée
integrar	intégrer
miniserie	minisérie
enzima	enzyme
secuestro	enlèvement
muelle	jetée
padilla	padilla
monstruos	monstres
divino	divin
beck	beck
amanecer	aube
soportar	supporter
varían	varient
precipitación	précipitation
regalo	cadeau
evita	évite
adolescencia	adolescence
embarazo	grossesse
checo	tchèque
alejandría	alexandrie
duras	dures
zagreb	zagreb
candelaria	candelaria
sena	seine
erupción	éruption
roble	chêne
devoción	dévotion
cómico	comique
catolicismo	catholicisme
márgenes	marges
johannes	johannes
superman	superman
caen	caen
cid	cid
césped	pelouse
miel	miel
irene	irène
junín	junín
franquismo	franquisme
denver	denver
operadores	opérateurs
montgomery	montgomery
bird	bird
atraer	attirer
maximiliano	maximilien
electric	electric
pato	canard
francos	francs
lucy	lucy
durán	durán
apodado	surnommé
some	some
holmes	holmes
sydney	sydney
nfl	nfl
murphy	murphy
car	car
joel	joël
querétaro	querétaro
queensland	queensland
nacer	naître
cardenales	cardinaux
arácnido	arachnide
clarke	clarke
pesada	lourde
milagro	miracle
diamante	diamant
agencias	agences
creadores	créateurs
narración	récit
distribuido	distribué
ideales	idéaux
deutsche	deutsche
cal	chaux
frederick	frederick
asegura	assure
corrió	couru
refuerzos	renforts
aaron	aaron
agujero	trou
capturados	capturés
durango	durango
rechazado	rejeté
schmidt	schmidt
rendición	reddition
desaparecer	disparaître
artigas	artigas
decano	doyen
jung	jung
segmentos	segments
flecha	flèche
fabricado	fabriqué
caído	déchu
practicar	pratiquer
helicópteros	hélicoptères
disparar	tirer
nubes	nuages
bielorrusia	biélorussie
reich	reich
hierbas	herbes
sellos	timbres
animados	animés
evaluar	évaluer
madero	madero
prioridad	priorité
botón	bouton
observado	observé
panel	panneau
corregir	corriger
uva	raisin
aurelio	aurelio
emilia	émilie
pioneros	pionniers
carranza	carranza
know	know
boyacá	boyacá
modalidades	modalités
fibras	fibres
corral	corral
anarquista	anarchiste
ferreira	ferreira
patriarca	patriarche
claire	claire
evil	evil
mons	mons
run	run
seda	soie
combina	combine
andina	andine
children	children
henares	henares
jesse	jesse
johan	johan
multimedia	multimédia
andorra	andorre
disposiciones	dispositions
comisionado	commissaire
ibarra	ibarra
her	her
mueve	déplace
obrera	ouvrière
rogers	rogers
pollo	poulet
referéndum	référendum
recurrente	récurrents
bernardino	bernardino
helsinki	helsinki
continuamente	continuellement
hemisferio	hémisphère
sex	sex
peligroso	dangereux
registrada	enregistrée
portales	portails
emperatriz	impératrice
vestuario	vestiaire
egipcio	égyptien
pesados	lourds
panteón	panthéon
dignidad	dignité
paquetes	paquets
válido	valide
válido	valable
antonia	antonia
inaugura	inaugure
got	got
ilustrado	illustré
claras	claires
felicidad	bonheur
stefan	stefan
leandro	leandro
ceremonias	cérémonies
encarnación	incarnation
brillantes	brillants
barranquilla	barranquilla
apache	apache
iniciativas	initiatives
importa	importe
colabora	collabore
apareciendo	apparaissant
limitaciones	limitations
demostración	démonstration
fall	fall
congresos	congrès
próximas	prochaines
quechua	quechua
carros	chariots
embarazada	enceinte
levanta	lève
benedicto	benoît
butler	butler
excepcional	exceptionnel
excepcional	exceptionnelle
exiliados	exilés
hongos	champignons
arrestado	arrêté
poderosos	puissants
cameron	cameron
beat	beat
idh	idh
románica	romane
case	case
obligatorio	obligatoire
preliminar	préliminaire
darwin	darwin
manzana	pomme
estimaciones	estimations
inquisición	inquisition
demografía	démographie
hardcore	hardcore
afectada	affectée
catalanes	catalans
romántico	romantique
obligaciones	obligations
equipado	équipé
contaban	comptaient
neutralidad	neutralité
card	card
laboratorios	laboratoires
vial	flacon
componer	composer
birmania	birmanie
guionistas	scénaristes
pau	pau
andreas	andreas
homosexual	homosexuel
mitos	mythes
progresista	progressiste
reconocidas	reconnues
generado	généré
ábside	abside
matando	tuant
siberia	sibérie
consorcio	consortium
comercialización	commercialisation
mártires	martyrs
yellow	yellow
gimnasio	gymnase
internacionalmente	internationalement
hermoso	magnifique
dados	dés
ramiro	ramiro
linneo	linnaeus
provienen	proviennent
porteño	porteño
call	call
alcázar	alcazar
euro	euro
convencer	convaincre
octavio	octave
leído	lu
alimentan	nourrissent
bustamante	bustamante
chevrolet	chevrolet
erik	erik
marketing	marketing
acabado	finition
harina	farine
enviada	envoyée
delegados	délégués
sáenz	sáenz
audiovisual	audiovisuel
supera	dépasse
supera	surpasse
teodoro	théodore
madres	mères
permanecen	restent
precisa	précise
aplicado	appliqué
trabajador	travailleur
listo	prêt
mongolia	mongolie
müller	müller
mejorado	amélioré
votaciones	votes
avenidas	avenues
guitarristas	guitaristes
autopistas	autoroutes
mostraba	montrait
semestre	semestre
actrices	actrices
representados	représentés
diplomáticos	diplomates
descubren	découvrent
muebles	meubles
gobernó	gouverna
adquirida	acquise
sega	sega
exige	exige
cuencas	bassins
armstrong	armstrong
tel	tel
peruanos	péruviens
comerciante	commerçant
cuántica	quantique
obispado	évêché
anfitrión	hôte
chase	chase
protestante	protestant
incluyeron	incluaient
adaptaciones	adaptations
sepulcro	sépulcre
andrade	andrade
búlgaro	bulgare
gallegos	gallegos
michigan	michigan
amanda	amanda
eliminatorias	éliminatoires
detección	détection
proximidad	proximité
return	return
amantes	amoureux
amantes	amants
funeral	funérailles
semilla	graine
sobrevivientes	survivants
estratégico	stratégique
jules	jules
distribuida	distribuée
vergara	vergara
wallace	wallace
true	true
lucky	lucky
morning	morning
parma	parme
greco	gréco
cumbres	sommets
transportar	transporter
rca	rca
tyler	tyler
sugieren	suggèrent
confirma	confirme
playoffs	playoffs
coleoptera	coleoptera
demonios	démons
teórico	théorique
zúrich	zurich
libremente	librement
zulia	zulia
hart	hart
anuncios	annonces
dirigía	dirigeait
lane	lane
mate	matte
mate	mat
ayacucho	ayacucho
regnum	regnum
cortar	couper
glaciar	glacier
actúan	agissent
rodean	entourent
nombrados	nommés
terceros	tiers
protector	protecteur
panamericanos	panaméricains
its	its
zar	tsar
ordo	ordo
estambul	istanbul
phillips	phillips
josefa	josefa
herida	blessure
bautizado	baptisé
galaxias	galaxies
roles	rôles
judaísmo	judaïsme
térmica	thermique
patronales	patronales
pirata	pirate
tendrán	auront
hope	hope
reed	reed
want	want
ulloa	ulloa
manolo	manolo
resultante	résultante
patinaje	patinage
raramente	rarement
seven	seven
diseñados	conçus
vásquez	vasquez
indie	indie
trampa	piège
middle	middle
kid	kid
sousa	sousa
reorganización	réorganisation
bala	balle
harvey	harvey
ara	ara
madurez	maturité
nicole	nicole
ghana	ghana
caldas	caldas
conquistadores	conquérants
esqueleto	squelette
quijote	quichotte
candidaturas	candidatures
bienal	biennale
dominación	domination
recogida	collecte
hugh	hugh
panamericana	panaméricaine
privilegio	privilège
obviamente	évidemment
diploma	diplôme
defensiva	défensive
aprovechar	saisir
aprox	env
machado	machado
sandoval	sandoval
through	through
gibson	gibson
gatos	chats
beltrán	beltran
amplitud	amplitude
trajes	costumes
bonaparte	bonaparte
coca	coca
dragones	dragons
cubiertos	couverts
vientre	ventre
orgullo	fierté
sonda	sonde
salario	salaire
hito	jalon
trae	apporte
vallejo	vallejo
lès	lès
haro	haro
favorables	favorables
corregimiento	corregimiento
nadal	nadal
consolidación	consolidation
botones	boutons
breves	brèves
antoni	antoni
editoriales	éditoriaux
aeródromo	aérodrome
cono	cône
ferro	ferro
buscó	chercha
villar	villar
chuck	chuck
conquistador	conquérant
movilidad	mobilité
compatible	compatible
traer	apporter
arce	érable
reparación	réparation
compilación	compilation
gradualmente	progressivement
gradualmente	graduellement
aria	aria
sag	sag
excepciones	exceptions
muhammad	muhammad
mccartney	mccartney
tapa	couvercle
vinilo	vinyle
unificación	unification
licencias	licences
humo	fumée
escaleras	escaliers
fidel	fidel
divulgación	divulgation
diplomática	diplomatique
marne	marne
verticales	verticaux
controlada	contrôlée
farmacia	pharmacie
cuzco	cuzco
molécula	molécule
princeton	princeton
cruceros	croisières
pat	pat
greene	greene
ayer	hier
hesse	hesse
fierro	fierro
quiroga	quiroga
hueco	creux
lennon	lennon
wta	wta
ace	ace
misil	missile
legendario	légendaire
pescadores	pêcheurs
modernización	modernisation
nariz	nez
bicicleta	vélo
preparatoria	préparatoire
dávila	dávila
spanish	french
peñarol	peñarol
mares	mers
villarreal	villarreal
manila	manille
consideraban	considéraient
palmer	palmer
almacén	entrepôt
allmusic	allmusic
africanos	africains
mover	déplacer
renombrado	renommé
tolkien	tolkien
potable	potable
trek	trek
absolutamente	absolument
basura	ordures
bundesliga	bundesliga
económicamente	économiquement
transcripción	transcription
invisible	invisible
compositora	compositrice
tensiones	tensions
molinos	moulins
describen	décrivent
especialización	spécialisation
ultra	ultra
hernando	hernando
presidido	présidé
encarcelado	emprisonné
encarcelado	incarcéré
cohetes	roquettes
aquitania	aquitaine
phylum	phylum
certificación	certification
emocional	émotif
emocional	émotionnel
dialectos	dialectes
hábitats	habitats
patrocinio	parrainage
danubio	danube
owen	owen
lynch	lynch
estudiado	étudié
estudiado	étudiée
positivos	positifs
precedido	précédé
becker	becker
restaurar	restaurer
ochoa	ochoa
compresión	compression
ferias	foires
stan	stan
sullivan	sullivan
enseña	enseigne
espectador	spectateur
esther	esther
atractivos	attrayants
foster	foster
burdeos	bordeaux
bowl	bowl
adriana	adriana
reto	défi
happy	happy
acento	accent
warriors	warriors
ateneo	athénée
allan	allan
placer	plaisir
subtropicales	subtropicales
apropiado	approprié
sensible	sensible
morrison	morrison
mason	mason
sanción	sanction
drive	drive
controles	contrôles
marion	marion
letonia	lettonie
bucarest	bucarest
romanticismo	romantisme
lanzamientos	lancements
emily	emily
joyas	bijoux
inventor	inventeur
tortura	torture
preferencia	préférence
plantarum	plantarum
stark	stark
need	need
usaban	utilisaient
raw	raw
crema	crème
comparado	comparé
auxiliares	auxiliaires
colaborado	collaboré
vende	vend
koch	koch
granos	grains
recuperado	récupéré
invención	invention
neo	néo
motivación	motivation
músculos	muscles
acumulación	accumulation
indicando	indiquant
vector	vecteur
lanzados	lancés
bajar	descendre
déficit	déficit
nube	nuage
recaudación	recouvrement
pere	pere
continentes	continents
alcántara	alcántara
aparecía	apparaissait
recorrer	parcourir
subida	montée
subida	hausse
horno	four
chen	chen
rituales	rituels
trad	trad
shaw	shaw
curioso	curieux
servía	servait
originarios	originaires
surinam	suriname
sólidos	solides
zoológico	zoo
instalar	installer
sucesivas	successifs
sucesivas	successives
garza	garza
textil	textile
étnico	ethnique
duarte	duarte
lomas	lomas
dedo	doigt
boris	boris
claros	clairs
marcus	marcus
revolution	revolution
declive	déclin
descubrimientos	découvertes
afirmar	affirmer
esenciales	essentiels
artesanos	artisans
rae	rae
obtienen	obtiennent
completos	complets
rocío	rosée
intercontinental	intercontinental
rechaza	rejette
duke	duke
fidelidad	fidélité
proporciones	proportions
bass	bass
montserrat	montserrat
completas	complètes
tracks	tracks
portador	porteur
asesinos	tueurs
sostenible	durable
salvajes	sauvages
ruth	ruth
ninja	ninja
guaraní	guarani
tratamientos	traitements
regina	regina
next	next
verificar	vérifier
ultramar	outremer
intendencia	intendance
adrian	adrian
genio	génie
spears	spears
villano	méchant
bloqueos	blocages
pasta	pâte
dispara	tire
estrictamente	strictement
azar	hasard
drake	drake
ejercicios	exercices
gene	gene
cuadernos	cahiers
cuadernos	carnets
viejas	vieilles
sodio	sodium
andino	andin
robots	robots
heaven	heaven
retira	retire
impreso	imprimé
morfología	morphologie
veteranos	vétérans
sales	sels
comprendido	compris
say	say
mamá	maman
