que	que
del	do
los	os
por	por
con	com
las	as
una	uma
categoría	categoria
para	para
como	como
fue	foi
más	mais
sus	suas
sus	seus
también	também
entre	entre
the	the
#redirección	#redirecionamento
este	este
pero	mas
años	anos
dos	dois
son	são
sobre	envelope
año	ano
desde	desde
esta	esta
enlaces	ligações
hasta	até
externos	externos
externos	externas
ciudad	cidade
ser	ser
parte	parte
durante	durante
sin	sem
donde	onde
san	san
era	era
nacional	nacional
primera	primeira
está	está
team	team
cuando	quando
seed	seed
nombre	nome
estados	estados
utc	utc
siglo	século
después	depois
españa	espanha
tiene	tem
otros	outros
gran	grande
unidos	unidos
puede	pode
estado	estado
uno	um
primer	primeiro
así	assim
población	população
muy	muito
había	havia
mismo	mesmo
nueva	nova
fueron	foram
historia	história
club	clube
eran	eram
cual	qual
vez	vez
universidad	universidade
forma	forma
forma	formulário
tres	três
grupo	grupo
general	geral
guerra	guerra
aunque	embora
familia	família
además	além
todo	tudo
sur	sul
mayor	maior
tiempo	tempo
provincia	província
partido	partido
contra	contra
encuentra	encontra
municipio	município
otras	outras
todos	todos
juan	joão
josé	josé
bajo	baixo
serie	série
cada	cada
fútbol	futebol
equipo	equipe
norte	norte
río	rio
méxico	méxico
han	han
argentina	brazil
inglés	inglês
nuevo	novo
véase	ver
junto	junto
septiembre	setembro
octubre	outubro
segunda	segunda
ese	esse
discusión	discussão
gobierno	governo
condado	condado
final	final
final	fim
vida	vida
personas	pessoas
español	espanhol
centro	centro
julio	julho
hay	há
lincoln	lincoln
país	país
mientras	enquanto
web	web
internacional	internacional
santa	santa
antes	antes
oficial	oficial
oficial	agente
quien	quem
mundo	mundo
embargo	embargo
tanto	tanto
mayo	maio
algunos	alguns
temporada	temporada
mejor	melhor
luego	depois
marzo	março
día	dia
siendo	sendo
madrid	madrid
enero	janeiro
número	número
agosto	agosto
diciembre	dezembro
artículo	artigo
noviembre	novembro
otro	outro
estaba	estava
estos	estes
abril	abril
total	total
región	região
sistema	sistema
habitantes	habitantes
maría	maria
real	real
página	página
esto	isto
mundial	mundial
música	música
presidente	presidente
casa	casa
sólo	só
sólo	apenas
álbum	álbum
debido	devido
cuenta	conta
junio	junho
febrero	fevereiro
ella	ela
pueden	podem
varios	vários
francia	frança
solo	apenas
solo	só
chile	chile
tipo	tipo
obra	obra
iglesia	igreja
película	filme
entonces	então
banda	banda
cuatro	quatro
zona	área
televisión	televisão
principal	principal
tuvo	teve
carlos	carlos
otra	outra
rey	rei
premio	prêmio
hace	faz
km²	km²
edición	edição
tenía	tinha
premios	prêmios
sitio	site
futbolistas	futebolistas
bien	bem
segundo	segundo
mar	mar
poco	pouco
orden	ordem
estadounidense	americano
agua	água
tierra	terra
título	título
ellos	eles
earth	earth
están	estão
división	divisão
canción	canção
fecha	data
república	república
trabajo	trabalho
especie	espécie
luis	luis
unos	uns
caso	caso
dentro	dentro
obras	obras
color	cor
distrito	distrito
superficie	superfície
copa	copa
copa	copo
muchos	muitos
near	near
línea	linha
francisco	francisco
les	les
siguiente	próximo
área	área
grandes	grandes
censo	recenseamento
censo	censo
liga	liga
estas	estas
align	align
muerte	morte
política	política
menos	menos
largo	longo
largo	comprido
hijo	filho
hecho	feito
algunas	algumas
carrera	corrida
poder	poder
pueblo	povo
localidades	localidades
hizo	fez
veces	vezes
reino	reino
central	central
todas	todas
york	york
ejemplo	exemplo
género	gênero
padre	pai
isbn	isbn
campo	campo
isla	ilha
hacer	fazer
misma	mesma
ante	ante
conocido	conhecido
http	http
países	países
frente	frente
antonio	antónio
época	época
director	diretor
días	dias
española	espanhola
partir	partir
versión	versão
varias	várias
actual	atual
momento	momento
lista	lista
jpg	jpg
densidad	densidade
campeonato	campeonato
tarde	tarde
tienen	têm
ejército	exército
porque	porque
estación	estação
observatorio	observatório
aires	ares
actualmente	atualmente
desarrollo	desenvolvimento
escuela	escola
programa	programa
información	informações
información	informação
importante	importante
último	último
canciones	músicas
canciones	canções
uso	uso
uso	utilização
juegos	jogos
localidad	localidade
base	base
punto	ponto
posición	posição
esa	essa
alemania	alemanha
ubicación	localização
grupos	grupos
john	john
miembros	membros
pedro	pedro
capital	capitais
primeros	primeiros
teatro	teatro
cualquier	qualquer
datos	dados
manera	forma
laboratorio	laboratório
socorro	socorro
libro	livro
estudios	estúdios
estudios	estudos
diferentes	diferentes
barcelona	barcelona
nivel	nível
llamado	chamado
mayoría	maioria
unión	união
edad	idade
toda	toda
artículos	artigos
juego	jogo
arte	arte
especies	espécies
europa	europa
estilo	estilo
cine	cinema
proyecto	projeto
center	center
sea	seja
selección	seleção
costa	litoral
costa	costa
equipos	equipamentos
puesto	post
puesto	postar
origen	origem
museo	museu
puntos	pontos
perú	peru
militar	militar
américa	américa
ubicado	localizado
producción	produção
italia	itália
manuel	manuel
tener	ter
wikipedia	wikipédia
plantas	plantas
comenzó	começou
debe	deve
siempre	sempre
metros	metros
oro	ouro
posteriormente	posteriormente
casi	quase
construcción	construção
local	local
francés	francês
cultura	cultura
santiago	santiago
cerca	perto
estudio	estudo
principales	principais
usuario	usuário
com	com
finalmente	finalmente
cinco	cinco
anterior	anterior
cargo	cargo
batalla	batalha
derecho	direito
peak	peak
imagen	imagem
gracias	obrigado
cuales	quais
kitt	kitt
puerto	porto
torneo	torneio
mucho	muito
social	social
millones	milhões
comunidad	comunidade
fin	fim
acuerdo	acordo
lado	lado
colombia	colômbia
servicio	serviço
rock	rock
político	político
películas	filmes
ver	ver
fuera	fora
pesar	pesar
popular	popular
muchas	muitas
hoy	hoje
tal	tal
alto	alto
cuerpo	corpo
disco	disco
finales	finais
sociedad	sociedade
tema	assunto
dirección	endereço
hombres	homens
última	última
original	originais
original	original
new	new
estadio	estádio
ambos	ambos
miguel	miguel
ley	lei
oeste	oeste
mujeres	mulheres
obs	obs
incluso	mesmo
cambio	mudança
style	style
jugador	jogador
instituto	instituto
público	público
miembro	membro
pues	pois
superior	superior
media	meia
media	média
california	califórnia
parque	parque
tan	tão
llegó	chegou
archivo	arquivo
radio	rádio
ahora	agora
parís	paris
sería	seria
world	world
cruz	cruz
cest	cest
cabo	cabo
brasil	brasil
unido	unido
red	rede
aquí	aqui
canal	canal
movimiento	movimento
revista	revista
éxito	sucesso
relación	relacionamento
elecciones	eleições
plaza	praça
grande	grande
distribución	distribuição
compañía	companhia
islas	ilhas
proceso	processo
alrededor	aproximadamente
habían	haviam
musical	musical
primero	primeiro
territorio	território
encuentran	encontram
dice	diz
hombre	homem
león	leão
algo	alguma
algo	algo
voz	voz
década	década
madre	mãe
iii	iii
organización	organização
monte	monte
aún	ainda
decir	dizer
goles	gols
victoria	vitoria
sede	sede
importantes	importantes
resultado	resultado
china	chinesa
xix	xix
calle	rua
papel	papel
van	van
medios	mídia
dio	deu
aparece	aparece
empresa	empresa
fernando	fernando
don	don
propio	próprio
mapa	mapa
civil	civil
venezuela	venezuela
educación	educação
término	termo
convirtió	converteu
convirtió	transformou
llamada	chamada
ciudades	cidades
alta	alta
igual	igual
usa	usa
allí	lá
londres	londrina
londres	londres
tercera	terceira
edificio	edifício
fallecimiento	morte
fallecimiento	falecimento
fuerzas	forças
posible	possível
antiguo	antigo
natural	natural
álbumes	álbuns
paso	passo
mujer	mulher
fuerza	força
altura	altura
hijos	filhos
etc	etc
garcía	garcia
for	for
servicios	serviços
conocida	conhecida
estuvo	esteve
campeón	campeão
autor	autor
modo	modalidade
personajes	personagens
conjunto	conjunto
eso	isso
alemán	alemão
meses	meses
único	único
actor	ator
parece	parece
antigua	antiga
especial	especial
interior	interior
plata	prata
lemmon	lemmon
japón	japão
municipal	municipal
control	controle
control	controlo
consejo	dica
consejo	conselho
menor	menor
seis	seis
libre	livre
llegar	chegar
valle	vale
festival	filipe
personaje	personagem
principalmente	principalmente
david	davi
castillo	castelo
publicado	postado
cantante	cantora
cantante	cantor
referencia	referência
nació	nasceu
inglaterra	inglaterra
resto	resto
común	comum
editorial	editorial
deporte	desporto
recibió	recebeu
saint	saint
espacio	espaço
asociación	parceria
hija	filha
acción	ação
actores	atores
hermano	irmão
fundación	fundação
blanco	branco
profesional	profissional
episodio	episódio
cultural	cultural
principios	princípios
imperio	império
ganó	ganhou
dicho	dito
nunca	nunca
investigación	pesquisa
prefijo	prefixo
estar	estar
municipios	municípios
from	from
problemas	problemas
modelo	modelo
svg	svg
favor	favor
actividad	atividade
formación	formação
lugares	locais
éste	este
incluyendo	incluindo
realizó	realizou
planta	planta
período	período
montañas	montanhas
ronda	rodada
clase	turma
especialmente	especialmente
oficina	escritório
alcalde	prefeito
pasó	passou
estaban	estavam
longitud	comprimento
temas	tópicos
políticos	políticos
deportivo	desportivo
arquitectura	arquitetura
creación	criação
barrio	bairro
argentino	argentino
libros	livros
novela	romance
novela	novela
olímpicos	olímpicos
jorge	jorge
razas	raças
academia	academia
jefe	chefe
defensa	defesa
características	características
unas	umas
honor	honra
survey	survey
incluye	inclui
existen	existem
amor	amor
fuente	fonte
obtuvo	obteve
nuevos	novos
martín	martín
martín	martinho
situación	situação
nombrado	nomeado
existe	existe
ellas	elas
derechos	direitos
ministro	ministro
interés	juros
series	series
series	séries
texto	texto
escritores	escritores
actriz	atriz
persona	pessoa
capacidad	capacidade
artes	artes
participó	participou
cantidad	quantidade
fuentes	fontes
vista	vista
luz	luz
baja	baixa
border	border
paz	paz
tercer	terceiro
vuelta	volta
noche	noite
muestra	amostra
rusia	rússia
personal	pessoal
robert	robert
aeropuerto	aeroporto
apoyo	apoio
semana	semana
palacio	palácio
propia	própria
pacífico	pacífico
escritor	escritor
castilla	castela
profesor	professor
comuna	comuna
roma	roma
diseño	desenho
diseño	projeto
casos	casos
negro	preto
camino	caminho
ayuda	ajuda
nombres	nomes
podría	poderia
causa	causa
horario	horário
ciencias	ciências
últimos	últimos
tamaño	tamanho
principio	princípio
periodo	período
nacimiento	nascimento
nada	nada
etapa	etapa
etapa	estágio
actualidad	actualidade
pequeño	pequeno
santo	santo
zonas	zonas
zonas	áreas
lópez	lópez
referencias	referências
única	única
ediciones	edições
dios	deus
debut	estreia
presente	presente
congreso	congresso
guitarra	guitarra
guitarra	violão
australia	austrália
pablo	paulo
elementos	itens
elementos	elementos
relaciones	relacionamentos
compuesto	composto
horas	horas
ubicada	localizada
partes	peças
text	text
lengua	língua
diversos	diversos
militares	militares
torre	torre
dado	dado
actividades	atividades
nacionales	nacionais
cantón	cantão
nuevas	novas
sencillo	simples
federal	federal
participación	participação
fuerte	forte
italiano	italiano
primeras	primeiras
posee	possui
jugadores	jogadores
lleva	leva
seguridad	segurança
administración	administração
empresas	empresas
mercado	mercado
gonzález	gonzález
lucha	luta
estructura	estrutura
jesús	jesus
ocupación	ocupação
cet	cet
nacido	nascido
enrique	henrique
literatura	literatura
católica	católica
armas	armas
energía	energia
idioma	língua
valencia	valência
cabeza	cabeça
gobernador	governador
geográfica	geográfica
city	city
córdoba	córdoba
mes	mês
situado	localizado
diferencia	diferença
objetivo	alvo
ruta	caminho
economía	economia
histórico	histórico
india	índia
flores	flores
visita	visitar
conde	conde
fase	fase
william	william
resultados	resultados
nos	nos
niños	crianças
tales	tais
https	https
pequeña	pequena
presenta	apresenta
campaña	campanha
dar	dar
fernández	fernández
colegio	colégio
occidental	ocidental
aproximadamente	aproximadamente
ocasiones	ocasiões
tropas	tropas
sección	seção
sección	secção
presencia	presença
permite	permite
sentido	sentido
uruguay	uruguai
tenían	tinham
top	top
siete	sete
ets	dst
animales	animais
esposa	mulher
esposa	esposa
ríos	rios
logró	conseguiu
catalina	catarina
you	you
may	may
murió	morreu
bar	bar
medalla	medalha
función	função
usuarios	utilizadores
programas	programas
des	des
calidad	qualidade
artistas	artistas
similar	semelhante
similar	similar
nuestra	nossa
independencia	independência
buena	boa
sistemas	sistemas
significa	significa
paul	paul
virgen	virgem
transporte	transporte
pueblos	povos
rodríguez	rodríguez
coordenadas	coordenadas
vol	vol
valor	coragem
valor	valor
internacionales	internacionais
unidad	unidade
diversas	diversas
crear	criar
creo	acho
creo	acredito
imágenes	imagens
inicio	início
salud	saúde
contiene	contém
sierra	serra
será	será
idea	idéia
idea	ideia
llevó	levou
minutos	minutos
diego	diogo
verano	verão
sol	sol
teoría	teoria
revolución	revolução
entrada	entrada
mejores	melhores
mando	comando
decidió	decidiu
james	james
ciencia	ciência
dirigida	dirigida
dirigida	direcionada
records	records
aire	ar
sector	setor
importancia	importância
ataque	ataque
flora	flora
comunicación	comunicação
jean	jean
puente	ponte
matrimonio	casamento
material	material
volvió	voltou
humanos	humanos
mitad	metade
realidad	realidade
gente	gente
cámara	câmera
escudo	escudo
pérez	pérez
aguas	águas
alguna	alguma
acceso	acesso
clasificación	classificação
mano	mão
sigue	segue
cuya	cuja
sociales	sociais
problema	problema
trabajos	trabalhos
elegido	escolhido
independiente	independente
ningún	nenhum
futbolista	futebolista
comercial	comercial
metal	metal
diario	diário
palabra	palavra
carácter	caráter
falta	falta
reina	rainha
corte	corte
domingo	domingo
libertad	liberdade
vía	via
xviii	xviii
unidades	unidades
capitán	capitão
bgcolor	bgcolor
políticas	políticas
sevilla	sevilha
jugó	jogou
algún	algum
video	vídeo
considerado	atencioso
comisión	comissão
lima	lima
alberto	alberto
velocidad	velocidade
felipe	felipe
objetos	objectos
escribió	escreveu
ministerio	ministério
creado	criado
xvi	xvi
oriental	oriental
hermanos	irmãos
edificios	edifícios
tierras	terras
cosas	coisas
michael	michael
británico	britânico
áfrica	áfrica
izquierda	esquerda
cambios	mudanças
martínez	martinez
martínez	martínez
quedó	ficou
canadá	canadá
alfonso	afonso
lanzado	lançado
bandera	bandeira
videojuegos	videojogos
rica	rica
verde	verde
templo	templo
raza	raça
avenida	avenida
regional	regional
posterior	posterior
posterior	traseira
biblioteca	biblioteca
publicó	publicou
rojo	vermelho
títulos	títulos
utiliza	usa
dijo	disse
reporte	relatório
reporte	denúncia
blancos	brancos
diez	dez
ángel	anjo
ecuador	equador
señor	senhor
productos	produtos
portugal	portugal
salvador	salvador
manos	mãos
carretera	estrada
escrito	escrito
industria	indústria
entrenador	treinador
palabras	palavras
padres	pais
sánchez	sánchez
policía	polícia
líder	líder
fondo	fundo
pudo	pôde
productor	produtor
gira	vira
técnica	técnica
ninguna	nenhuma
príncipe	príncipe
áreas	áreas
press	press
encontrar	encontrar
plan	plano
artista	artista
formas	formulários
von	von
rafael	rafael
atlético	atlético
jun	jun
catedral	catedral
generalmente	geralmente
ayuntamiento	prefeitura
cuarto	quarto
saludos	saudações
temporadas	épocas
temporadas	temporadas
ambas	ambas
colección	colecção
colección	coleção
cadena	cadeia
cadena	corrente
music	music
reyes	reis
combate	combate
mayores	maiores
azul	azul
motivo	motivo
líneas	linhas
cuanto	quanto
pasado	passado
páginas	páginas
george	george
españoles	espanhóis
medida	medida
influencia	influência
lago	lago
conoce	conhece
condiciones	condições
oficiales	oficiais
left	left
hospital	hospital
ocho	oito
fuego	fogo
piedra	pedra
sub	sub
federación	federação
black	black
constitución	constituição
tratado	tratado
razón	razão
mil	mil
comercio	comércio
pop	pop
distancia	distância
estudiantes	estudantes
internet	internet
episodios	episódios
propiedad	propriedade
económica	econômico
marca	marca
tipos	tipos
baloncesto	basquetebol
contenido	conteúdo
todavía	ainda
inició	iniciou
anteriores	anteriores
haciendo	fazendo
sala	sala
map	map
estrella	estrela
viaje	viagem
rosa	rosa
dejó	deixou
jóvenes	jovens
realizado	realizado
formato	formato
formato	formatar
formato	formatação
tour	tour
prueba	teste
feb	fev
peso	peso
cómo	como
washington	washington
mal	errado
jersey	jersey
abr	abr
locales	locais
der	der
marco	marco
sep	sep
llega	chega
daniel	daniel
musicales	musicais
mount	mount
eduardo	eduardo
duque	duque
amigo	amigo
empezó	começou
evitar	evitar
emperador	imperador
restos	restos
restos	destroços
ingresos	receitas
santos	santos
obispo	bispo
pocos	poucos
mediados	meados
toma	pega
campos	campos
nov	nov
mexicano	mexicano
ésta	esta
europea	europeia
kilómetros	quilômetros
justicia	justiça
ago	ago
bastante	bastante
love	love
señora	senhora
deben	devem
dic	dic
ana	ana
naturales	naturais
alejandro	alexandre
publicación	publicação
figura	figura
soldados	soldados
blanca	branca
aves	aves
peter	peter
pie	pé
hora	hora
amigos	amigos
particular	particular
numerosos	numerosos
crítica	crítica
maestro	mestre
cuba	cuba
asia	ásia
casas	vivendas
motor	motor
efecto	efeito
completo	completo
trabajó	trabalhou
crecimiento	crescimento
doctor	doutor
pequeños	pequenos
autores	autores
junta	junta
europeo	europeu
nuevamente	novamente
grado	grau
buen	bom
facultad	faculdade
cataluña	catalunha
extremo	extremidade
tradicional	tradicional
derecha	direita
niño	menino
niño	criança
plantilla	modelo
votos	votos
banco	banco
consiguió	conseguiu
contrato	contrato
pintura	pintura
ruso	russo
cuenca	bacia
batería	bateria
diputados	deputados
pasa	passa
andrés	andré
máximo	máximo
deportes	desportos
representa	representa
recursos	recursos
misión	missão
compositor	compositor
corresponden	correspondem
futuro	futuro
ángeles	anjos
utilizado	utilizado
vicente	vicente
hacen	fazem
terminó	terminou
terminó	acabou
tecnología	tecnologia
with	with
trabajar	trabalhar
distintos	diferentes
considera	considere
tiempos	tempos
ramón	ramón
fiesta	festa
smith	smith
jardín	jardim
madera	madeira
inferior	inferior
clubes	clubes
mexicana	mexicana
solid	solid
incluyen	incluem
alcanzar	alcançar
hubo	houve
frontera	fronteira
hab	hab
atención	atenção
digital	digital
torres	torres
formó	formou
doble	dupla
referirse	referir
comandante	comandante
corazón	coração
esos	aqueles
secretario	secretário
charles	charles
letras	letras
lenguas	línguas
vivo	vivo
xvii	xvii
encuentro	encontro
obtener	obter
originalmente	originalmente
naturaleza	natureza
claro	claro
existencia	existência
man	man
guatemala	guatemala
bajos	baixos
aragón	aragão
juega	joga
rico	delicia
sonido	som
usar	usar
mensajes	mensagens
firme	firme
mesa	mesa
queda	fica
granada	granada
antiguos	antigos
pasar	passar
suele	costuma
objeto	objeto
objeto	objecto
generales	geral
formado	formado
apertura	abertura
geografía	geografia
análisis	análise
protección	proteção
géneros	gêneros
naciones	nações
familias	famílias
notas	notas
american	american
proyectos	projetos
white	white
funciones	funções
corona	coroa
apareció	apareceu
clima	clima
guillermo	guilherme
prensa	imprensa
escena	cena
provincial	provincial
versiones	versões
www	www
isabel	isabel
distintas	diferentes
gómez	gómez
numerosas	numerosas
puerta	porta
mario	mário
romano	romano
griego	grego
thomas	thomas
all	all
tuvieron	tiveram
habla	fala
cierto	verdade
crisis	crise
efectos	efeitos
memoria	memória
orquesta	orquestra
creó	criou
siglos	séculos
montaña	montanha
mantener	manter
#aaa	#aaa
austria	áustria
llegada	chegada
construido	construído
martin	martin
berlín	berlim
llama	chama
directamente	diretamente
lanzamiento	lançamento
comité	comitê
javier	javier
capilla	capela
probablemente	provavelmente
larga	longa
colspan	colspan
bolivia	bolívia
poeta	poeta
tradición	tradição
podía	podia
provincias	províncias
produce	produz
autónoma	autônoma
hojas	folhas
ricardo	ricardo
soviética	soviética
tomar	tomá
necesario	necessário
filosofía	filosofia
periodista	jornalista
texas	texas
jugar	jogar
operación	operação
produjo	produziu
papa	batata
papa	papa
latinos	latinos
firma	assinatura
nacionalidad	nacionalidade
patrimonio	património
regiones	regiões
poesía	poesia
hermana	irmã
decide	decide
alianza	aliança
respuesta	resposta
google	google
pruebas	testes
richard	richard
médico	médico
médico	médicos
metro	metrô
metro	metro
marina	marinha
eventos	eventos
exterior	exterior
músicos	músicos
británica	britânica
visto	visto
estudió	estudou
aquellos	aqueles
suiza	suíça
coronel	coronel
parroquia	paróquia
física	física
dan	dan
presentó	apresentou
anteriormente	anteriormente
práctica	prática
grecia	grécia
zaragoza	saragoça
exposición	exposição
aquel	aquele
cuadro	quadro
fundada	fundada
enfermedad	doença
nba	nba
colonia	colônia
díaz	díaz
pequeñas	pequenas
nación	nação
show	show
national	national
anunció	anunciou
extensión	extensão
régimen	regime
dinero	dinheiro
ahí	aí
suelo	solo
descritas	descritas
aparición	aparição
operaciones	operações
concepto	conceito
estatal	estadual
calles	ruas
encontraba	encontrava
hechos	fatos
ambiente	ambiente
pronto	logo
gestión	gestão
hall	hall
recibe	receba
salida	saída
capítulo	capítulo
italiana	italiana
acciones	ações
pertenece	pertence
cristo	cristo
medicina	medicina
evolución	evolução
alcanzó	alcançou
modelos	modelos
venta	venda
tomó	pegou
fundador	fundador
river	river
piano	piano
procedencia	origem
roberto	roberto
mismos	mesmos
ganar	ganhar
pintor	pintor
evento	evento
campeonatos	campeonatos
alemana	alemã
rosario	rosário
menores	menores
solamente	somente
pertenecían	pertenciam
hispanos	hispânicos
conocimiento	conhecimento
conocer	conhecer
términos	termos
debajo	abaixo
generación	geração
bronce	bronze
tabla	tabela
vio	viu
armada	armada
armada	marinha
pareja	casal
producto	produto
territorios	territórios
gol	gol
institución	instituição
ingeniero	engenheiro
luna	lua
reconocimiento	reconhecimento
península	península
escrita	escrita
organizaciones	organizações
bahía	bahia
adelante	adiante
asamblea	assembléia
cerro	cerro
cerro	morro
enlace	ligação
till	till
traducción	tradução
hicieron	fizeram
máxima	máxima
contaba	contava
tracking	tracking
fundado	fundado
paraguay	paraguai
alguien	alguém
ganador	vencedor
estrellas	estrelas
sangre	sangue
resistencia	resistência
continuación	continuação
conflicto	conflito
software	software
volumen	volume
vuelve	volta
xxi	xxi
aérea	aérea
técnico	técnico
humano	humano
dirigido	dirigido
consecuencia	consequência
colaboración	colaboração
aparecen	aparecem
colores	cores
falleció	faleceu
per	per
materiales	materiais
carta	carta
centros	centros
categorías	categorias
curso	curso
tenido	tido
fiestas	festas
simplemente	simplesmente
japonés	japonês
opinión	opinião
franco	franco
temperatura	temperatura
propuesta	proposta
eds	eds
decreto	decreto
decisión	decisão
concepción	conceição
concepción	concepção
cara	cara
carolina	carolina
lee	leia
lee	lee
botánica	botânica
maria	maria
editor	editor
polonia	polónia
hogar	repouso
experiencia	experiência
mantuvo	manteve
abierto	aberto
noroeste	noroeste
participantes	participantes
instituciones	instituições
monasterio	mosteiro
castro	castro
sean	sean
amerindios	ameríndios
suecia	suécia
inicialmente	inicialmente
nota	nota
concurso	concurso
seguir	seguir
seguir	continuar
marqués	marquês
altitud	altitude
dólares	dólares
actuación	atuação
peces	peixes
ascenso	ascensão
planeta	planeta
israel	israel
marcha	marcha
representación	representação
turismo	turismo
publicaciones	publicações
ingeniería	engenharia
frecuencia	frequência
semanas	semanas
basado	baseado
saber	saber
olímpico	olímpico
utilizar	usar
piezas	peças
participar	participar
poner	colocar
poner	pôr
corea	coréia
borrado	apagar
carmen	carmen
creada	criada
religión	religião
técnicas	técnicas
estaciones	estações
escuelas	escolas
elección	eleição
elección	escolha
clases	aulas
completamente	completamente
relacionados	relacionados
vuelo	voo
xiii	xiii
parlamento	parlamento
titular	manchete
titular	titular
deja	deixa
florida	flórida
habría	teria
económico	econômico
descrito	descrito
rápidamente	rapidamente
sabe	sabe
nave	navio
isleños	ilhéus
posibilidad	possibilidade
destaca	destaques
html	html
anderson	anderson
directo	direto
usado	usado
sucesor	sucessor
presidencia	presidência
contrario	contrário
totalmente	totalmente
andalucía	andaluzia
oficialmente	oficialmente
volver	voltar
autoridades	autoridades
pista	faixa
botánico	botânico
iglesias	igrejas
composición	composição
método	método
concierto	concerto
cuarta	quarta
agricultura	agricultura
par	par
capaz	capaz
viejo	velho
tratamiento	tratamento
palomar	pombal
especiales	especiais
nueve	nove
bosque	floresta
ganado	ganhado
carga	carregar
quiere	quer
letra	letra
debutó	estreou
necesidad	necessidade
diócesis	diocese
dejar	deixar
consiste	consiste
registro	registo
regreso	retorno
duración	duração
complejo	complexo
acto	ato
life	life
indica	indica
fundó	fundou
bandas	bandas
voto	voto
nicolás	nicolau
arquitecto	arquiteto
convierte	converte
solar	solar
perdió	perdeu
playa	praia
rango	intervalo
cantantes	cantores
arriba	topo
latina	latina
femenino	feminino
regresó	voltou
instalaciones	instalações
vive	mora
cosa	coisa
louis	louis
derrota	derrota
vii	vii
king	king
sola	sozinha
basada	baseado
césar	césar
castellano	castelhano
urbano	urbano
destacan	destaques
international	international
forman	forman
oriente	oriente
campeones	campeões
leyes	leis
estructuras	estruturas
entrevista	entrevista
niveles	níveis
arco	arco
justo	justo
ficción	ficção
right	right
socialista	socialista
art	art
administrativa	administrativa
difícil	difícil
one	one
novelas	novelas
novelas	romances
conocidos	conhecidos
super	super
discos	discos
simple	simples
listas	listas
sebastián	sebastião
histórica	histórica
diputado	deputado
ideas	ideias
ideas	idéias
ojos	olhos
continuó	continuou
músico	músico
busca	procura
números	números
destino	destino
comarca	comarca
vasco	vasco
contacto	contato
reforma	reforma
teniendo	tendo
carreras	carreiras
single	single
expedición	expedição
invierno	inverno
llegaron	chegaram
nadie	ninguém
diferente	diferente
park	park
romana	romana
barrios	bairros
cree	acredita
ofrece	oferece
navarra	navarra
lanzó	lançou
relevancia	relevância
ancho	largura
grabación	gravação
esas	essas
boca	boca
panamá	panamá
universal	universal
completa	completa
producido	produzido
negra	preta
dando	dando
variedad	variedade
dominio	domínio
trabajadores	trabalhadores
star	star
valores	valores
propios	próprios
movimientos	movimentos
océano	oceano
promedio	média
árabe	árabe
aplicación	aplicativo
aplicación	aplicação
ámbito	escopo
ámbito	âmbito
refiere	refere
famoso	famoso
interpretación	interpretação
competición	competição
compuesta	composta
publicada	postada
publicada	publicada
terreno	terreno
respectivamente	respectivamente
entró	entrou
similares	similares
similares	semelhantes
construir	construir
toledo	toledo
periódico	jornal
noticias	notícias
miss	miss
normalmente	normalmente
trayectoria	trajeto
trayectoria	trajectória
piloto	piloto
unió	juntou
abogado	advogado
chicago	chicago
figuras	figuras
clásico	clássico
ópera	ópera
candidato	candidato
debería	deveria
desarrollado	desenvolvido
municipales	municipais
designado	nomeado
designado	designado
activo	ativo
irlanda	irlanda
detrás	atrás
llegando	chegando
xii	xii
descripción	descrição
aspecto	aparência
málaga	málaga
realizada	realizado
vídeo	vídeo
presión	pressão
henry	henry
conciertos	concertos
vecinos	vizinhos
lorenzo	lourenço
federico	frederico
competencia	concorrência
sky	sky
punta	dica
punta	ponta
fórmula	fórmula
núcleo	núcleo
illinois	illinois
galería	galeria
puso	botou
humana	humana
iba	ia
cambiar	mudar
nelson	nelson
asturias	astúrias
verdad	verdade
une	une
joaquín	joaquim
juventud	juventude
golpe	batida
avión	avião
estadounidenses	americanos
masa	massa
bosques	florestas
joseph	joseph
bienes	bens
egipto	egito
moderna	moderna
intento	tentativa
textos	textos
presentación	apresentação
muerto	morto
escribir	escrever
reserva	reserva
live	live
árboles	árvores
culturales	culturais
estableció	estabeleceu
comienzo	começo
denominación	denominação
hábitat	habitat
lenguaje	linguagem
unidas	unidas
asistencia	assistência
judíos	judeus
expresión	expressão
inicial	inicial
ejecutivo	executivo
portugués	português
bélgica	bélgica
órdenes	ordens
ignacio	ignacio
dirigió	dirigiu
torneos	torneios
corto	curto
chileno	chileno
populares	populares
usando	usando
science	science
hotel	hotel
clara	clara
normal	normal
tampoco	tampouco
búsqueda	pesquisa
sello	carimbo
revistas	revistas
teniente	tenente
investigaciones	investigações
álvarez	alvarez
álvarez	álvarez
mark	mark
file	file
mendoza	mendoza
comerciales	comerciais
titulado	intitulado
residencia	residência
jazz	jazz
indígenas	indígenas
massachusetts	massachusetts
jack	jack
café	café
podemos	podemos
hierro	ferro
nuestro	nosso
latín	latim
oposición	oposição
vías	vias
árbol	árvore
global	global
suelen	costumam
escala	escala
salió	saiu
bueno	bom
muertos	mortos
valladolid	valladolid
bogotá	bogotá
reales	reais
posteriores	posteriores
comunidades	comunidades
pierre	pierre
marcos	marcos
vivir	viver
die	die
fama	fama
united	united
permitió	permitiu
gabriel	gabriel
debía	devia
votación	votação
biografía	biografia
biografía	cronologia
vino	vinho
alonso	alonso
caída	queda
sonora	sonora
visión	visão
hacía	fazia
arena	areia
límite	limite
entrar	entrar
pese	pese
noruega	noruega
canales	canais
materia	matéria
roja	vermelha
data	data
regular	regular
promoción	promoção
discográfica	gravadora
salir	sair
autoridad	autoridade
bellas	belas
caracas	caracas
comenzaron	começaram
pasando	passando
demasiado	demais
accidente	acidente
image	image
manga	cambada
manga	manga
medidas	medidas
siguió	seguiu
dejando	deixando
críticas	críticas
bajas	baixas
asuntos	assuntos
aviones	aviões
conquista	conquista
disputó	disputou
estoy	estou
cuartos	quartos
células	células
alemanes	alemães
laguna	lagoa
montevideo	montevidéu
protagonista	protagonista
pérdida	perda
corresponde	corresponde
alma	alma
caballero	cavaleiro
retiro	aposentadoria
enciclopedia	enciclopédia
jaime	jaime
dinastía	dinastia
aspectos	aspectos
procesos	processos
salón	salão
ataques	ataques
tony	tony
breve	breve
zip	zip
universo	universo
imperial	imperial
sitios	sites
bot	bot
emisión	emissão
abajo	abaixo
múltiples	múltiplos
múltiples	múltiplas
homenaje	homenagem
guardia	guarda
miles	milhares
pantalla	tela
pantalla	ecrã
convento	convento
allá	lá
clásica	clássica
clásica	clássico
grabado	gravura
considerada	atenciosa
corriente	corrente
quinto	quinto
legislatura	legislatura
puertas	portas
ruiz	ruiz
disponible	disponível
disponible	disponivel
ocasión	ocasião
mantiene	mantém
dulce	doce
óscar	óscar
tribunal	tribunal
profesores	professores
posiciones	posições
últimas	últimas
honduras	honduras
conferencia	conferência
tom	tom
dvd	dvd
comentarios	comentários
reinado	reinado
royal	royal
naval	naval
científico	cientista
plano	plano
oportunidad	oportunidade
documentos	originais
documentos	documentos
viene	vem
anual	anuais
anual	anual
elemento	elemento
destacado	destaque
universitario	universitário
time	time
actos	atos
west	west
species	species
agustín	agustín
agustín	agostinho
vega	vega
infantil	infantil
escenario	palco
comienzos	começos
brown	brown
flota	frota
clave	chave
css	css
atlántico	atlântico
alexander	alexander
habita	habita
condición	condição
desarrolló	desenvolveu
jones	jones
construida	construída
moscú	moscovo
hernández	hernández
profesionales	profissionais
quién	quem
cuestión	questão
aumento	aumento
encontrado	encontrado
mejorar	melhorar
comunes	comuns
víctor	vitor
youtube	youtube
públicos	públicos
rojas	rojas
caja	caixa
guerras	guerras
formada	formada
cabecera	cabeçalho
rowspan	rowspan
territorial	territorial
declaró	declarou
var	var
recién	recém
responsable	responsável
cortes	cortes
guadalajara	guadalajara
dedicado	dedicado
org	org
ciclo	ciclo
incluido	incluído
señal	sinal
amplia	ampla
williams	williams
murcia	múrcia
vehículos	veículos
und	und
aquella	aquela
hungría	hungria
civiles	civis
liberal	liberal
catalán	catalão
intención	intenção
tropical	tropical
ejemplos	exemplos
secundaria	secundário
masculino	masculino
altos	altos
xiv	xiv
realmente	realmente
encontró	encontrou
doce	doze
americano	americano
burgos	burgos
siguiendo	seguindo
recientemente	recentemente
instrumento	ferramenta
salamanca	salamanca
ayudar	ajudar
portada	capa
identidad	identidade
pasajeros	passageiros
suficiente	suficiente
suficiente	chega
mezcla	mistura
buscar	pesquisar
infantería	infantaria
construyó	construiu
culto	culto
historias	histórias
duda	duda
duda	duvida
duda	dúvida
big	big
actuales	atuais
pies	pés
ida	ida
presentan	apresentam
utilizan	utilizam
metropolitana	metropolitana
url	url
recorrido	percurso
comunista	comunista
leyenda	lenda
comedia	comédia
barco	navio
mañana	amanhã
tomás	tomás
fotografía	fotografia
romanos	romanos
resulta	resulta
etiqueta	rótulo
ohio	ohio
cable	cabo
propias	próprias
mensaje	mensagem
hugo	hugo
altas	altas
décadas	décadas
poderes	poderes
permanente	permanente
anime	anime
antiguas	antigas
química	química
plataforma	plataforma
razones	razões
poblaciones	populações
potencia	potência
espíritu	espírito
pro	pro
artístico	artístico
house	house
vivió	viveu
rol	função
tren	comboio
juvenil	juvenil
misiones	missões
princesa	princesa
college	college
audiencia	audiência
audiencia	platéia
entrega	entrega
valign	valign
coleóptero	coleóptero
invasión	invasão
límites	limites
enseñanza	ensino
asteroides	asteróides
correspondiente	correspondente
reconocido	reconhecido
corta	curta
reunión	reunião
ocupa	ocupa
estándar	padrão
representantes	representantes
frank	frank
programación	programação
entidad	entidade
compañeros	companheiros
animal	animal
recibido	recebido
grand	grand
escultura	escultura
saga	saga
destacar	destaque
motivos	motivos
espacios	espaços
introducción	introdução
fuertes	fortes
bases	bases
sureste	sudeste
bretaña	bretanha
chino	chinês
viii	viii
récord	recorde
fauna	fauna
raíz	raiz
profundidad	profundidade
sirve	serve
crea	cria
científicos	cientistas
cabe	cabe
universidades	universidades
termina	acaba
ciudadanos	cidadãos
símbolo	símbolo
copias	cópias
virginia	virgínia
descrita	descrita
primaria	primário
distritos	distritos
rápido	rápido
list	list
moderno	moderno
eléctrica	elétrica
zelanda	zelândia
moreno	moreno
destacados	destaque
destacados	destaques
utilizando	usando
pocas	poucas
paulo	paulo
pobreza	pobreza
fachada	fachada
error	erro
ministros	ministros
ventas	vendas
conservación	conservação
cambió	mudou
interpretó	interpretou
scott	scott
mucha	muita
contexto	contexto
propiedades	propriedades
historiador	historiador
enfermedades	doenças
prácticamente	praticamente
cola	cauda
exteriores	exteriores
constante	constante
asesinato	assassinato
cádiz	cádis
celebra	comemora
recibir	receber
juntos	juntos
individuales	individuais
fábrica	fábrica
machos	machos
title	title
hacienda	fazenda
hacienda	finanças
paris	paris
chan	chan
chilena	chilena
sufrió	sofreu
restauración	restauração
roca	rocha
cargos	cobranças
cargos	acusações
prisión	prisão
sale	sai
dirigente	dirigente
dedicada	dedicada
mismas	mesmas
religiosos	religiosos
pintores	pintores
filipinas	filipinas
privada	privada
intervención	intervenção
juicio	julgamento
escenas	cenas
europeos	europeus
permaneció	permaneceu
documental	documentário
ascendencia	ascendência
expansión	expansão
convertido	converso
entrenadores	treinadores
igualmente	igualmente
tradicionales	tradicionais
cápita	capita
pan	pão
quinta	quinta
trono	trono
noreste	nordeste
inmediatamente	imediatamente
riesgo	risco
desambiguación	desambiguação
hablar	falar
inicia	inicia
ermita	ermida
caza	caça
reacción	reação
llamados	chamados
humanidad	humanidade
guerrero	guerreiro
seguido	seguido
tramo	trecho
uefa	uefa
representante	representante
empieza	começa
rugby	rugby
chris	chris
dakota	dakota
galicia	galiza
comprende	compreende
max	max
pensilvania	pensilvânia
cubierta	coberta
caribe	caraíbas
perfil	perfil
escocia	escócia
png	png
definición	definição
simon	simon
establecer	definir
amarillo	amarelo
piel	pele
sergio	sérgio
primavera	primavera
mariano	mariano
gas	gás
that	that
solución	solução
diferencias	diferenças
dominicana	dominicana
dimensiones	dimensões
objetivos	objetivos
fusión	fusão
coro	coro
eje	eixo
america	america
pone	coloca
mary	mary
regimiento	regimento
formando	formando
nacidos	nascidos
php	php
canto	canto
licencia	licença
idiomas	línguas
ocupó	ocupou
directa	direta
viena	viena
bolívar	bolívar
posiblemente	possivelmente
continente	continente
cartas	cartas
corrientes	correntes
poemas	poemas
presentado	apresentado
facebook	facebook
palma	palma
enemigo	inimigo
cielo	céu
dinamarca	dinamarca
excepto	exceto
minnesota	minnesota
producir	produzir
pico	pico
conserva	conserva
arma	arma
religiosa	religiosa
cementerio	cemitério
resolución	resolução
peña	peña
violencia	violência
describe	descreve
terminología	terminologia
adaptación	adaptação
voces	vozes
utilizada	utilizada
utilizada	usada
bob	bob
individual	individual
soy	sou
once	onze
descubiertos	descobertos
esperanza	esperança
consumo	consumo
compañero	parceiro
medieval	medieval
amplio	amplo
teresa	teresa
firmó	assinou
agente	agente
alumnos	alunos
cuentos	contos
impacto	impacto
alfredo	alfredo
trabajando	trabalhando
emilio	emilio
kansas	kansas
blue	blue
secreto	segredo
propósito	finalidade
colombiano	colombiano
inferiores	inferiores
llamó	chamou
north	north
peligro	perigo
arroyo	ribeiro
latino	latino
rama	rama
argentinos	argentinos
característica	característica
raúl	raul
mantenimiento	manutenção
morales	morais
dieron	deram
estudiar	estudar
society	society
society	sociedade
comentario	comentário
ramírez	ramirez
circuito	circuito
sexual	sexual
libres	livres
planes	planos
jackson	jackson
enemigos	inimigos
fácil	fácil
silva	silva
compositores	compositores
diámetro	diâmetro
éxitos	sucessos
éxitos	êxitos
artística	artística
victorias	vitórias
puestos	posts
podían	podiam
pieza	peça
científica	cientista
guía	guia
podrían	poderiam
arturo	artur
superiores	superiores
frase	frase
cuerpos	corpos
renta	renda
negocios	negócios
ben	ben
excepción	exceção
gustavo	gustavo
nace	nasce
funcionamiento	funcionamento
griega	grega
víctimas	vítimas
conoció	conheceu
cita	citação
terminar	terminar
guitarrista	guitarrista
ciertos	certos
turquía	turquia
triunfo	vitória
llegado	chegado
walter	walter
young	young
cristianos	cristãos
gutiérrez	gutiérrez
cantabria	cantábria
descubierto	descoberto
cáncer	câncer
métodos	métodos
delantero	atacante
suroeste	sudoeste
indiana	indiana
puebla	puebla
trabaja	trabalha
min	min
caballeros	cavalheiros
caballeros	cavaleiros
minas	minas
comportamiento	comportamento
sucedió	aconteceu
originales	originais
nuclear	nuclear
billboard	billboard
escritos	escritos
santander	santander
viento	vento
americana	americana
group	group
normas	regras
sectores	setores
cónyuge	cônjuge
espectadores	espectadores
rusa	russa
salas	salas
peruano	peruano
liberación	libertação
pez	peixe
quería	queria
atenas	atenas
momentos	momentos
fifa	fifa
aplicaciones	aplicações
limita	restringe
limita	limita
intenta	tenta
air	air
georgia	geórgia
hielo	gelo
caballo	cavalo
steve	steve
significado	significado
cinturón	cinto
cordillera	cordilheira
judicial	judiciário
crítico	crítico
sirvió	serviu
interpretado	interpretado
mis	meus
motores	motores
posibles	possíveis
ganadores	vencedores
pilotos	pilotos
mike	mike
foto	foto
wilson	wilson
británicos	britânicos
joe	joe
sueño	sonho
guinea	guiné
informe	relatório
treinta	trinta
tráfico	tráfego
contó	contou
órgano	órgão
medallas	medalhas
constituye	constitui
archivos	arquivos
archivos	ficheiros
fechas	datas
south	south
dobles	duplas
directores	diretores
físico	físico
democracia	democracia
mediterráneo	mediterrâneo
opción	opção
perdido	perdido
notable	notável
tengo	tenho
legal	legal
tercero	terceiro
enorme	enorme
constitucional	constitucional
plazo	prazo
católicos	católicos
escritura	escrita
escritura	escrever
cuyos	cujos
estadísticas	estatísticas
documento	documento
críticos	críticos
iowa	iowa
cristiana	cristã
ordenó	ordenou
oscar	oscar
transmisión	transmissão
carne	carne
poetas	poetas
ucrania	ucrânia
desarrollar	desenvolver
ocurre	acontece
enviado	enviado
muestran	mostram
street	street
vehículo	veículo
reparto	elenco
producida	produzida
producida	produzido
círculo	círculo
harry	harry
ciertas	certas
alimentos	alimentares
alimentos	alimentos
urbana	urbana
participa	participa
association	association
casado	casado
semifinales	semifinais
abierta	aberta
agencia	agência
popularidad	popularidade
votar	votar
pinturas	tintas
terminal	terminal
iniciativa	iniciativa
ffffff	ffffff
estreno	estreia
london	london
localización	localização
fortaleza	fortaleza
deriva	deriva
democrática	democrática
democrática	democrático
marido	marido
electrónica	eletrônica
cristóbal	cristóvão
your	your
herrera	herrera
buques	navios
diccionario	dicionário
profesión	profissão
consulta	consulta
historiadores	historiadores
mitología	mitologia
debate	debate
debate	debates
perder	perder
dedicó	dedicou
componentes	componentes
belleza	beleza
descubre	descobre
jiménez	jiménez
personales	pessoais
ácido	ácido
veo	vejo
cumplir	cumprir
infancia	infância
líderes	líderes
espacial	espacial
predecesor	antecessor
oscuro	escuro
verdadero	verdadeiro
segundos	segundos
margen	margem
cañón	canhão
religioso	religioso
net	net
zamora	zamora
relativamente	relativamente
columna	coluna
high	high
danza	dança
veinte	vinte
desarrolla	desenvolve
periodistas	jornalistas
asunción	assunção
fondos	fundos
llevan	levam
factores	fatores
barcos	barcos
salvo	salvo
chica	menina
chica	garota
precio	preço
pensamiento	pensamento
leer	leia
declaración	declaração
deportistas	atletas
mala	má
asesinado	assassinado
argumento	argumento
online	online
portal	portal
médicos	médicos
sacerdote	sacerdote
night	night
nicaragua	nicarágua
regionales	regionais
rodrigo	rodrigo
arzobispo	arcebispo
mancha	mancha
conocidas	conhecidas
retirado	aposentado
inteligencia	inteligência
realizan	realizam
envió	enviou
baile	dança
fundamental	fundamental
disney	disney
relevante	relevante
fox	fox
serían	seriam
paseo	passeio
albert	albert
menciona	menciona
green	green
famosa	famosa
abandonó	abandonou
obtiene	obtém
brian	brian
romero	alecrim
espera	espera
encargado	mantenedor
compañías	companhias
retiró	aposentou
actuaciones	actuações
diseñado	projetado
reciente	recente
intereses	juros
senado	senado
mercedes	mercedes
christian	christian
johnson	johnson
edward	edward
esteban	estêvão
introduction	introduction
coros	coros
vicepresidente	vice
plantillas	moldes
plantillas	modelos
canarias	canárias
disputa	disputa
ave	ave
astronómicos	astronómicos
post	post
participaron	participaram
globo	balão
valenciana	valenciana
den	den
orígenes	origens
éstos	estes
económicos	econômico
aliados	aliados
rally	rali
detalles	detalhes
salto	salto
state	state
marine	fuzileiro
bilbao	bilbau
rivera	rivera
universitaria	universitária
roger	roger
colonial	colonial
competiciones	competições
dictadura	ditadura
tenga	tenha
medina	medina
difusión	divulgação
alcanza	alcança
ejecución	execução
ensayo	ensaio
lucas	lucas
independientes	independentes
joan	joan
boston	boston
reglas	regras
viernes	sexta
suerte	sorte
golfo	golfo
nobles	nobres
augusto	augusto
radical	radical
yucatán	yucatán
establecido	estabelecido
bruselas	bruxelas
mandato	mandato
trenes	comboios
feria	feira
comida	comida
apellido	sobrenome
etapas	etapas
etapas	fases
comunas	comunas
seguro	seguro
fotos	fotos
amistad	amizade
entra	entra
hill	hill
particularmente	particularmente
extranjeros	estrangeiros
artillería	artilharia
concentración	concentração
contar	contar
abrió	abriu
máquina	máquina
frecuentemente	frequentemente
lagos	lagos
montes	montes
hot	hot
usan	usam
fruto	fruto
manual	manual
coche	carro
bernardo	bernardo
brasileño	brasileiro
terrenos	terrenos
terrenos	terreno
miranda	miranda
ceremonia	cerimônia
columbia	columbia
lejos	afastado
conflictos	conflitos
integrantes	integrantes
alicante	alicante
pregunta	pergunta
drama	drama
juez	juiz
familiares	família
patrón	padrão
requiere	requer
this	this
afirma	afirma
ala	asa
ala	ala
continental	continental
endémica	endémica
taylor	taylor
sexo	sexo
presentes	presentes
miami	miami
celebración	comemoração
day	day
previamente	anteriormente
mínimo	mínimo
macdonald	macdonald
abarca	abrange
literaria	literária
milán	milão
tomo	pego
descenso	descida
descritos	descritos
viajes	viagens
bloqueo	bloqueio
empleados	empregados
dada	dada
batallas	batalhas
demanda	procura
demanda	demanda
agrupación	agrupamento
fenómeno	fenômeno
continuar	continuar
paredes	paredes
jurado	júri
can	can
tenemos	temos
muñoz	muñoz
permiten	permitem
empleo	emprego
usos	utilizações
confederación	confederação
upper	upper
suárez	suárez
cabezas	cabeças
misuri	missouri
agrícola	agrícola
continúa	continua
parecer	parecer
opera	opera
aniversario	aniversário
coleópteros	coleópteros
niña	menina
terremoto	terremoto
terremoto	terramoto
casco	capacete
factor	fator
hollywood	hollywood
suma	soma
oxford	oxford
acabó	acabou
deseo	desejo
ejemplares	exemplares
gonzalo	gonçalo
buque	navio
diciendo	dizendo
siguen	seguem
ausencia	ausência
lanza	lança
wheeler	wheeler
coalición	coligação
naves	naves
realización	realização
interna	interna
personalidad	personalidade
félix	félix
bill	bill
flor	flor
marcó	marcou
jugando	jogando
celebró	realizou
alas	asas
jardines	jardins
muro	parede
grados	graus
santuario	santuário
township	township
destrucción	destruição
empresario	empresário
regresar	voltar
entrenamiento	treinamento
izquierdo	esquerdo
propietario	proprietário
intentó	tentou
nacida	nascida
llegan	chegam
claramente	claramente
molina	molina
cañones	canhões
marie	marie
poseen	possuem
pasos	passos
descubrimiento	descoberta
retirada	retirada
ciclista	ciclista
catálogo	catálogo
revisión	revisão
tarea	tarefa
extranjero	estrangeiro
anna	anna
divide	dividir
divisiones	divisões
vieja	velha
abandonar	abandonar
espectáculo	espetáculo
organismos	organismos
indios	índios
journal	journal
irán	irã
grave	grave
héctor	heitor
habana	havana
punk	punk
caracteriza	caracteriza
organismo	organismo
puedan	puderem
seres	seres
encuentros	encontros
auto	carro
ford	ford
columnas	colunas
clásicos	clássicos
comunicaciones	comunicações
elena	helena
productores	produtores
secciones	secções
secciones	seções
guzmán	guzman
tesis	tese
conexión	conexão
secretaría	secretariado
bautista	batista
utilizó	utilizou
embajada	embaixada
invitado	convidado
colón	colombo
desempeñó	desempenhou
best	best
tenis	ténis
tenis	tênis
individuos	indivíduos
publications	publications
finalizar	concluir
exposiciones	exposições
museos	museus
little	little
explica	explica
cambridge	cambridge
lectura	leitura
nombró	nomeou
jornada	jornada
álvaro	álvaro
extiende	estende
quiero	quero
island	island
wiley	wiley
hubiera	tivesse
colorado	colorado
transición	transição
muere	morre
llevaron	levaram
recientes	recentes
consideran	consideram
alguno	algum
llamadas	chamadas
cristina	cristina
rutas	rotas
presentar	apresentar
rival	rival
norma	norma
posesión	posse
noticia	notícia
encontraban	encontravam
estudiante	estudante
taller	oficina
caminos	caminhos
caminos	estradas
alcance	alcance
laura	laura
pdf	pdf
privado	privado
participado	participado
esfuerzo	esforço
piedras	pedras
capa	camada
lateral	lateral
editores	editores
daños	danos
ernesto	ernesto
exclusivamente	exclusivamente
magnitud	magnitude
cueva	caverna
alternativa	alternativa
discurso	discurso
activa	ativa
entidades	entidades
tareas	tarefas
moneda	moeda
relacionado	relacionado
armadas	armadas
aldea	aldeia
soporte	suporte
occidente	ocidente
vivienda	moradia
gloria	glória
chico	garoto
chico	rapaz
chico	chico
incluir	incluir
prado	prado
católico	católico
incluía	incluía
editado	editado
times	times
realizaron	realizaram
caballería	cavalaria
representan	representam
rebelión	rebelião
religiosas	religiosas
definitivamente	definitivamente
asistente	assistente
fallecido	falecido
supone	supõe
canadiense	canadense
alex	alex
jacques	jacques
ritmo	ritmo
andes	andes
guionista	argumentista
mallorca	maiorca
vocal	vogal
entertainment	entertainment
tío	tio
senador	senador
relacionadas	relacionadas
viven	vivem
costas	costas
organizado	organizado
adultos	adultos
dispone	dispõe
piso	andar
carreteras	estradas
declarado	declarado
gobiernos	governos
special	special
quito	tiro
cardenal	cardeal
hermandad	irmandade
perro	cachorro
establecimiento	estabelecimento
rápida	rápido
puesta	posta
dura	dura
capítulos	capítulos
precisamente	precisamente
county	county
archipiélago	arquipélago
portuguesa	portuguesa
gregorio	gregorio
listado	listagem
tocar	tocar
negros	pretos
asunto	assunto
ramas	ramos
publica	publica
morir	morrer
insecto	inseto
ganando	ganhando
cartagena	cartagena
autonomía	autonomia
cocina	cozinha
asociado	associado
incluyó	incluiu
cualquiera	qualquer
pesca	pesca
sucesión	sucessão
primo	primo
avance	avanço
proteger	proteger
presidencial	presidencial
pacientes	doentes
finlandia	finlândia
laterales	laterais
estrecho	estreito
ampliamente	amplamente
papeles	papéis
diversity	diversity
determinar	determinar
telenovela	telenovela
fabricación	fabrico
fabricación	fabricação
poema	poema
lados	lados
saludo	saudação
recuerda	lembra
indonesia	indonésia
prentice	prentice
pidió	pediu
marino	marinho
ramos	ramos
ray	ray
batallón	batalhão
pelea	luta
pelea	briga
gastronomía	gastronomia
académico	acadêmico
virus	vírus
umbral	limiar
potencial	potencial
extra	extra
pilar	pilar
utilizados	utilizados
moral	moral
cierre	fechamento
vargas	vargas
carl	carl
paisaje	paisagem
noble	nobre
aviación	aviação
rendimiento	desempenho
acontecimientos	eventos
actuó	agiu
escultor	escultor
pide	pede
usada	usada
antigüedad	antiguidade
penal	criminal
davis	davis
sam	sam
recuperar	recuperar
resumen	resumo
medellín	medellín
serbia	sérvia
shift	shift
arcos	arcos
integrado	integrado
existentes	existentes
errores	erros
raíces	raízes
responsabilidad	responsabilidade
cuentan	contam
amenaza	ameaça
ojo	olho
cero	zero
separación	separação
pasaron	passaram
convención	convenção
sciences	sciences
provocó	causou
provocó	provocou
teatral	teatral
habilidades	habilidades
habilidades	habilidade
bbc	bbc
pago	pagamento
tendencia	tendência
animación	animação
instalación	instalação
marcas	marcas
vietnam	vietnã
poca	pouca
índice	índice
gana	ganhe
gana	vence
gana	ganha
cambia	muda
hectáreas	hectares
estando	estando
terror	terror
próximo	próximo
saddle	saddle
explotación	exploração
pena	pena
quizás	talvez
titulada	intitulada
realizadas	realizadas
comparación	comparação
grabó	gravou
producen	produzem
habilidad	habilidade
define	define
tiro	tiro
navarro	navarro
solitario	solitário
wisconsin	wisconsin
cursos	cursos
dioses	deuses
disposición	disposição
dolor	dor
fácilmente	facilmente
boys	boys
magdalena	madalena
cadenas	correntes
serán	serão
comúnmente	comumente
serv	serv
tasa	taxa
hecha	feita
petición	petição
petición	pedido
notables	notáveis
wiki	wiki
criterios	critérios
out	out
hermanas	manas
hermanas	irmãs
interpretada	interpretada
disponibles	disponíveis
estadística	estatística
game	game
dependiendo	dependendo
herramientas	ferramentas
simón	simão
blackwell	blackwell
gil	gil
vocalista	vocalista
escapar	fugir
escapar	escapar
espada	espada
will	will
árabes	árabes
sexto	sexto
matar	matar
ninguno	nenhum
vertical	vertical
oficinas	escritórios
kong	kong
contemporánea	contemporânea
disciplina	disciplina
cech	cech
aparecer	aparecer
who	who
gigante	gigante
cristiano	cristão
revolucionario	revolucionário
obispos	bispos
blancas	brancas
sport	sport
derrotado	derrotado
participaciones	participações
ichthyology	ichthyology
candidatura	candidatura
arthur	arthur
ortiz	ortiz
cuadros	quadros
vegetación	vegetação
voluntad	vontade
habiendo	tendo
habiendo	havendo
necesidades	necessidades
eliminar	apagar
vandalismo	vandalismo
aéreo	aéreo
france	france
científicamente	cientificamente
karl	karl
cayó	caiu
clasificado	classificado
esté	esteja
ven	vem
maestros	professores
lake	lake
negocio	negócio
mención	menção
escribe	escreve
esfuerzos	esforços
dolores	dores
dolores	dolores
doña	dona
actuar	atuar
producciones	produções
necesita	precisa
andrea	andrea
gris	cinzento
gris	cinza
periódicos	jornais
oviedo	oviedo
lewis	lewis
margarita	margarida
adicional	adicional
regresa	volta
brigada	brigada
claudio	cláudio
graves	graves
quedan	sobraram
quedan	restam
béisbol	beisebol
logrando	conseguindo
redacción	redação
junior	júnior
junior	junior
tomando	tomando
depende	depende
combinación	combinação
aventuras	aventuras
combustible	combustível
eric	eric
inaugurado	inaugurado
ocurrió	aconteceu
embajador	embaixador
entender	compreender
compra	compra
puedes	podes
estuvieron	estiveram
involucrados	envolvidos
desierto	deserto
compuestos	compostos
lisboa	lisboa
juana	joana
electo	eleito
agentes	agentes
creador	criador
productora	produtora
power	power
venecia	veneza
ensayos	ensaios
barroco	barroco
rev	rev
alba	alba
alba	alvorada
considerar	considere
ingenieros	engenheiros
insectos	insetos
pistas	faixas
trinidad	trindade
mamíferos	mamíferos
cinta	fita
viajó	viajou
retrato	retrato
calor	calor
awards	awards
stone	stone
are	are
colonias	colônias
colonias	colónias
goya	goya
mejora	melhora
flandes	flandres
republicano	republicano
lord	lord
lord	lorde
twitter	twitter
acompañado	acompanhado
talleres	oficinas
jim	jim
angeles	anjos
peor	pior
bottom	bottom
anillo	anel
blues	blues
parejas	casais
basílica	basílica
nieto	neto
verdadera	verdadeira
acceder	acessar
hans	hans
terrestre	terrestre
elenco	elenco
estrategia	estratégia
aquellas	aquelas
causas	causas
virtual	virtual
integración	integração
astronómica	astronómica
temporal	temporário
temporal	temporária
contenidos	conteúdo
clausura	encerramento
frecuente	frequente
obteniendo	obtendo
alternativo	alternativo
alternativo	alternativa
tenerife	tenerife
útil	útil
lunes	segunda
grammy	grammy
minuto	minuto
estilos	estilos
probable	provável
estatua	estátua
supremo	supremo
recinto	recinto
equivalente	equivalente
campus	campus
volúmenes	volumes
tomado	tomado
estancia	estadia
jan	jan
anexos	anexos
matemáticas	matemática
descendientes	descendentes
caballos	cavalos
verdes	verdes
boy	boy
back	back
lara	lara
evidencia	evidência
hidalgo	hidalgo
marruecos	marrocos
amiga	amiga
hola	olá
gales	gales
defensor	defensor
tokio	tóquio
sir	sir
quedaron	ficaram
euros	euros
ciclismo	ciclismo
definitiva	definitiva
alpes	alpes
benito	benito
copas	copos
semillas	sementes
subfamilia	subfamília
pierde	perde
pasión	paixão
home	home
variante	variante
acero	aço
héroe	herói
collette	collette
malden	malden
aumentar	aumentar
adicionales	adicionais
patria	pátria
prisioneros	prisioneiros
actitud	atitude
borde	borda
bibliotecario	bibliotecário
pre	pre
mecánica	mecânica
cuyas	cujas
war	war
est	est
moda	moda
recuperación	recuperação
otoño	outono
lanzada	lançada
rebotes	ressaltos
tienda	loja
temperaturas	temperaturas
campañas	campanhas
obtenido	obtido
nintendo	nintendo
vera	vera
reducir	reduzir
descubrió	descobriu
buscando	procurando
long	long
cárcel	prisão
cuento	conto
otorgado	concedido
imposible	impossível
mencionado	mencionado
prácticas	práticas
draft	draft
africa	áfrica
audio	áudio
hong	hong
crónica	crônica
garden	garden
toro	touro
solista	solista
reducción	redução
tribu	tribo
registros	registos
ligeramente	ligeiramente
helfman	helfman
fotografías	fotografias
facey	facey
nuestros	nossos
asumió	assumiu
congo	congo
presidentes	presidentes
continua	contínua
kim	kim
tendría	teria
jurisdicción	jurisdição
candidatos	candidatos
dibujos	desenhos
dueño	dono
escritora	escritora
puedo	posso
investigadores	pesquisadores
checa	checa
mérida	mérida
bibliografía	bibliografia
bordo	bordo
ejercicio	exercício
rioja	rioja
apariencia	aparência
oferta	oferta
variedades	variedades
ventaja	vantagem
revela	revela
peruana	peruana
remix	remix
literario	literário
libertadores	libertadores
decidieron	decidiram
lograron	conseguiram
humor	humor
influencias	influências
bomba	bomba
verlag	verlag
sujeto	sujeito
catalana	catalã
mostrar	exibir
necesaria	necessária
adolfo	adolfo
françois	françois
cien	cem
arquitectos	arquitetos
ganadora	vencedora
arkansas	arkansas
mostró	mostrou
cooperación	cooperação
editar	editar
alan	alan
monedas	moedas
orientación	orientação
dichos	ditos
preparación	preparação
preparación	preparo
victor	victor
integrada	integrada
mérito	mérito
consenso	consenso
jerusalén	jerusalém
himno	hino
chrysomelidae	chrysomelidae
cristal	vidro
bella	bella
destacó	destacou
visual	visual
múnich	munique
bloque	bloco
presupuesto	orçamento
neptune	neptune
desconocido	desconhecido
ligas	ligas
almirante	almirante
eléctrico	elétrico
calendario	calendário
siria	síria
play	play
pensar	pensar
empate	empate
tono	tom
adn	dna
representado	representado
confianza	confiança
colecciones	coleções
exilio	exílio
funciona	funciona
dejado	deixado
not	not
excelente	excelente
determinado	determinado
veracruz	veracruz
ido	ido
uruguayo	uruguaio
publicidad	publicidade
inauguración	inauguração
polaco	polonês
polaco	polaco
hipótesis	hipóteses
atacar	atacar
parques	parques
centrales	centrais
progreso	progresso
cup	cup
nosotros	nós
ávila	ávila
selva	selva
ibérica	ibérica
debían	deviam
florencia	florença
elegir	escolher
tripulación	tripulação
defender	defender
marcelo	marcelo
secuencia	sequência
michel	michel
intentar	tentar
electrónico	eletrônico
millas	milhas
situaciones	situações
permitir	permitir
genérico	genérico
samuel	samuel
modernos	modernos
porcentaje	porcentagem
porcentaje	percentagem
mata	mata
uniforme	uniforme
satélite	satélite
aventura	aventura
compone	compõe
brazo	braço
sal	sal
body	body
borrar	apagar
ruinas	ruínas
observar	observar
parecido	semelhança
aceite	óleo
playstation	playstation
giovanni	giovanni
jaén	jaén
eliminado	eliminado
eliminado	removido
microsoft	microsoft
ariel	ariel
sant	sant
regla	regra
regla	régua
fueran	fossem
pudiera	pudesse
douglas	douglas
tumba	túmulo
empleado	empregado
cuidado	cuidado
belgrano	belgrano
bulgaria	bulgária
sun	sun
alias	alias
kevin	kevin
venezolano	venezuelano
ideal	ideal
alrededores	arredores
ingleses	ingleses
previa	prévia
mecanismo	mecanismo
atp	atp
rocas	rochas
trama	enredo
renacimiento	renascença
dama	dama
diputación	diputación
dificultades	dificuldades
daño	dano
seguidores	seguidores
parroquial	paroquial
argumentos	argumentos
mauricio	maurício
inversión	investimento
asociaciones	parcerias
mundiales	mundiais
andré	andré
flujo	fluxo
tendrá	terá
eva	eva
italianos	italianos
adquirió	adquiriu
conceptos	conceitos
surgió	surgiu
east	east
placa	placa
mtv	mtv
duró	durou
rosas	rosas
logrado	conseguido
psicología	psicologia
municipalidad	prefeitura
criterio	critério
fiscal	fiscal
fiscal	procurador
hoja	folha
cuadrados	quadrados
rose	rose
aprendizaje	aprendizado
aprendizaje	aprendizagem
grabar	gravar
sexta	sexta
blog	blog
onda	onda
capaces	capazes
interesante	interessante
abc	abc
reformas	reformas
encontraron	encontraram
esposo	marido
fenner	fenner
gray	gray
variantes	variantes
luisa	luísa
representar	representar
publicados	publicados
old	old
creando	criando
respeto	respeito
correo	correio
destinado	destinado
eliminación	eliminação
símbolos	símbolos
cerámica	cerâmica
delgado	magro
asentamiento	assentamento
guadalupe	guadalupe
variable	variável
tecnologías	tecnologias
abre	abre
griegos	gregos
caracteres	caracteres
llevaba	levava
grabaciones	gravações
conscientious	conscientious
elaboración	elaboração
petróleo	petróleo
intercambio	troca
aviso	aviso
psoe	psoe
absoluta	absoluta
dónde	onde
palmarés	palmarés
vendido	vendido
unirse	aderir
famosos	famosos
duro	duro
compitió	competiu
arizona	arizona
cristianismo	cristianismo
huevos	ovos
dibujo	desenho
frío	frio
concreto	concreto
tradicionalmente	tradicionalmente
decisiones	decisões
esculturas	esculturas
emplea	emprega
tango	tango
patio	pátio
conocimientos	conhecimento
angel	anjo
alberga	abriga
administrativo	administrativo
afirmó	afirmou
añadir	adicionar
dúo	dupla
dúo	duo
adam	adam
brillante	brilhante
reconocida	reconhecida
anotó	anotou
existía	existia
mide	mede
leche	leite
nápoles	nápoles
caer	cair
sociedades	sociedades
pagar	pagar
soldado	soldado
pleno	plenário
pleno	pleno
teorías	teorias
jose	jose
puertos	portos
cincuenta	cinquenta
salta	salta
almería	almeria
croacia	croácia
tormenta	tempestade
transformación	transformação
ejércitos	exércitos
francis	francis
deportista	atleta
genera	gera
cáceres	cáceres
rebeldes	rebeldes
visitantes	visitantes
colo	colo
cabrera	cabrera
ropa	roupa
propuesto	proposto
máquinas	máquinas
acabar	acabar
síndrome	síndrome
soledad	solidão
localizado	localizado
tiendas	lojas
premier	premier
cuello	pescoço
pudieron	puderam
trataba	tratava
nick	nick
propuestas	propostas
orientales	orientais
asalto	assalto
asalto	agressão
procesión	procissão
democrático	democrático
compromiso	noivado
compromiso	compromisso
palacios	palácios
consecuencias	consequências
ranking	ranking
mateo	mateus
abuelo	avô
abuelo	vô
propuso	propôs
quizá	talvez
núñez	nunez
novia	namorada
contienen	contêm
enfrentó	enfrentou
tucumán	tucumán
utilización	utilização
filas	fileiras
anexo	anexo
heridos	feridos
ejerció	exerceu
activos	ativos
viva	viva
quince	quinze
minerales	minerais
miedo	medo
colombiana	colombiana
vapor	vapor
parecen	parecem
nazi	nazista
comenzar	começar
servir	servir
death	death
stephen	stephen
alimentación	alimentação
navidad	natal
aprobación	aprovação
intelectual	intelectual
luchar	lutar
procedentes	provenientes
traslado	transferência
navegación	navegação
pertenecen	pertencem
desaparición	desaparecimento
resolver	resolver
andrew	andrew
cuentas	contas
desaparecidos	desapareceram
desaparecidos	desaparecidos
lluvia	chuva
interno	interno
interno	estagiário
tradiciones	tradições
académicos	acadêmicos
industriales	industriais
dispositivos	dispositivos
creciente	crescente
marcador	placar
celebrado	comemorado
lady	lady
crucero	cruzeiro
apariciones	aparições
pesos	pesos
ocupar	ocupar
videos	vídeos
directora	diretora
road	road
coste	custo
realizando	realizando
polo	polo
sporting	sporting
nebraska	nebraska
medias	meias
médica	médica
proteínas	proteína
proteínas	proteínas
eurovisión	eurovisão
fundadores	fundadores
maya	maia
bruce	bruce
coruña	corunha
girl	girl
depresión	depressão
firmado	assinado
clientes	clientes
barra	barra
destruir	destruir
mente	mente
limitada	limitada
tus	tus
relatos	relatos
estamos	estamos
sesión	sessão
protagonistas	protagonistas
tribus	tribos
cientos	centenas
siglas	siglas
teclados	teclados
union	union
union	união
meridional	meridional
daba	dava
invitados	convidados
carbono	carbono
históricas	históricas
johnny	johnny
sony	sony
wild	wild
plazas	praças
leonardo	leonardo
prefectura	prefeitura
específicamente	especificamente
occidentales	ocidentais
existente	existente
techo	teto
implica	envolve
implica	implica
doctorado	doutoramento
comando	comando
jimmy	jimmy
incendio	incêndio
intentos	tentativas
cae	cai
hitler	hitler
cuestiones	questões
marta	marta
culturas	culturas
costumbres	costumes
riqueza	riqueza
largas	longas
altar	altar
triple	triplo
hogares	agregados
infraestructura	infraestrutura
constituyen	constituem
dispositivo	dispositivo
frutos	frutos
derrotar	derrotar
josep	josep
what	what
song	song
solicitud	solicitação
solicitud	pedido
silla	cadeira
inauguró	inaugurou
informática	computadores
fronteras	fronteiras
bartolomé	bartolomeu
dichas	ditas
construcciones	construções
maíz	milho
emmy	emmy
johann	johann
system	system
gato	gato
azúcar	açúcar
sueco	sueco
albacete	albacete
millón	milhão
defunción	óbito
disputar	disputar
lesión	lesão
sonidos	sons
salvar	salvar
atlanta	atlanta
nobel	nobel
friedrich	friedrich
composiciones	composições
individuo	indivíduo
siente	sente
dividido	dividido
giro	giro
alcalá	alcalá
men	men
medallistas	medalhistas
trece	treze
crimen	crime
first	first
correcto	correto
esclavos	escravos
comics	quadrinhos
aguilar	aguilar
vuelos	voos
ayudó	ajudou
abrir	abrir
conocen	conhecem
largos	longos
valparaíso	valparaíso
inmediato	imediato
interpreta	interpreta
aparentemente	aparentemente
trujillo	trujillo
band	band
procedimiento	procedimento
album	álbum
album	album
comienzan	começam
automóviles	automóveis
automóviles	automóvel
colaboró	colaborou
periodismo	jornalismo
sábado	sábado
beach	beach
cuartel	quartel
héroes	heróis
network	network
elizabeth	elizabeth
perspectiva	perspectiva
cuevas	grutas
correspondientes	correspondentes
suprema	supremo
suprema	suprema
decoración	decoração
hijas	filhas
julián	julian
paraná	paraná
gama	gama
inc	inc
foro	fórum
copia	cópia
muros	muralhas
muros	muros
retorno	retorno
sands	sands
europeas	europeias
lógica	lógica
soto	soto
segura	segura
organizó	organizou
cuarenta	quarenta
costo	custo
extinción	extinção
news	news
típico	típico
nativos	nativos
conferencias	conferências
ajedrez	xadrez
habitación	quarto
señales	sinais
trabajado	trabalhado
tensión	tensão
cesar	césar
conciencia	consciência
seminario	seminário
juárez	juárez
técnicos	técnicos
palmas	palmas
vidas	vidas
órganos	órgãos
cobertura	cobertura
jefes	chefes
gusta	curte
acaba	acaba
entradas	bilhetes
pelo	cabelo
estatus	status
estatus	estatuto
monterrey	monterrey
creció	cresceu
miller	miller
contemporáneo	contemporâneo
seco	seco
howard	howard
procede	procede
lisa	lisa
huracán	furacão
cumbre	cimeira
mexicanos	mexicanos
residentes	moradores
ofreció	ofereceu
patrick	patrick
conservador	conservador
rueda	roda
botánicos	botânicos
valles	vales
completar	completar
pacto	pacto
llamar	ligar
contribuciones	contribuições
opiniones	opiniões
segovia	segóvia
brazos	braços
british	british
moore	moore
consejero	conselheiro
cámaras	câmeras
cámaras	câmaras
website	website
interpretar	interpretar
isidro	isidro
off	off
empezaron	começaram
documentación	documentação
autopista	autoestrada
arts	arts
circunstancias	circunstâncias
parcial	parcial
clan	clã
incluidos	incluídos
séptimo	sétimo
juniors	juniors
historial	histórico
billy	billy
impuestos	impostos
reloj	relógio
delta	delta
pardo	pardo
singles	singles
extremadura	estremadura
intensidad	intensidade
fundadas	fundadas
toronto	toronto
definir	definir
definir	definindo
liberales	liberais
gabinete	armário
fray	frei
villas	vivendas
equilibrio	equilíbrio
esquina	canto
cofradía	confraria
allen	allen
recuerdo	lembrança
inmigrantes	imigrantes
pared	parede
henri	henri
órbita	órbita
aceptado	aceito
tropicales	tropical
designados	nomeados
gótico	gótico
asistió	assistiu
cima	topo
elevado	elevado
airlines	airlines
conservan	conservam
vázquez	vázquez
della	della
perdiendo	perdendo
soviético	soviético
rubén	ruben
anthony	anthony
pos	pos
goleador	goleador
atletismo	atletismo
heavy	heavy
silencio	silêncio
trató	tentou
trofeo	troféu
was	was
dicen	dizem
ocupado	ocupado
arqueológico	arqueologia
pobres	pobres
reconstrucción	reconstrução
tratados	tratados
particulares	particulares
óperas	óperas
presa	barragem
presa	presa
oportunidades	oportunidades
nevada	nevada
usados	usados
calderón	calderón
monarquía	monarquia
percusión	percussão
aceptó	aceitou
circular	circular
lobo	lobo
biología	biologia
móvil	móvel
dividida	dividida
dividida	dividido
víctima	vítima
incremento	aumento
teología	teologia
ambiental	ambiental
nobleza	nobreza
cultivos	culturas
considerados	considerados
escultores	escultores
gusto	gosto
corporación	corporação
gimnasia	ginástica
refugio	refúgio
automóvil	automóvel
formaron	formaram
renuncia	renúncia
borbón	bourbon
voy	vou
open	open
jugado	jogado
filósofo	filósofo
rasgos	traços
cantar	cantar
end	end
decía	dizia
pino	pinheiro
pino	pinho
pamplona	pamplona
incorporó	incorporou
sofía	sofia
lucía	lúcia
temprana	precoce
ortega	ortega
absoluto	absoluto
procedente	proveniente
herramienta	ferramenta
águila	águia
camiseta	camiseta
registrado	registado
cabello	cabelo
reinos	reinos
mix	mix
permiso	permissão
consideró	considerou
musulmanes	muçulmanos
diversidad	diversidade
two	two
andy	andy
testamento	testamento
sudeste	sudeste
alfred	alfred
cortos	curtos
julia	júlia
medallista	medalhista
fracaso	fracasso
vélez	vélez
óblast	oblast
ciento	cento
superar	superar
drogas	droga
fans	fãs
cantidades	quantidades
persecución	perseguição
centenario	centenário
mac	mac
consideraba	considerava
cuerdas	cordas
selecciones	seleções
anti	anti
artificial	artificial
nominaciones	nomeações
bay	bay
villanueva	villanueva
muestras	amostras
tomaron	tomaram
like	like
pertenecía	pertencia
obrero	operário
issn	issn
demócrata	democrata
traducido	traduzido
cerebro	cérebro
sombra	sombra
mercados	mercados
iniciar	iniciar
toneladas	toneladas
confirmó	confirmou
indican	indicam
senadores	senadores
cambiado	mudado
cambiado	alterado
ganadería	pecuária
deuda	dívida
dark	dark
chilenos	chilenos
señala	aponta
bell	bell
ciclistas	ciclistas
fuertemente	fortemente
proporciona	fornece
vientos	ventos
experimental	experimental
bancos	bancadas
bancos	bancos
seleccionado	selecionado
indio	indiano
dudas	dúvidas
vieron	viram
partículas	partículas
cali	cali
parcialmente	parcialmente
dirigir	direcionar
dirigir	dirigir
bravo	bravo
específico	específico
country	country
pastor	pastor
iván	ivan
traje	fato
flag	flag
monarca	monarca
cifra	cifra
murieron	morreram
escuadra	esquadrão
profesora	professora
enfrentamiento	confronto
circulación	circulação
formal	formal
gobernación	governação
cerrado	fechado
detalle	detalhe
tim	tim
desaparecido	desapareceu
desaparecido	sumido
sucede	acontece
introdujo	introduziu
simpson	simpson
citado	citado
pekín	pequim
yugoslavia	jugoslávia
jamás	jamais
meta	meta
vegas	vegas
ampliación	ampliação
ibn	ibn
académica	acadêmica
localiza	localiza
doctrina	doutrina
dead	dead
iban	iam
conseguido	conseguido
cobre	cobre
separado	separado
habitualmente	habitualmente
créditos	créditos
coral	coral
creados	criados
posibilidades	possibilidades
line	line
paciente	paciente
arias	arias
great	great
memorias	memórias
tailandia	tailândia
pobre	pobre
telenovelas	novelas
calcio	cálcio
pasan	passam
velasco	velasco
precios	preços
talento	talento
frecuentes	frequentes
captura	captura
cervantes	cervantes
próxima	próxima
antena	antena
parada	parada
dientes	dentes
básica	básico
reemplazado	substituído
marvel	marvel
epíteto	epíteto
heart	heart
retirarse	retirar
temática	temática
republicana	republicana
marcado	marcação
puentes	pontes
previo	prévio
previo	prévia
volcán	vulcão
mora	amora
beneficios	benefícios
rodolfo	rodolfo
reproducción	reprodução
estima	estima
sudamericano	sulamericano
canaria	canaria
platino	platina
field	field
gala	gala
charlie	charlie
hockey	hóquei
fósiles	fóssil
fósiles	fósseis
presentaciones	apresentações
tablas	tábuas
tablas	tabelas
tablas	pranchas
representaciones	representações
ofensiva	ofensiva
rector	reitor
negó	negou
roy	roy
coches	carros
unesco	unesco
designación	designação
incidente	incidente
alicia	alicia
alicia	alice
abogados	advogados
funcionarios	funcionários
vendió	vendeu
esperar	esperar
atlas	atlas
russell	russell
rumbo	rumo
cruces	cruzes
negras	pretas
rumania	roménia
magazine	magazine
exactamente	exatamente
mira	olha
leo	leo
opciones	opções
cortés	cortês
legislativo	legislativo
oliver	oliver
fortuna	fortuna
nova	nova
localizada	localizada
legislación	legislação
soria	soria
warner	warner
ramal	ramal
privadas	privadas
last	last
bernard	bernard
rené	rené
matt	matt
instrucción	instrução
lanzar	lançar
modalidad	modalidade
accidentes	acidentes
spider	spider
adecuado	adequado
poseía	possuía
plena	plena
emitido	emitido
venezolana	venezuelana
delegación	delegação
restantes	restantes
sugiere	sugere
palencia	palencia
conforme	conforme
casada	casada
misa	missa
reconoce	reconhece
causó	causou
marrón	marrom
value	value
relevantes	relevantes
magia	magia
núcleos	núcleos
vender	vender
houston	houston
hard	hard
estaría	estaria
part	part
campamento	acampamento
siguieron	seguiram
participan	participam
dorado	dourado
celular	celular
ryan	ryan
armando	armando
diarios	diários
diarios	jornais
pisos	andares
directiva	diretiva
armenia	arménia
mina	mina
gráfico	gráfico
amateur	amadora
amateur	amadores
amateur	amador
emitió	emitiu
sports	sports
consultado	consultado
cuál	qual
gracia	graça
franklin	franklin
viuda	viúva
salazar	salazar
pirineos	pirinéus
acta	acta
evidente	evidente
rescate	resgate
aceptar	aceitar
actúa	age
relieve	relevo
considerable	considerável
integral	integral
organizar	organizar
infante	infante
fundamentalmente	fundamentalmente
reducido	reduzido
athletic	athletic
paula	paula
sobrino	sobrinho
integró	integrou
come	come
guayaquil	guayaquil
perros	cães
perros	cachorro
cliente	cliente
profundo	profundo
ruedas	rodas
tantos	tantos
modificaciones	modificações
estatales	estaduais
estatales	estatais
inmigración	imigração
aguirre	aguirre
arqueológicos	arqueológicos
channel	channel
down	down
gallego	galego
asociados	parceiros
mariscal	marechal
naranja	laranja
encargó	encomendou
autobuses	autocarro
embalse	reservatório
americanos	americanos
rayos	raios
ducado	ducado
aficionados	amadores
representada	representada
condados	condados
marc	marc
gordon	gordon
hayan	tenham
multitud	multidão
heredero	herdeiro
generar	gerar
finalista	finalista
cátedra	cátedra
licenciado	licenciado
espiritual	espiritual
page	page
basados	baseados
violín	violino
carnaval	carnaval
seno	seio
fort	fort
playas	praias
síntesis	síntese
docente	docente
way	way
aceptadas	aceites
piragüismo	canoagem
recibieron	receberam
encontramos	encontramos
clark	clark
sacerdotes	padres
sacerdotes	sacerdotes
dirigentes	dirigentes
dirigentes	líderes
shorts	shorts
basadas	baseadas
evaluación	avaliação
inaugurada	inaugurada
modos	modos
inscripción	inscrição
homónimo	homónimo
descubrir	descobrir
enfoque	foco
anne	anne
industrias	indústrias
mejoras	melhoras
agrícolas	agrícolas
publicar	postar
judío	judeu
abadía	abadia
vándalo	vândalo
crédito	crédito
pedir	pedir
irak	iraque
llevando	levando
roque	roque
queen	queen
visitante	visitante
deberían	deveriam
institucional	institucional
institucional	institucionais
operador	operador
investigador	pesquisador
negociaciones	negociações
marítimo	marítimo
serrano	serrano
inclinación	inclinação
laboral	trabalhista
físicas	físicas
federales	federais
judía	judia
escritas	escritas
amante	amante
wayne	wayne
holanda	holanda
stadium	stadium
arroz	arroz
dificultad	dificuldade
jugaba	jogava
sicilia	sicília
dave	dave
sustituido	substituído
secundario	secundário
hilo	discussão
belga	belga
operativo	operacional
épocas	épocas
terminado	concluído
propone	propõe
contrajo	contraiu
concedió	concedeu
extensa	extensa
cabildo	cabildo
dragón	dragão
organizada	organizada
ofrecer	oferecer
armamento	armamento
profunda	profunda
napoleón	napoleão
link	link
recepción	recepção
parroquias	paróquias
igualdad	igualdade
conductor	condutor
orleans	orleans
krasnodar	krasnodar
sabor	sabor
síntomas	sintomas
detenido	detido
legión	legião
golden	golden
nominado	nomeado
alcanzado	alcançado
licenciatura	licenciatura
festivales	festivais
elegidos	eleitos
vale	vale
pabellón	pavilhão
christopher	christopher
springer	springer
túnel	túnel
jason	jason
missouri	missouri
surge	surge
baviera	baviera
soberanía	soberania
expertos	peritos
expertos	especialistas
necesarios	necessários
alaska	alasca
asesino	assassino
permanece	permanece
prima	prima
manifestaciones	manifestações
bolsa	saco
dedica	dedica
usó	usou
elegida	escolhida
masas	massas
paralelo	paralelo
empezar	começar
demostrar	demonstrar
demostrado	comprovado
fragmentos	fragmentos
fragmentos	trechos
acuerdos	acordos
aparecido	aparecido
disputado	disputado
ballet	ballet
ballet	balé
wikimedia	wikimedia
moon	moon
viajar	viajar
toros	touros
escenarios	cenários
crece	cresce
anuales	anuais
diálogo	diálogo
lema	lema
observa	observa
informó	relatou
diplomático	diplomata
malasia	malásia
adams	adams
marinos	marinheiros
socio	parceiro
lingüística	linguística
condesa	condessa
mencionar	mencionar
ross	ross
jerónimo	jerónimo
version	version
cumple	cumpre
identificación	identificação
good	good
describió	descreveu
electricidad	eletricidade
electricidad	electricidade
sesiones	sessões
tránsito	trânsito
típica	típica
robin	robin
filial	filial
atmósfera	atmosfera
madonna	madonna
explicar	explicar
hacían	faziam
colectivo	coletivo
vacío	vazio
requisitos	exigências
requisitos	requisitos
movie	movie
pontificia	pontifícia
diana	diana
family	family
elevada	elevada
nieve	neve
pares	pares
comunistas	comunistas
colina	colina
cuerda	corda
reporta	denuncie
espectáculos	espetáculos
señores	senhores
aplica	aplica
aplica	aplique
chicas	meninas
vizcaya	biscaia
jane	jane
sentimientos	sentimentos
relacionada	relacionada
aparato	aparelho
eschmeyer	eschmeyer
variables	variáveis
reunió	reuniu
project	project
poderoso	poderoso
antiguamente	antigamente
nacionalista	nacionalista
pudiendo	podendo
alcanzando	atingindo
provisional	provisório
jeff	jeff
podido	podido
haga	faça
barón	barão
salinas	salinas
venganza	vingança
sajonia	saxónia
socks	socks
official	official
clínica	clínica
harvard	harvard
observación	observação
bajista	baixista
explosión	explosão
bruno	bruno
armado	armado
aux	aux
acusado	acusado
mínima	mínimo
renovación	renovação
diosa	deusa
acepta	aceita
metropolitano	metropolitano
ventana	janela
ventana	janelas
rusos	russos
reservas	reservas
variaciones	variações
lluvias	chuvas
ventanas	janelas
sat	sat
beneficio	lucro
descarga	download
visitar	visitar
herencia	herança
gijón	gijón
vueltas	voltas
juntas	juntas
aeronaves	aeronaves
madagascar	madagáscar
extremos	extremos
plato	prato
eugenio	eugenio
claude	claude
dir	dir
añade	adiciona
instrumental	instrumental
gravedad	gravidade
competir	competir
ferrocarriles	ferrovias
planos	plantas
planos	planos
líquido	líquido
pozo	poço
plataformas	plataformas
establecieron	estabeleceram
jonathan	jonathan
pecho	peito
constelación	constelação
explicación	explicação
conclusión	conclusão
prestigio	prestígio
campesinos	camponeses
kelly	kelly
story	story
aumenta	aumenta
biblia	bíblia
seria	séria
antología	antologia
inspiración	inspiração
negativa	negativa
negativa	negativo
impresión	impressão
fría	fria
spring	spring
diseños	projetos
teléfono	telefone
pío	pio
ideología	ideologia
costumbre	costume
básicos	básicos
patricia	patrícia
georges	georges
cómic	quadrinhos
quedado	ficado
huelva	huelva
ball	ball
logros	conquistas
logros	realizações
comprar	comprar
enterrado	enterrado
herido	ferido
formados	formados
cubierto	coberto
mental	mental
franz	franz
polémica	polêmica
crónicas	crônicas
principado	principado
alegre	alegre
relativa	relativa
suelos	solos
database	database
destacando	destacando
parecía	parecia
oaxaca	oaxaca
unida	unida
recurso	recurso
rubio	loiro
homónima	homónima
financiera	financeira
compuso	compôs
méndez	méndez
vivían	viviam
vela	vela
creek	creek
chávez	chávez
voleibol	voleibol
ocurrido	ocorrido
conjuntos	conjuntos
demuestra	demonstra
rolling	rolling
competencias	competências
talla	tamanho
bafta	bafta
personalidades	personalidades
experiencias	experiências
austin	austin
giras	digressões
sesenta	sessenta
cannes	cannes
litoral	litoral
fases	fases
orgánica	orgânica
orgánica	orgânicos
franja	faixa
book	book
piensa	pensa
carbón	carvão
convirtieron	converteram
convirtieron	transformaram
mozart	mozart
set	set
sufre	sofre
vocales	vogais
perdidos	perdidos
pesado	pesado
sorpresa	surpresa
cruce	cruzamento
descendencia	descendência
infantiles	infantis
badajoz	badajoz
bárbara	bárbara
romance	romance
escuadrón	esquadrão
brasileña	brasileira
oxígeno	oxigênio
distinto	diferente
jueves	quinta
cráter	cratera
distinción	distinção
abandonado	abandonado
llevada	levada
archive	archive
nominación	nomeação
instancia	instância
reuniones	reuniões
mármol	mármore
instrucciones	instruções
tengan	tenham
pascual	pascual
jalisco	jalisco
volvieron	voltaram
matemática	matemática
muralla	muralha
cura	cura
disolución	dissolução
vivía	vivia
hispano	hispânico
interpretando	interpretando
milenio	milênio
ligero	leve
sagrado	sagrado
empresarios	empresários
húngaro	húngaro
instaló	instalou
matriz	matriz
books	books
sara	sara
valley	valley
marshall	marshall
sebastian	sebastião
pase	passe
wilhelm	wilhelm
coordinación	coordenação
sarmiento	sarmiento
perteneció	pertenceu
condenado	condenado
caliente	quente
reúne	reúne
represión	repressão
deciden	decidem
hembras	fêmeas
corredor	corredor
radiación	radiação
rostro	rosto
baker	baker
bad	bad
mexico	méxico
mexico	mexico
tito	tito
point	point
corporation	corporation
construyeron	construíram
ine	ine
estética	estética
visitas	visitas
otto	otto
condes	condes
colonos	colonos
configuración	configuração
configuración	configurações
boda	casamento
gobernadores	governadores
permitía	permitia
entiendo	entendo
entiendo	entendi
entiendo	compreendo
crearon	criaram
mecanismos	mecanismos
renunció	renunciou
trasladado	transferido
construidos	construídos
gen	gene
lleno	cheio
colaborador	colaborador
sentencia	sentença
congregación	congregação
incorpora	incorpora
abandono	abandono
clasificados	classificados
trazado	traçado
kennedy	kennedy
subsp	subsp
defensores	defensores
financiero	financeiro
comentó	comentou
gay	gay
bóveda	cofre
check	check
sueños	sonhos
vamos	vamos
anualmente	anualmente
lector	leitor
básicamente	basicamente
puntuación	pontuação
conducta	comportamento
conducta	conduta
ángulo	ângulo
oral	oral
básico	básico
precisión	precisão
protegido	protegido
recomienda	recomenda
representando	representando
socialistas	socialistas
atraviesa	atravessa
postura	postura
provoca	provoca
sarah	sarah
socios	parceiros
oración	oração
arteria	artéria
pri	pri
protegidas	protegidas
amazonas	amazônia
visible	visível
grant	grant
templos	templos
anfibios	anfíbios
islam	islã
británicas	britânicas
adyacentes	adjacentes
geográfico	geográfico
misiles	mísseis
tejido	tecido
aprobado	aprovado
establecida	estabelecida
studios	studios
apodo	apelido
emergencia	emergência
intérprete	intérprete
canta	canta
constantemente	constantemente
limitado	limitado
nombrada	nomeada
enviar	enviar
soul	soul
intendente	intendente
preguntas	perguntas
oscura	escura
wwe	wwe
memorial	memorial
humanas	humanas
estadios	estádios
reciben	recebem
vigilancia	vigilância
planificación	planejamento
bibliotecarios	bibliotecários
montreal	montreal
barrera	barreira
permitiendo	permitindo
aprender	aprender
actualización	atualização
pictures	pictures
tarjetas	cartões
pakistán	paquistão
catalunya	catalunya
baby	baby
imprenta	tipografia
tesoro	tesouro
olímpica	olímpica
macedonia	macedónia
ali	ali
ofrecen	oferecem
pianista	pianista
facilitar	facilitar
bits	bits
otorga	confere
integrante	integrante
patrona	patroa
aparecieron	apareceram
presidenciales	presidencial
maestra	professora
sancho	sancho
continuo	contínuo
vecino	vizinho
exploración	exploração
consejos	dicas
parámetros	parâmetros
legado	legado
chicos	galera
componente	componente
corrupción	corrupção
externa	externa
ebro	ebro
us$	us$
vegetales	legumes
vegetales	vegetais
lawrence	lawrence
dragon	dragão
séptima	sétima
signo	sinal
espejo	espelho
finalidad	finalidade
iso	iso
sinfonía	sinfonia
virtud	virtude
teclado	teclado
feliz	feliz
mapas	mapas
molecular	molecular
cúpula	cúpula
ciudadano	cidadão
cónsul	cônsul
somos	somos
existir	existindo
existir	existir
protocolo	protocolo
malvinas	falkland
dallas	dallas
capturado	capturado
cerrada	fechada
habrá	haverá
ganaron	ganharam
huesca	huesca
célebre	célebre
batman	batman
continuidad	continuidade
sacar	tirar
hablando	falando
asesor	conselheiro
asesor	consultor
restaurante	restaurante
tanques	tanques
informes	relatórios
misterio	mistério
harris	harris
expresa	expressar
expresa	expressa
planetas	planetas
proteína	proteína
sexuales	sexuais
espalda	costas
postal	postal
signos	sinais
administrador	administrador
estrecha	estreita
extraño	saudades
tratando	tentando
vigo	vigo
venus	vênus
determinada	determinada
encargada	encarregada
hamilton	hamilton
escaños	bancadas
cirugía	cirurgia
chinos	chineses
segmento	segmento
destruido	destruído
ayudante	assistente
ayudante	ajudante
genus	genus
servidor	servidor
portero	goleiro
portero	porteiro
característico	característico
latin	latim
escasa	escassa
aplicar	aplicar
perfectamente	perfeitamente
diablo	diabo
repertorio	repertório
viviendo	vivendo
java	java
transferencia	transferência
quinteto	quinteto
reconocer	reconhecer
more	more
intérpretes	intérpretes
internos	internos
internos	estagiários
llena	cheia
jueces	juízes
alcohol	álcool
dejaron	deixaram
cubano	cubano
utilizadas	utilizadas
rodeado	cercado
beatriz	beatriz
estable	estável
about	about
inspirado	inspirado
entera	inteira
uci	uti
concesión	concessão
arqueología	arqueologia
iniciales	iniciais
alimento	alimento
corre	corre
praga	praga
tigre	tigre
linux	linux
light	light
protesta	protesto
educativo	educacional
ochenta	oitenta
detener	parar
genética	genética
monumental	monumental
responde	responde
lyon	lyon
celebran	celebram
palo	pau
varía	varia
ondas	ondas
sufrido	sofrido
protestas	protestos
contratado	contratado
manteniendo	mantendo
geográficos	geográficos
abundante	abundante
digitales	digitais
altamente	altamente
llaman	chamam
hechas	feitas
conservatorio	conservatório
correcta	correto
patricio	patrício
colonización	colonização
islandia	islândia
controversia	controvérsia
incorporación	incorporação
diseñador	desenhador
diseñador	designer
