tarjeta	cartão
oklahoma	oklahoma
orlando	orlando
anillos	anéis
leyendas	lendas
arenas	areias
morgan	morgan
contribución	contribuição
banderas	bandeiras
originario	originário
acb	acb
voluntarios	voluntários
germán	germán
vegetal	vegetal
versos	versos
indicar	indicar
jurídica	jurídica
transportes	transportes
domínguez	dominguez
compró	comprou
huir	fugir
sustitución	substituição
ejercer	exercer
horacio	horatio
distinciones	distinções
literalmente	literalmente
gráfica	gráfico
emisiones	emissões
supuestamente	supostamente
perdieron	perderam
western	western
isaac	isaac
bosnia	bósnia
químico	químico
destinos	destinos
partidarios	apoiantes
urss	urss
reacciones	reacções
reacciones	reações
challenger	challenger
adoptó	adotou
queso	queijo
leopoldo	leopoldo
ponce	ponce
externo	externo
silvestre	selvagem
silvestre	silvestre
gary	gary
inca	inca
identificar	identificar
narra	narra
ian	ian
hip	hip
smiths	smiths
concilio	concílio
escuchar	escutar
escuchar	ouvir
hop	hop
catorce	catorze
demostró	demonstrou
demostró	mostrou
legales	legais
his	his
representó	representou
pelota	bola
gráficos	gráficos
ferrer	ferrer
taiwán	taiwan
tercio	terço
natación	natação
frases	frases
entregó	entregou
anuncio	anúncio
azules	azuis
tubo	tubo
freshwater	freshwater
liceo	liceu
flamenco	flamengo
refleja	reflete
cálculo	cálculo
get	get
cifras	números
carter	carter
orange	orange
quebec	quebec
kentucky	kentucky
lorena	lorena
entrevistas	entrevistas
futura	futura
conduce	conduz
bibliotecas	bibliotecas
propietarios	proprietários
hierba	erva
detroit	detroit
responsables	responsáveis
convenciones	convenções
extremadamente	extremamente
toca	toca
toca	toque
cubana	cubana
review	review
hernán	hernan
hablan	falam
abad	abade
consistía	consistia
químicos	químicos
rechazó	rejeitou
publicadas	publicadas
iniciado	iniciado
manifiesto	manifesto
fantasma	fantasma
centímetros	centímetros
commons	commons
soluciones	soluções
revuelta	revolta
implicados	envolvidos
especialidad	especialidade
contraste	contraste
castellón	castellón
suyo	seu
carlo	carlo
generaciones	gerações
bello	bello
arreglos	arranjos
esencial	essencial
town	town
nombramiento	nomeação
jerez	jerez
cancha	quadra
abreviado	abreviado
esquema	esquema
esquema	destaques
piratas	piratas
sirven	servem
ecuación	equação
permanecer	permanecer
recibiendo	recebendo
faro	farol
jon	jon
phil	phil
almacenamiento	armazenamento
especializado	especializado
tarragona	tarragona
asignado	atribuído
producidos	produzidos
fire	fire
neutral	neutro
tienes	tens
walker	walker
conversión	conversão
separados	separados
omar	omar
descanso	repouso
sinónimo	sinônimo
violación	violação
presidenta	presidente
desempeño	desempenho
clemente	clemente
presentador	apresentador
obligó	obrigou
quintana	quintana
registró	registrou
utah	utah
platos	pratos
débil	fraca
vidrio	vidro
casarse	casar
broadway	broadway
trabajaba	trabalhava
presentaron	apresentaram
reseña	resenha
desarrollada	desenvolvida
crímenes	crimes
valdés	valdés
free	free
derivados	derivados
chihuahua	chihuahua
contando	contando
vasca	basca
vivos	vivos
gerardo	gerardo
australiano	australian
australiano	australiano
seguía	seguia
produjeron	produziram
ascendido	promovido
asteroide	asteróide
dimensión	dimensão
atentado	atentado
creía	acreditava
afganistán	afeganistão
restaurantes	restaurantes
perry	perry
comer	comer
heridas	feridas
diagnóstico	diagnóstico
señaló	apontou
asedio	cerco
montana	montana
privados	privados
onu	onu
francesco	francesco
modernas	modernas
celebrar	comemorar
simultáneamente	simultaneamente
collection	collection
intelectuales	intelectuais
alcaldía	prefeitura
macho	macho
alumno	aluno
steven	steven
reemplazo	substituição
décimo	décimo
setenta	setenta
clasificaciones	classificações
bach	bach
viña	vinha
capas	camadas
interacción	interação
interacción	interacção
murray	murray
perfecto	perfeito
mhz	mhz
permitido	permitido
jordi	jordi
girls	girls
universitarios	universitários
tiros	tiros
trigo	trigo
persa	persa
tennessee	tennessee
civilización	civilização
complejos	complexos
argentinas	argentinas
mariana	mariana
turco	turco
creen	acreditam
colegios	colégios
enfrentamientos	confrontos
iluminación	iluminação
extendió	espalhou
extendió	estendeu
convocado	convocado
participando	participando
mineral	mineral
sustancias	substâncias
entero	inteiro
impulso	impulso
computadora	computador
lectores	leitores
castellana	castellana
elevación	elevação
elevación	elevador
móviles	móveis
integra	integra
rotación	rotação
estabilidad	estabilidade
dependiente	dependente
curva	curva
alabama	alabama
maestría	mestrado
maestría	perícia
hidrógeno	hidrogênio
krai	krai
people	people
criminal	criminoso
criminal	criminal
year	year
vuelto	voltado
tejidos	tecidos
suceso	acontecimento
fabricante	fabricante
adquisición	aquisição
cuadrado	quadrado
israelí	israelita
israelí	israelense
existían	existiam
expulsado	expulso
guerreros	guerreiros
positivo	positivo
combatir	combater
iguales	iguais
impuesto	imposto
modificación	modificação
modificación	alteração
haría	faria
ginebra	genebra
luces	luzes
concluyó	concluiu
interiores	interiores
juveniles	juvenis
historieta	quadrinhos
esperaba	esperava
sindicato	sindicato
períodos	períodos
inclusión	inclusão
rick	rick
suspensión	suspensão
desplazamiento	deslocamento
reconocidos	reconhecidos
wars	wars
proporcionar	fornecendo
berlin	berlim
reveló	revelou
pedido	encomenda
históricamente	historicamente
educativa	educacional
font	font
específica	específica
jordan	jordan
huelga	greve
distinta	diferente
eddie	eddie
claudia	cláudia
apple	apple
benjamin	benjamin
capitales	capitais
sostiene	sustenta
adecuada	adequada
just	just
huesos	ossos
llamaba	chamava
vídeos	vídeos
serena	serena
declarada	declarada
salsa	molho
salvaje	selvagem
baleares	baleares
bryan	bryan
alfabeto	alfabeto
continuaron	continuaram
manuscrito	manuscrito
petersburgo	petersburgo
gosse	gosse
visitó	visitou
horizontal	horizontal
vestido	vestido
especializada	especializada
octavo	oitavo
palestina	palestina
ampliar	ampliar
orstom	orstom
cartel	cartaz
maryland	maryland
arm	arm
espero	aguardo
granja	fazenda
patas	pernas
heemstra	heemstra
vanguardia	vanguarda
hoese	hoese
presentada	apresentada
masters	masters
préstamo	empréstimo
plate	plate
iucn	iucn
oficio	profissão
estatuto	estatuto
dream	dream
liderazgo	liderança
mostrando	mostrando
space	space
célula	pilha
lineal	linear
franquicia	franquia
tervuren	tervuren
adquirir	adquirir
expulsión	expulsão
genes	genes
plana	plana
nicolas	nicolas
perón	perón
observaciones	observações
desembocadura	foz
pepe	pepe
rivales	rivais
solicitó	solicitou
alice	alice
rayo	raio
físicos	físicos
organiza	organiza
bombas	bombas
maurice	maurice
cecilia	cecília
cecilia	cecilia
marte	marte
retratos	retratos
loco	louco
harrison	harrison
stewart	stewart
formalmente	formalmente
argelia	argélia
sound	sound
novio	namorado
rechazo	rejeição
parker	parker
eligió	escolheu
firmar	assinar
describir	descrever
xavier	xavier
chipre	chipre
guy	guy
expresiones	expressões
ruptura	ruptura
emisora	emissora
filósofos	filósofos
previsto	planejado
thys	thys
adolescente	adolescente
inés	inês
actualizado	atualizado
prototipo	protótipo
dinámica	dinâmica
literarias	literárias
mencionada	mencionada
variación	variação
latitud	latitude
trío	trio
usted	você
sabía	sabia
alfa	alpha
alfa	alfa
ann	ann
grabada	gravada
irlandés	irlandês
audenaerde	audenaerde
edgar	edgar
anchura	largura
botanical	botanical
marciales	marciais
barry	barry
utilidad	utilidade
manchester	manchester
beatles	beatles
higgins	higgins
celebrada	realizada
receptor	destinatário
construidas	construídos
construidas	construídas
personalmente	pessoalmente
desapareció	desapareceu
prólogo	prólogo
valenciano	valenciano
xbox	xbox
maugé	maugé
force	force
states	states
ken	ken
campeona	campeã
lgbt	lgbt
automáticamente	automaticamente
centre	centre
pacheco	pacheco
necesarias	necessárias
abraham	abraão
colaboradores	colaboradores
lost	lost
baterista	baterista
caras	rostos
supercopa	supercopa
turín	turim
lesiones	lesões
disminución	diminuição
apoyó	apoiou
aceptación	aceitação
sídney	sydney
parra	parra
facilidad	facilidade
libras	libras
modificar	modificar
land	land
cedido	cedido
definido	definido
contribuyó	contribuiu
terrestres	terrestres
rara	rara
necesitan	precisam
soviéticos	soviéticos
figueroa	figueroa
adquirido	adquirido
clasificó	classificou
pérdidas	perdas
fantasía	fantasia
fenómenos	fenômenos
conecta	conecta
mini	mini
africano	africano
let	let
poética	poética
robinson	robinson
otomano	otomano
over	over
finanzas	finanças
sinfónica	sinfônica
suborden	subordem
boxeo	boxe
ocupada	ocupada
renault	renault
raymond	raymond
iron	iron
comparte	compartilhe
jerry	jerry
árbitro	árbitro
antropología	antropologia
favorable	favorável
bizantino	bizantino
significativa	significativa
protegida	protegida
fiel	fiel
derivado	derivado
rodaje	rodagem
escalera	escada
heinrich	heinrich
reglamento	regulamento
arabia	arábia
gigantes	gigantes
experimentos	experiências
paisajes	paisagens
cuesta	custa
mito	mito
dispuesto	disposto
grabados	gravuras
efectivo	dinheiro
robot	robô
cárdenas	cárdenas
cuota	quota
roland	roland
obreros	operários
sagrada	sagrado
sagrada	sagrada
primarias	primárias
interpretaciones	interpretações
hembra	fêmea
consiguieron	conseguiram
añadió	adicionou
añadió	acrescentou
gold	gold
procedimientos	procedimentos
dominante	dominante
fred	fred
rob	rob
vigente	vigente
chaco	chaco
luchador	lutador
ligera	leve
facultades	faculdades
tocando	tocando
recuerdos	lembranças
mantenido	mantido
popularmente	popularmente
específicos	específicos
wright	wright
falla	falha
llano	planície
llano	liso
romper	quebrar
huerta	horta
septentrional	setentrional
seguimiento	acompanhamento
difíciles	difíceis
cerveza	cerveja
proyección	projeção
neerlandés	holandês
neerlandés	neerlandês
chiapas	chiapas
compuestas	compostas
contenía	continha
bloqueado	bloqueado
maneras	maneiras
salen	saem
tocó	tocou
infierno	inferno
gastos	despesas
africana	africana
conformado	conformado
depósito	depósito
lucio	lúcio
montenegro	montenegro
avanzada	avançado
avanzada	avançada
nucleares	nuclear
emma	emma
terry	terry
jornadas	jornadas
situados	localizados
lobos	lobos
especialista	especialista
octava	oitava
pendiente	brinco
pendiente	pendente
realista	realista
century	century
cortas	curtas
definitivo	definitivo
recordar	recordar
comenzando	começando
paraíso	paraíso
autora	autora
funcionar	funcionar
testimonio	testemunho
malta	malta
balonmano	handebol
bloques	blocos
positiva	positivo
pudieran	pudessem
separa	separa
turner	turner
vidal	vidal
polvo	poeira
componen	compõem
tomada	tomada
balón	bola
fija	fixa
declara	declara
alegría	alegria
luxemburgo	luxemburgo
prusia	prússia
declaraciones	declarações
declaraciones	depoimentos
reconoció	reconheceu
estén	estejam
cronología	cronologia
cría	filhote
ilustraciones	ilustrações
cross	cross
ron	rum
singular	singular
tratan	tratam
vital	vital
comenzado	começado
phoenix	phoenix
semi	semi
maine	maine
varsovia	varsóvia
masacre	massacre
dirigidos	direcionados
vinos	vinhos
nominada	nomeada
denuncia	denúncia
decidir	decidir
frutas	fruta
periodos	períodos
obtenidos	obtidos
señalar	apontar
desempeña	desempenha
graham	graham
duquesa	duquesa
delito	crime
preocupación	preocupação
metales	metais
sufrir	sofrer
renfe	comboios
golf	golfe
asistencias	assistências
creencias	crenças
sucre	sucre
baltimore	baltimore
stars	stars
reputación	reputação
toman	tomam
party	party
norman	norman
humberto	humberto
participante	participante
conexiones	conexões
conexiones	ligações
cumplimiento	cumprimento
jugados	jogados
aurora	aurora
quedarse	ficar
condujo	conduziu
htm	htm
ámsterdam	amesterdão
ilustración	ilustração
potosí	potosí
efectiva	efetiva
constituyente	constituinte
convertir	converter
emite	emite
llanura	planície
levantamiento	levantamento
hebreo	hebraico
hebreo	hebreu
propaganda	propaganda
desea	deseja
thompson	thompson
jay	jay
secuela	sequela
dirigidas	dirigidas
tributo	tributo
placas	placas
estructural	estrutural
culpa	culpa
causar	causar
concejales	vereadores
singapur	cingapura
desarrollan	desenvolvem
comerciantes	mercadores
bank	bank
meseta	planalto
hamburgo	hamburgo
ordenado	ordenado
pereira	pereira
proporción	proporção
asociada	associada
fiat	fiat
estimada	estimada
interfaz	interface
poniendo	colocando
vuelven	voltam
correa	correia
colaborar	colaborar
arquidiócesis	arquidiocese
episcopal	episcopal
secretaria	secretária
circuitos	circuitos
previas	prévias
magallanes	magalhães
distribuye	distribui
concacaf	concacaf
auxiliar	auxiliar
minería	mineração
corteza	casca
verso	verso
sensación	sensação
afluentes	afluentes
suave	suave
have	have
constantes	constantes
viaja	viaja
cbs	cbs
suizo	suíço
jamaica	jamaica
sencilla	simples
censura	censura
rebelde	rebelde
roll	roll
paco	paco
matías	matias
nancy	nancy
marítima	marítima
canada	canada
crimea	crimeia
liberado	libertado
narrativa	narrativa
gerente	gerente
encuesta	enquete
afecta	afeta
enciclopédico	enciclopédico
pokémon	pokémon
libertador	libertador
generalidad	generalidade
efectivamente	efetivamente
seca	seca
medir	medir
asume	assume
dieta	dieta
aparente	aparente
lanzaron	lançaram
discusiones	discussões
stanley	stanley
panorama	panorama
realistas	realista
rin	reno
animada	animada
nativa	nativa
intensa	intensa
duelo	duelo
legend	legend
seattle	seattle
rectangular	retangular
english	english
acústica	acústica
innovación	inovação
hueso	osso
administrativas	administrativas
donald	donald
rincón	canto
jacob	jacó
ordenador	computador
baño	banho
baño	banheiro
establecidas	estabelecidas
seguros	seguros
correr	correr
hms	hms
telecomunicaciones	telecomunicações
arequipa	arequipa
iris	íris
eventualmente	eventualmente
maldonado	maldonado
ocupando	ocupando
cantando	cantando
examen	exame
depósitos	reservatórios
depósitos	depósitos
ocasionalmente	ocasionalmente
invitada	convidada
gov	gov
homer	homer
liverpool	liverpool
rap	rap
respondió	respondeu
asistir	assistir
turistas	turistas
darío	dário
imdb	imdb
autobús	autocarro
actuando	atuando
anuncia	anuncia
confusión	confusão
lituania	lituânia
unieron	uniram
tendencias	tendências
secretos	segredos
tommy	tommy
probabilidad	probabilidade
disc	disc
exhibición	exibição
exhibición	exposição
amistoso	amigável
amistoso	amistoso
convenio	convênio
elaborado	elaborado
entretenimiento	entretenimento
usadas	usadas
temprano	cedo
norteamericano	americano
aumentó	aumentou
euphorbia	euphorbia
direcciones	endereços
soprano	soprano
now	now
delitos	crimes
atletas	atletas
informa	informa
sonic	sonic
semifinal	semifinal
asumir	assumir
espectro	espectro
serio	sério
conducción	condução
gobernantes	governantes
colocó	colocou
capacidades	capacidades
inteligente	inteligente
introducido	introduzido
ficticio	fictício
manhattan	manhattan
concursos	concursos
partió	partiu
cia	cia
europe	europe
abundantes	abundantes
dosis	dosagem
conocía	conhecia
cubrir	cobrir
antártida	antártida
unen	unem
citas	namoro
aprobada	aprovada
filadelfia	filadélfia
decidido	decidido
baden	baden
vincent	vincent
falso	falso
jesuitas	jesuítas
enfrenta	enfrenta
humedad	humidade
atracción	atração
jurídico	jurídica
tabasco	tabasco
formaciones	formações
testigo	testemunha
afluente	afluente
seguida	seguida
bros	bros
kilómetro	quilômetro
bobby	bobby
lugo	lugo
reptiles	répteis
logo	logo
sustancia	substância
holandés	holandês
plus	plus
estocolmo	estocolmo
nasa	nasa
masiva	maciço
viendo	vendo
viendo	assistindo
mercurio	mercúrio
gilbert	gilbert
escobar	escobar
moléculas	moléculas
regulación	regulamentação
regulación	regulação
sargento	sargento
alturas	alturas
creencia	crença
aterrizaje	aterragem
campbell	campbell
danny	danny
ventajas	vantagens
abandona	abandona
martes	terça
requieren	exigem
pretendía	pretendia
arsenal	arsenal
sociología	sociologia
nigeria	nigéria
constantinopla	constantinopla
extrema	extrema
gibraltar	gibraltar
consola	console
sentimiento	sentimento
complutense	complutense
trato	trato
suficientes	suficientes
when	when
márquez	márquez
flash	flash
place	place
proclamó	proclamou
non	non
reality	reality
castillos	castelos
constituyó	constituiu
fuga	fuga
cleveland	cleveland
dorada	dourada
abuela	vovó
experto	especialista
frontal	frontal
aprovechando	aproveitando
considerablemente	consideravelmente
borgoña	borgonha
huevo	ovo
tragedia	tragédia
dejan	deixam
ubicados	localizados
lagunas	lagoas
beta	beta
contaminación	poluição
contaminación	contaminação
charlotte	charlotte
azteca	asteca
patrones	padrões
how	how
boeing	boeing
transmisiones	transmissões
aliado	aliado
enfrentar	enfrentar
ama	ama
literarios	literários
luchó	lutou
viejos	velhos
traducciones	traduções
pulgadas	polegadas
arnold	arnold
ladrillo	tijolo
calvo	careca
barbara	barbara
creer	crer
creer	acreditar
compartir	compartilhar
niñas	meninas
dependencia	dependência
detective	detetive
probar	experimentar
probar	testar
mónica	mônica
arroyos	córregos
arroyos	riachos
volante	volante
sabio	sábio
budapest	budapeste
beca	bolsa
cráneo	crânio
provocando	provocando
velocidades	velocidades
gobernante	governante
madison	madison
caridad	caridade
leftarm	leftarm
llave	chave
situadas	situadas
exclusiva	exclusividade
estero	estero
reference	reference
philip	philip
merced	mercê
armados	armados
three	three
manuscritos	manuscritos
rivas	rivas
major	major
necesariamente	necessariamente
tve	tve
demonio	demônio
note	note
emitida	emitida
carrillo	carrillo
reside	reside
nazis	nazistas
nazis	nazis
completó	completou
lérida	lérida
internas	internas
valdivia	valdivia
luisiana	luisiana
televisa	televisa
malo	ruim
materias	matérias
urbanas	urbanas
estándares	padrões
gases	gases
festividad	feriado
ferroviario	ferroviário
boletín	boletim
potencias	potências
ejemplar	exemplar
histoire	histoire
separadas	separadas
express	express
portugueses	portugueses
normales	normais
basket	basket
estelar	estelar
montaje	montagem
digo	digo
demo	demo
considerando	considerando
enviados	enviados
fotógrafo	fotografo
fotógrafo	fotógrafo
desconoce	desconhece
kent	kent
larry	larry
porción	porção
asesinados	assassinados
combatientes	combatentes
combatientes	lutadores
oponente	adversário
prince	prince
activamente	ativamente
giuseppe	giuseppe
pura	pura
forestal	florestal
viola	viola
track	track
parodia	paródia
evangelio	evangelho
honda	honda
eléctricos	elétricos
loira	loire
esfera	esfera
muertes	mortes
román	román
intenso	intenso
vaya	eita
alvarado	alvarado
ibáñez	ibáñez
impuso	impôs
litros	litros
penales	penais
shows	shows
constituido	constituído
name	name
consulado	consulado
autorización	autorização
autorización	autorizações
belén	belém
próximos	próximos
discografía	discografia
ponen	põem
rangers	rangers
esquí	esqui
envía	envia
prisionero	prisioneiro
causando	causando
disparo	tiro
teorema	teorema
golpes	golpes
golpes	batidas
mega	mega
atacó	atacou
herbert	herbert
recorre	percorre
dinosaurios	dinossauros
brevemente	brevemente
extranjera	estrangeira
caña	cana
ética	ética
arquitectónico	arquitectónico
other	other
encontrados	encontrados
correspondencia	correspondência
monjes	monges
formatos	formatos
vaticano	vaticano
bombardeo	bombardeamento
respuestas	respostas
cooper	cooper
duero	douro
august	august
cambiando	mudando
típicos	típicos
lento	lento
lento	devagar
summer	summer
dramaturgo	dramaturgo
seudónimo	pseudónimo
sacro	sacro
apoyado	apoiado
astronómico	astronômico
col	repolho
col	couve
col	col
ludwig	ludwig
velázquez	velázquez
líbano	líbano
túnez	tunísia
cena	jantar
four	four
pescado	peixe
republicanos	republicanos
magic	magic
artísticas	artísticas
lujo	luxo
electrones	elétrons
wood	wood
avances	avanços
european	european
vacaciones	férias
murallas	muralhas
descendiente	descendente
abiertos	abertos
sainte	sainte
eta	eta
pts	pts
cóndor	condor
reduce	reduz
coronado	coroado
esperando	esperando
manifestación	manifestação
robles	carvalhos
trajo	trouxe
mansión	mansão
suplente	substituto
convencional	convencional
philippe	philippe
asesinatos	assassinatos
fieles	fiéis
southern	southern
concha	concha
implementación	implementação
correctamente	corretamente
perdida	perdida
ciudadanía	cidadania
modern	modern
significativo	significativo
desastre	desastre
warren	warren
elías	elias
ltd	ltd
identificado	identificado
ejecutar	executar
studio	studio
law	law
destinada	destinada
calificación	qualificação
dramática	dramática
antoine	antoine
plástico	plástico
armadura	armadura
guipúzcoa	guipúzcoa
espaciales	espacial
habido	havido
dedicados	dedicados
bebé	bebê
hits	hits
tenor	tenor
mortal	mortal
tallos	caules
casino	casino
leipzig	leipzig
delegado	delegado
adoptado	adotado
library	library
colinas	colinas
extranjeras	estrangeiras
apolo	apollo
membrana	membrana
etnia	etnia
ruido	ruído
ricos	ricos
radar	radar
wagner	wagner
quieren	querem
teatros	teatros
añadido	adicionado
fabricantes	fabricantes
trabajan	trabalham
pilares	pilares
solía	costumava
guarnición	guarnição
edwards	edwards
fábricas	fábricas
roman	roman
oliva	oliva
conservadores	conservadores
contener	conter
secos	secos
escape	escape
obtuvieron	conseguiram
shakespeare	shakespeare
marín	marín
für	für
under	under
eugenia	eugenia
cap	cap
desarrollados	desenvolvidos
baños	banheiros
alternativas	alternativas
alternativas	alternativa
entiende	entende
entiende	compreende
extracción	extracção
extracción	extração
profundamente	profundamente
fresco	fresco
nacionalismo	nacionalismo
cruzar	atravessar
adulto	adulto
disciplinas	disciplinas
geográficas	geográficas
responder	responder
hermosa	linda
propiamente	propriamente
electrónicos	eletrônicos
galaxia	galáxia
age	age
cubiertas	abrangidas
cubiertas	cobertas
cubiertas	tampas
existió	existiu
dependencias	dependências
produciendo	produzindo
abu	abu
bola	bola
lázaro	lázaro
wolf	wolf
certificado	certificado
vigor	vigor
rita	rita
usaba	usava
uss	uss
escándalo	escândalo
tanque	tanque
sólido	sólido
kiev	kiev
serpiente	serpente
testigos	testemunhas
economista	economista
submarino	submarino
códigos	códigos
prevención	prevenção
abiertas	abertas
descubierta	descoberta
progresivo	progressivo
editó	editou
estudia	estuda
paloma	pomba
folk	folk
ira	ira
ira	raiva
atractivo	atraente
volar	voar
recta	reta
ecuatoriano	equatoriano
publishing	publishing
entregado	entregue
etiopía	etiópia
dick	dick
jefferson	jefferson
centroamérica	centroamérica
celeste	celeste
palermo	palermo
asientos	assentos
dominios	domínios
falsa	falsa
tribunales	tribunais
bond	bond
cerdo	porco
dorsal	dorsal
woman	woman
women	women
blood	blood
danés	dinamarquês
studies	studies
cajas	caixas
pacific	pacific
ring	ring
fiebre	febre
geometría	geometria
pink	pink
doblaje	dobragem
hoteles	hotéis
blas	blas
bull	bull
ayala	ayala
derrotas	derrotas
macizo	maciço
sacramento	sacramento
neil	neil
documentales	documentários
introducir	introduzir
libia	líbia
canciller	chanceler
collins	collins
aldeas	aldeias
silvia	silvia
inmaculada	imaculada
conjuntamente	conjuntamente
potente	potente
desafío	desafio
respectivos	respectivos
cerebral	cerebral
determinados	determinados
santísima	santíssima
soberano	soberano
emi	emi
normandía	normandia
temporalmente	temporariamente
ánimo	ânimo
publicaron	publicaram
chart	chart
divina	divina
hablantes	falantes
quedaba	ficava
quedaba	restava
ilustres	ilustres
acusaciones	acusações
sudoeste	sudoeste
prieto	prieto
oso	urso
cruzada	cruzada
teruel	teruel
nat	nat
mostrado	mostrado
via	via
excentricidad	excentricidade
camp	camp
rivadavia	rivadavia
levante	levante
reunir	reunir
aproximación	aproximação
enfrentaron	enfrentaram
mirada	olhar
hará	fará
marquesado	marquesado
sri	sri
games	games
departamental	departamental
plumas	canetas
consideración	consideração
cerrar	fechar
molino	moinho
tronco	tronco
cuarteto	quarteto
nativo	nativa
nativo	nativo
cook	cook
eeuu	eua
marquesa	marquesa
reducida	reduzida
anatomía	anatomia
monstruo	monstro
escribiendo	escrevendo
dedos	dedos
pasaje	passagem
denis	denis
anunciado	anunciado
mandó	mandou
mató	matou
futbol	futebol
vitoria	vitoria
estonia	estónia
bacterias	bactérias
ortodoxa	ortodoxa
extendido	estendido
arácnidos	aracnídeos
ilegal	ilegal
foundation	foundation
apóstol	apóstolo
ejecutado	executado
denominados	denominados
intentando	tentando
escocés	escocês
crecer	crescer
luchas	lutas
helena	helena
trasera	traseira
apreciar	apreciar
recuperó	recuperou
conducido	conduzido
gabriela	gabriela
radios	rádios
coordinador	coordenador
miércoles	quarta
poseer	possuir
terrorismo	terrorismo
linares	linares
side	side
poderosa	poderosa
lunar	lunar
precipitaciones	precipitação
capturar	capturar
adquiere	adquire
niega	nega
defecto	defeito
marcada	marcada
sud	sud
viajeros	viajantes
sobrevivir	sobreviver
ferrari	ferrari
experimento	experiência
románico	românico
consideradas	consideradas
escasos	escasso
adolescentes	adolescentes
callao	callao
confirmado	confirmado
here	here
habituales	habituais
brooklyn	brooklyn
comunica	comunica
impedir	impedir
lienzo	tela
ascendió	ascendeu
empiezan	começam
taekwondo	taekwondo
solidaridad	solidariedade
gard	gard
evans	evans
accesible	acessível
georg	georg
certificados	certificados
castigo	punição
complejidad	complexidade
renacentista	renascentista
adrián	adrian
head	head
nordeste	nordeste
gallo	galo
nuestras	nossas
ivan	ivan
matthew	matthew
parlamentarias	parlamentares
salomón	salomão
nbc	nbc
exportación	exportação
colectiva	coletiva
colectiva	coletivo
susana	susana
hambre	fome
residuos	resíduos
socialismo	socialismo
américas	américas
directorio	diretório
square	square
cruza	atravessa
leones	leões
consigo	consigo
amy	amy
prohibición	proibição
notablemente	notavelmente
dean	dean
alusión	alusão
leonor	leonor
habitan	habitam
irregular	irregular
videoclip	videoclipe
consecutivos	consecutivos
escudos	escudos
operar	operar
films	films
terapia	terapia
instalado	instalado
famosas	famosas
fallo	falha
barro	lama
banca	banca
banca	bancário
hubiese	tivesse
únicas	únicas
acompañada	acompanhada
luchadores	lutadores
stuttgart	estugarda
edificación	edificação
riesgos	riscos
eco	eco
acosta	acosta
seguramente	certamente
vienen	vêm
apellidos	apelido
apellidos	sobrenome
desarrollaron	desenvolveram
class	class
presentadora	apresentadora
comisario	xerife
decenas	dezenas
campana	campainha
pib	pib
tía	tia
rivalidad	rivalidade
húmedo	húmido
embajadores	embaixadores
hospitales	hospitais
morelos	morelos
astronomía	astronomia
alcanzan	alcançam
alcanzan	atingem
leal	leal
terroristas	terroristas
visuales	visuais
establecimientos	estabelecimentos
guido	guido
comisiones	comissões
detención	detenção
algoritmo	algoritmo
inversiones	investimentos
criaturas	criaturas
lloyd	lloyd
mercancías	mercadorias
construye	constrói
margaret	margaret
hills	hills
ten	ten
jennifer	jennifer
agregar	adicionar
marinas	marinhas
tela	tecido
ataca	ataca
lorca	lorca
refugiados	refugiados
cantera	pedreira
marcel	marcel
dylan	dylan
harold	harold
god	god
dictionary	dictionary
forest	forest
descubridor	descobridor
énfasis	ênfase
combinado	combinado
