les	los
les	las
est	es
une	una
dans	en
catégorie	categoría
par	por
pour	para
sur	en
sur	sobre
qui	que
que	que
avec	con
son	sonido
plus	más
pas	no
sont	son
elle	ella
été	verano
comme	como
mais	pero
cette	esta
pop	pop
deux	dos
ses	sus
naissance	nacimiento
aussi	también
france	francia
the	the
après	después
fait	hecho
notes	notas
entre	entre
même	incluso
être	ser
nom	nombre
français	francés
ont	han
ont	tienen
paris	parís
lui	él
lieu	lugar
autres	otros
décès	muertes
références	referencias
liens	enlaces
était	era
ville	ciudad
jean	juan
date	fecha
peut	puede
depuis	desde
première	primera
alors	entonces
externes	externos
premier	primer
ces	estos
ces	estas
fut	fue
http	http
ainsi	así
film	película
voir	ver
pays	país
pays	países
ils	ellos
grand	grande
tout	todo
groupe	grupo
également	también
titre	título
monde	mundo
nord	norte
années	años
bien	bien
contre	contra
liste	lista
puis	luego
club	club
sud	sur
partie	parte
avant	antes
non	no
très	muy
trois	tres
articles	artículos
article	artículo
guerre	guerra
sans	sin
saison	temporada
fin	fin
vers	gusanos
vers	hacia
année	año
temps	tiempo
plusieurs	varios
faire	hacer
mars	marte
histoire	historia
série	serie
joueur	jugador
mai	mayo
tour	torre
mort	muerte
juin	junio
jpg	jpg
pierre	piedra
région	región
janvier	enero
avoir	tener
septembre	septiembre
juillet	julio
état	estado
église	iglesia
octobre	octubre
place	plaza
famille	familia
états	estados
général	general
avril	abril
insee	insee
tous	todos
politique	política
album	álbum
décembre	diciembre
août	agosto
novembre	noviembre
avait	tenía
prix	precios
align	align
nouvelle	nueva
février	febrero
département	departamento
peu	poco
américain	americano
ligne	línea
suite	suite
championnat	campeonato
selon	según
image	imagen
vie	vida
unis	unidos
lien	enlace
football	fútbol
pendant	durante
jeux	juegos
moins	menos
ouest	oeste
page	página
nouveau	nuevo
vous	usted
centre	centro
cours	curso
cours	cursos
partir	partir
village	aldea
université	universidad
nombre	número
siècle	siglo
coupe	copa
population	población
connexes	relacionados
homme	hombre
division	división
président	presidente
national	nacional
société	sociedad
quatre	cuatro
cas	caso
cas	casos
jeu	juego
genre	género
musique	música
fils	hijo
roi	rey
parti	partido
jour	día
europe	europa
forme	forma
époque	época
new	new
ancien	antiguo
origine	origen
ordre	orden
château	castillo
école	escuela
carrière	carrera
deuxième	segundo
bar	bar
points	puntos
ayant	habiendo
paul	pablo
rue	calle
chef	jefe
père	padre
exemple	ejemplo
durant	durant
rapport	informe
art	arte
canton	cantón
dernier	último
type	tipo
point	punto
compte	cuenta
période	período
armée	ejército
eau	agua
marie	maría
discuter	discutir
car	car
projet	proyecto
chaque	cada
anglais	inglés
province	provincia
john	john
international	internacional
conseil	consejo
françois	francisco
maison	casa
cela	esto
demande	solicitud
fonction	función
toujours	siempre
doit	debe
production	producción
certains	algunos
membre	miembro
meilleur	mejor
droit	derecho
mois	mes
île	isla
république	república
service	servicio
ensuite	luego
langue	idioma
dit	dice
gouvernement	gobierno
center	center
elles	ellas
petit	pequeño
toutes	todas
argent	plata
style	estilo
face	face
quand	cuando
top	top
ministre	ministro
ensemble	conjunto
ensemble	juntos
ensemble	juntas
théâtre	teatro
épisode	episodio
scène	escena
situé	situado
toute	toda
asp	asp
étaient	eran
étaient	fueron
musée	museo
troisième	tercera
auteur	autor
nous	nosotros
système	sistema
création	creación
stade	estadio
tant	tanto
reste	resto
text	text
roman	roman
roman	novela
jours	días
édition	edición
éditions	ediciones
historique	histórico
sera	sera
sera	será
permet	permite
âge	edad
robert	robert
environ	aproximadamente
effet	efecto
version	versión
membres	miembros
niveau	nivel
champion	campeón
espèce	especie
michel	miguel
raison	razón
modèle	modelo
travail	trabajo
femme	mujer
cinq	cinco
déjà	ya
bas	bajo
texte	texto
terre	tierra
allemagne	alemania
from	from
compétition	competición
wikipédia	wikipedia
allemand	alemán
britannique	británico
porte	puerta
hommes	hombres
italie	italia
bataille	batalla
corps	cuerpo
siège	sede
personnes	personas
nommé	nombrado
route	carretera
finale	final
jeune	joven
peuvent	pueden
york	york
royaume	reino
long	largo
long	long
latitude	latitud
base	base
études	estudios
communauté	comunidad
association	asociación
militaire	militar
section	sección
bronze	bronce
livre	libro
haut	alto
haut	arriba
suisse	suiza
canada	canadá
valign	valign
suivant	siguiente
beaucoup	mucho
dire	decir
seul	solo
fille	chica
buts	goles
enfants	niños
position	posición
pouvoir	poder
but	gol
merci	merci
merci	gracias
tête	cabeza
territoire	territorio
union	union
union	unión
construction	construcción
ancienne	antigua
premiers	primeros
prend	toma
maire	alcalde
présente	presenta
personnalité	personalidad
ligue	liga
public	público
pages	páginas
agit	actúa
externe	externo
externe	externa
simple	simple
dernière	última
henri	enrique
chanson	canción
poste	puesto
culture	cultura
grâce	gracia
développement	desarrollo
sortie	salida
empire	imperio
québec	quebec
david	david
loi	ley
côté	lado
mer	mar
haute	alta
espagne	españa
mère	madre
fichier	archivo
acteur	actor
recherche	búsqueda
classement	clasificación
code	código
double	doble
entraîneur	entrenador
web	web
directeur	director
joseph	josé
semble	parece
ici	aquí
ici	aqui
vainqueur	ganador
réalisé	realizado
existe	existe
six	seis
créé	creado
devant	delante
écrit	escrito
petite	pequeña
bois	madera
entreprise	empresa
retour	retorno
retour	volver
comté	condado
gare	estación
terme	término
connu	conocido
formation	formación
arts	artes
technique	técnica
révolution	revolución
etc	etc
objet	objeto
mon	mi
philippe	felipe
question	pregunta
lorsque	cuando
cinéma	cine
plan	plano
van	van
médaille	medalla
serait	sería
œuvres	obras
zone	zona
écrivain	escritor
compagnie	compañía
italien	italiano
championnats	campeonatos
films	películas
parc	parque
moyenne	promedio
mouvement	movimiento
furent	fueron
succès	éxito
jamais	nunca
vidéo	video
martin	martin
député	congresista
député	diputado
claude	claude
moyen	medio
till	till
san	san
notre	nuestra
notre	nuestro
bon	bueno
peintre	pintor
voix	voz
rouge	rojo
district	distrito
seulement	solo
seulement	sólo
pont	puente
libre	libre
air	air
festival	festival
belgique	bélgica
grands	grandes
georges	jorge
blanc	blanco
gauche	izquierda
travaux	trabajos
donne	da
passe	pasa
produit	producto
diffusion	difusión
aide	ayuda
action	acción
andré	andré
font	font
réseau	red
utilisé	utilizado
victoire	victoria
femmes	mujeres
minutes	minutos
autour	alrededor
left	left
belge	belga
certaines	algunas
durée	duración
espèces	especies
angleterre	inglaterra
afrique	áfrica
monuments	monumentos
sens	sentido
personne	nadie
municipalité	municipio
frère	hermano
rencontre	encuentro
trop	demasiado
matchs	partidos
japon	japón
domaine	dominio
eux	ellos
professeur	profesor
particulier	particular
quartier	barrio
scientifique	científico
honneur	honor
seule	sola
cause	causa
rien	nada
nouvelles	noticias
iii	iii
administration	administración
comte	conde
fort	fuerte
hockey	hockey
moi	yo
différents	diferentes
rome	roma
possible	posible
dix	diez
taille	tamaño
sport	deporte
principal	principal
référence	referencia
croix	cruz
mettre	poner
titres	títulos
enfin	finalmente
millions	millones
noir	negro
londres	londres
agglomération	aglomeración
moment	momento
chapelle	capilla
russe	ruso
prince	príncipe
activités	actividades
monument	monumento
sciences	ciencias
radio	radio
classe	clase
aucun	ninguno
droite	derecha
lieux	lugares
née	nacida
actuel	actual
espace	espacio
villes	ciudades
fer	hierro
activité	actividad
commence	comienza
organisation	organización
sélection	selección
assez	suficiente
assez	bastante
institut	instituto
james	james
internationale	internacional
sept	siete
lac	lago
fiche	ficha
affaires	negocios
télévision	televisión
duc	duque
personnage	personaje
précédent	anterior
évêque	obispo
richard	ricardo
adresse	dirección
php	php
william	william
thomas	thomas
ball	ball
résultats	resultados
problème	problema
finalement	finalmente
bonne	buena
nature	naturaleza
michael	michael
vol	vuelo
port	puerto
right	right
premières	primeras
donné	donado
donné	dado
discussion	discusión
dame	dama
axe	eje
mesure	medida
voie	vía
prendre	tomar
important	importante
données	datos
force	fuerza
pologne	polonia
couleur	color
collection	colección
actrice	actriz
élu	elegido
régiment	regimiento
dessus	encendido
loire	loira
bande	banda
capitale	capital
côte	costa
étape	etapa
créée	creada
combat	combate
footballeur	futbolista
forces	fuerzas
royal	royal
aucune	ninguna
russie	rusia
nicolas	nicolás
mètres	metros
possède	posee
presse	prensa
académie	academia
construit	construido
tournoi	torneo
épisodes	episodios
entrée	entrada
revue	revista
jeunes	jóvenes
présence	presencia
ceinture	cinturón
heures	horas
maître	maestro
services	servicios
marque	marca
single	single
intérieur	interior
appelé	llamado
olympique	olímpico
subdivision	subdivisión
bernard	bernard
qualité	calidad
langues	idiomas
langues	lenguas
propre	limpio
chine	china
patrimoine	patrimonio
com	com
évolution	evolución
tours	tours
obtient	obtiene
compositeur	compositor
joueurs	jugadores
lyon	lyon
généralement	generalmente
von	von
amérique	américa
mal	mal
rock	rock
abbaye	abadía
nuit	noche
principalement	principalmente
prise	toma
bretagne	bretaña
avaient	tenían
clubs	clubes
met	met
vitesse	velocidad
chemin	camino
réalisation	realización
groupes	grupos
éléments	elementos
salle	sala
carte	mapa
périhélie	perihelio
travers	travers
valeur	valor
utilisation	uso
palais	palacio
émission	emisión
composé	compuesto
situation	situación
droits	derechos
court	corto
vallée	valle
comité	comité
anciens	antiguos
rugby	rugby
basse	baja
pro	pro
total	total
for	for
nationalité	nacionalidad
chambre	habitación
nouveaux	nuevos
savoir	saber
glace	hielo
proche	cerca
mot	palabra
main	mano
huit	ocho
voïvodie	voivodato
assemblée	asamblea
populaire	popular
critique	crítico
publication	publicación
dieu	dios
uni	uni
japonais	japonés
hôtel	hotel
australie	australia
catholique	católico
mission	misión
https	https
accord	acuerdo
campagne	campaña
rapidement	rápidamente
traduction	traducción
anne	ana
montréal	montreal
programme	programa
bgcolor	bgcolor
coup	golpe
enfant	niño
mieux	mejor
maurice	mauricio
défense	defensa
vice	vicio
contrôle	control
noms	nombres
produits	productos
internet	internet
hiver	invierno
fondation	fundación
troupes	tropas
antoine	antonio
daniel	daniel
îles	islas
pris	tomado
marine	marina
bâtiment	edificio
peter	peter
fondé	fundado
der	der
vient	viene
seine	sena
amour	amor
mont	monte
statistiques	estadísticas
science	ciencia
personnages	personajes
bonjour	hola
marc	marc
altitude	altitud
unité	unidad
particulièrement	especialmente
lignes	líneas
traité	tratado
idée	idea
éditeur	editor
littérature	literatura
attaque	ataque
records	records
principaux	principales
chaîne	cadena
fondée	fundada
actuellement	actualmente
pourrait	podría
fond	fondo
format	formato
mode	moda
original	original
espagnol	español
producteur	productor
artiste	artista
créer	crear
composition	composición
décide	decide
garde	guardia
votre	su
sécurité	seguridad
fédération	federación
quatrième	cuarta
junior	junior
police	policía
comédie	comedia
bruxelles	bruselas
empereur	emperador
infanterie	infantería
ministère	ministerio
chevalier	caballero
armes	armas
livres	libros
personnalités	personalidades
unique	único
capitaine	capitán
guillaume	guillermo
tel	tal
tel	tel
commission	comisión
divers	varios
décision	decisión
classique	clásico
présent	presente
fit	fit
passé	pasado
mandat	mandato
berlin	berlín
isbn	isbn
surface	superficie
architecture	arquitectura
inscrit	inscrito
astéroïde	asteroide
transport	transporte
rené	rené
alexandre	alejandro
oui	sí
annonce	anuncio
pratique	práctico
conseiller	consejero
portail	portal
terrain	terreno
comprend	incluye
secrétaire	secretario
world	world
tennis	tenis
donner	dar
chose	cosa
pièces	piezas
fonctions	funciones
accès	acceso
informations	información
marché	mercado
charge	carga
alpes	alpes
sites	sitios
basket	baloncesto
utiliser	usar
économie	economía
longueur	longitud
légende	leyenda
pense	piensa
vingt	veinte
vingt	vingt
arrivée	llegada
conditions	condiciones
protection	protección
scénariste	guionista
bibliothèque	biblioteca
influence	influencia
énergie	energía
petits	pequeños
parties	partes
fiction	ficción
structure	estructura
laurent	lorenzo
kilomètres	kilómetros
jeunesse	juventud
régions	regiones
majorité	mayoría
passer	pasar
enseignement	enseñanza
seigneur	señor
veut	quiere
exposition	exposición
poids	peso
santé	salud
heure	hora
feu	fuego
profession	profesión
trouver	encontrar
voyage	viajes
supérieur	superior
logo	logo
logo	logotipo
gestion	gestión
permettant	permitiendo
derniers	últimos
localité	localidad
arrière	atrás
henry	henry
autriche	austria
résultat	resultado
couleurs	colores
comment	cómo
central	central
signe	signo
apparaît	aparece
orchestre	orquesta
concours	concurso
moderne	moderno
longue	larga
termine	finaliza
termine	termina
phase	fase
problèmes	problemas
journaliste	periodista
record	récord
célèbre	famoso
doivent	deben
mariage	boda
devenir	convertirse
svg	svg
architecte	arquitecto
message	mensaje
artistes	artistas
constitution	constitución
nos	nuestras
nos	nuestros
roger	roger
géolocalisation	geolocalización
presque	casi
propose	propone
esprit	espíritu
suivi	seguimiento
moteur	motor
relations	relaciones
ouverture	apertura
alain	alain
séries	series
vienne	viena
galerie	galería
découvert	descubierto
parlement	parlamento
zip	zip
étudiant	estudiante
techniques	técnicas
théorie	teoría
doute	duda
suppression	eliminación
mémoire	memoria
ami	amigo
super	super
arrive	llega
images	imágenes
éducation	educación
magazine	revista
don	don
aller	ir
officier	oficial
note	nota
hauteur	altura
morts	muertos
camp	campamento
considéré	considerado
secteur	sector
probablement	probablemente
social	social
représentant	representante
saisons	temporadas
temple	templo
forêt	bosque
importance	importancia
maintenant	ahora
conflit	conflicto
commandant	comandante
meurt	muere
ben	ben
docteur	doctor
christian	christian
gouverneur	gobernador
artistique	artístico
loin	lejos
collège	colegio
bassin	cuenca
victoires	victorias
bureau	oficina
contrat	contrato
féminin	femenino
romain	romano
professionnel	profesional
marseille	marsella
arbitre	árbitro
justice	justicia
directement	directamente
appel	llamada
semaine	semana
pied	pie
you	you
chanteur	cantante
neuf	nueve
européen	europeo
photographie	fotografía
principe	principio
latin	latín
victor	víctor
connue	conocida
distribution	distribución
environnement	entorno
canadien	canadiense
utilisée	usada
fontsize	fontsize
entreprises	empresas
lumière	luz
supérieure	superior
frères	hermanos
automobile	automóvil
train	tren
soviétique	soviético
lieutenant	teniente
textes	textos
moitié	mitad
pilote	piloto
studio	estudio
réponse	respuesta
reine	reina
patrick	patrick
physique	física
auteurs	autores
chansons	canciones
compris	entendido
compris	comprendido
représente	representa
via	via
californie	california
volume	volumen
militaires	militares
pape	papa
quoi	qué
questions	preguntas
parle	habla
courant	corriente
lire	leer
industrie	industria
terres	tierras
denis	denis
brésil	brasil
man	man
opération	operación
piste	pista
paix	paz
vieux	viejo
propriétaire	propietario
faible	débil
pyrénées	pirineos
algérie	argelia
chargé	cargado
cathédrale	catedral
participation	participación
puissance	potencia
zones	zonas
final	final
simon	simon
endémique	endémico
formule	fórmula
value	value
opéra	ópera
reçu	recibido
joué	jugado
derrière	detrás
piano	piano
montagne	montaña
découverte	descubrimiento
beaux	hermosos
front	frente
circonscription	circunscripción
poète	poeta
marcel	marcel
champ	campo
val	val
archives	archivo
vote	votación
projets	proyectos
formes	formas
proximité	proximidad
seront	serán
seront	seran
alt	alt
obtenir	obtener
blanche	blanca
continue	sigue
chant	canto
mondial	mundial
colonel	coronel
congrès	congresos
chinois	chino
frédéric	federico
soleil	sol
utilisateur	usuario
allemands	alemanes
moscou	moscú
sportif	deportivo
amis	amigos
lnh	nhl
toulouse	toulouse
peinture	pintura
légion	legión
inclinaison	inclinación
figure	figura
mexique	méxico
limite	límite
dernières	últimas
cinquième	quinta
guitare	guitarra
liberté	libertad
html	html
contenu	contenido
fête	fiesta
rhône	ródano
photo	foto
canal	canal
vincent	vicente
jouer	jugar
jules	jules
aphélie	afelio
polonais	polaco
analyse	análisis
côtés	lados
offre	oferta
sauf	excepto
sauf	salvo
travaille	trabaja
frontière	frontera
max	max
américains	americanos
existence	existencia
indépendance	independencia
anciennes	antiguas
eaux	aguas
bâtiments	edificios
love	love
résistance	resistencia
mes	mis
dessous	debajo
smith	smith
caractère	carácter
contient	contiene
bleu	azul
asie	asia
jack	jack
classé	archivado
excentricité	excentricidad
www	www
guy	guy
signifie	significa
tome	tomo
objets	objetos
sommet	cumbre
border	border
faits	hechos
construite	construida
matière	asignatura
licence	licencia
juifs	judíos
écrire	escribir
lance	lanza
ehess	ehess
besoin	necesidad
fondateur	fundador
grec	griego
bordeaux	burdeos
règles	reglas
soldats	soldados
mark	mark
chicago	chicago
provence	provenza
publie	publica
religion	religión
successeur	sucesor
cimetière	cementerio
somme	suma
formé	formado
éviter	evitar
défaite	derrota
sports	deportes
ceci	esto
maritime	marítima
cardinal	cardenal
exploitation	explotación
encyclopédie	enciclopedia
résumé	resumen
lorraine	lorena
lutte	lucha
parents	padres
tournée	gira
rose	rosa
disque	disco
recensement	censo
philosophie	filosofía
open	open
hôpital	hospital
propriété	propiedad
cycliste	ciclista
collaboration	colaboración
ouvert	abierto
parler	hablar
expression	expresión
astéroïdes	asteroides
nécessaire	necesario
suède	suecia
difficile	difícil
inconnu	desconocido
tom	tom
champions	campeones
modèles	modelos
meilleurs	mejores
animaux	animales
cheval	caballo
soutien	apoyo
navires	buques
dispose	dispone
débuts	debut
milan	milán
rive	ribera
animation	animación
raymond	raymond
méthode	método
communication	comunicación
petites	pequeñas
commun	común
jardin	jardín
min	min
avion	avión
paroisse	parroquia
internes	internos
mots	palabras
portugal	portugal
vert	verde
strasbourg	estrasburgo
personnel	personal
local	local
frank	frank
olivier	olivier
catherine	catalina
historien	historiador
inde	india
relation	relación
relation	relacion
baptiste	bautista
maisons	casas
apparition	aparición
manque	falta
comptait	contaba
plein	lleno
naturel	natural
opposition	oposición
simplement	simplemente
essentiellement	esencialmente
adaptation	adaptación
music	music
gérard	gérard
argument	argumento
semaines	semanas
familles	familias
expérience	experiencia
gardien	guardián
appelle	llama
dramatique	dramático
extérieur	exterior
restauration	restauración
draft	draft
médecine	medicina
marne	marne
régional	regional
thème	tema
prison	prisión
distance	distancia
capacité	capacidad
littéraire	literario
écoles	escuelas
arrêté	arrestado
tradition	tradición
réalité	realidad
savoie	saboya
connaissance	conocimiento
étoile	estrella
marche	marcha
jaune	amarillo
serbie	serbia
permettent	permiten
traitement	tratamiento
masse	masa
arc	arco
devait	debía
tombe	tumba
risque	riesgo
socialiste	socialista
vrai	cierto
armées	ejércitos
baseball	béisbol
arabe	árabe
acte	acto
arthur	arturo
live	live
grèce	grecia
major	mayor
santa	santa
essai	ensayo
décrit	describe
décrit	descrito
écosse	escocia
albums	álbumes
héros	héroe
team	team
reprend	retoma
termes	términos
nantes	nantes
filles	niñas
filles	chicas
midi	mediodía
midi	midi
aura	aura
pdf	pdf
ciel	cielo
anti	anti
rang	rango
washington	washington
maladie	enfermedad
aéroport	aeropuerto
king	king
dictionnaire	diccionario
autorité	autoridad
with	with
préfecture	prefectura
futur	futuro
objectif	objetivo
cap	cabo
ingénieur	ingeniero
actes	actos
irlande	irlanda
occupe	ocupa
hongrie	hungría
peine	pena
absence	ausencia
importants	importantes
guerres	guerras
yves	yves
crise	crisis
brigade	brigada
chapitre	capítulo
laisse	deja
madrid	madrid
cordialement	atentamente
drapeau	bandera
utilisés	utilizados
application	aplicación
responsable	responsable
circuit	circuito
banque	banco
décédé	fallecido
danse	danza
genève	ginebra
développé	desarrollado
systèmes	sistemas
élèves	alumnos
officiellement	oficialmente
remplacé	reemplazado
remplacé	sustituido
fleuve	río
univers	universo
villages	aldeas
critiques	críticas
vraiment	realmente
american	american
argentine	argentina
salon	salón
écriture	escritura
libération	liberación
entièrement	totalmente
places	plazas
largement	extensamente
largement	ampliamente
die	die
jazz	jazz
caractéristiques	características
réunion	reunión
trente	treinta
julien	julien
chasse	caza
processus	proceso
gaz	gas
orléans	orleans
catégories	categorías
park	park
propres	limpios
press	press
united	united
mixte	mixto
régulièrement	regularmente
gmina	gmina
lee	lee
rapide	rápido
agriculture	agricultura
traduit	traducido
chœur	coro
décret	decreto
plantes	plantas
permettre	permitir
nommée	nombrada
résidence	residencia
fusion	fusión
critères	criterios
commandement	mando
portrait	retrato
mairie	ayuntamiento
jan	jan
sang	sangre
jeanne	juana
indique	indica
yeux	ojos
désigne	designa
all	all
types	tipos
évolue	evoluciona
prédécesseur	predecesor
retraite	retiro
description	descripción
table	mesa
table	tabla
magnitude	magnitud
blue	blue
emploi	empleo
promotion	promoción
alliance	alianza
obtenu	obtenido
unités	unidades
faune	fauna
originaire	originario
actions	acciones
baron	barón
biographie	biografía
effets	efectos
bosnie	bosnia
explique	explica
égypte	egipto
avenue	avenida
blocage	bloqueo
dominique	dominica
nœud	nudo
serbe	serbio
christophe	christophe
atelier	taller
auguste	augusto
raisons	razones
devrait	debería
francis	francis
atlantique	atlántico
cent	cien
cent	cent
voiture	coche
agent	agente
disney	disney
chute	caída
communiste	comunista
présentation	presentación
trouvent	encuentran
étranger	extranjero
documentaire	documental
cartes	mapas
sièges	asientos
secret	secreto
couple	pareja
col	col
métro	metro
mary	mary
conférence	conferencia
palmarès	palmarés
alsace	alsacia
mains	manos
alfred	alfred
locaux	locales
coureur	corredor
basé	basado
différence	diferencia
bateau	barco
enregistré	registrado
xls	xls
connexe	relacionado
changement	cambio
députés	diputados
commencé	comenzado
électrique	eléctrico
opérations	operaciones
vite	rápido
diocèse	diócesis
rhin	rin
identité	identidad
normandie	normandía
culturel	cultural
variation	variación
romans	novelas
bourg	bourg
rejoindre	unirse
hommage	homenaje
collecte	recogida
seuls	solos
juge	juez
néerlandais	holandés
lille	lille
complexe	complejo
und	und
concept	concepto
titulaire	titular
diffusée	difundida
contexte	contexto
contact	contacto
fortement	fuertemente
vis	tornillo
concert	concierto
lois	leyes
douze	doce
ferme	granja
one	one
hautes	altas
édouard	eduardo
massif	macizo
vente	venta
athlétisme	atletismo
culte	culto
avocat	abogado
bras	brazos
calais	calais
proposition	propuesta
conduit	conduce
perdu	perdido
nice	niza
visite	visita
solution	solución
promu	promovido
portes	puertas
informatique	informática
mur	muro
scientifiques	científicos
tourisme	turismo
green	green
luc	luc
façade	fachada
statue	estatua
photos	fotos
construire	construir
scott	scott
liège	corcho
utilisant	usando
utilisant	utilizando
huile	aceite
convention	convención
orient	oriente
dessin	dibujo
barcelone	barcelona
manuel	manual
joe	joe
pression	presión
maroc	marruecos
faux	falso
constitué	constituido
christ	cristo
colombie	colombia
baie	bahía
documents	documentos
athlète	atleta
bourgogne	borgoña
destination	destino
champs	campos
vierge	virgen
lesquels	cuáles
température	temperatura
enfance	infancia
acteurs	actores
candidat	candidato
lancé	lanzado
dates	fechas
procès	juicio
cercle	círculo
essais	ensayos
aider	ayudar
mention	mención
arrêt	parada
agence	agencia
perd	pierde
mari	mari
élément	elemento
pouvait	podía
représentation	representación
cycle	ciclo
renaissance	renacimiento
hall	pasillo
attention	atención
jones	jones
marin	marino
domaines	dominios
usine	fábrica
fontaine	fuente
parlementaire	parlamentario
roland	roland
printemps	primavera
prêtre	sacerdote
étoiles	estrellas
réforme	reforma
chris	chris
gabriel	gabriel
monastère	monasterio
organisé	organizado
dos	espalda
noël	navidad
trouvé	encontrado
anomalie	anomalía
ign	ign
beau	guapo
villa	villa
lecture	lectura
montage	montaje
dollars	dólares
masculin	masculino
branche	rama
batterie	batería
pointe	punta
thèse	tesis
rgb	rgb
géographie	geografía
nancy	nancy
amateur	amateur
ascendant	ascendente
caroline	carolina
participer	participar
autorités	autoridades
test	prueba
west	west
relativement	relativamente
exemplaires	ejemplares
versions	versiones
venir	venir
laisser	dejar
gilles	gilles
plateau	bandeja
bataillon	batallón
vin	vino
découvreur	descubridor
spécialiste	especialista
vivant	vivo
ressources	recursos
ajouter	añadir
régionale	regional
rencontres	encuentros
demander	preguntar
israël	israel
tué	asesinado
généraux	generales
siècles	siglos
présenté	presentado
territoires	territorios
png	png
mike	mike
napoléon	napoleón
net	net
planète	planeta
intervention	intervención
législature	legislatura
bob	bob
white	white
océan	océano
idées	ideas
combats	combates
corée	corea
tokyo	tokio
bus	autobús
comprendre	comprensión
vivre	vivir
edward	edward
ordres	órdenes
arme	arma
dynastie	dinastía
erreur	error
publications	publicaciones
coll	coll
organisme	organismo
williams	williams
faculté	facultad
génération	generación
expédition	expedición
tchèque	checo
google	google
européens	europeos
arbre	árbol
tribunal	tribunal
appartient	pertenece
règle	regla
walter	walter
possibilité	posibilidad
euros	euros
avions	aviones
archevêque	arzobispo
regroupe	agrupa
participants	participantes
dvd	dvd
artillerie	artillería
mesures	medidas
occupation	ocupación
vent	viento
logiciel	software
définition	definición
danemark	dinamarca
administrateur	administrador
vos	sus
bruno	bruno
travailler	trabajar
églises	iglesias
mouvements	movimientos
princesse	princesa
volonté	voluntad
germain	germain
oiseaux	aves
homonymie	desambiguación
race	raza
sûr	seguro
disponible	disponible
totalement	totalmente
ski	esquí
ouvre	abre
échelle	escala
machine	máquina
luxembourg	luxemburgo
buteur	goleador
dimanche	domingo
électronique	electrónica
fil	hilo
suivre	seguir
sixième	sexto
accident	accidente
cérémonie	ceremonia
discours	discurso
bill	bill
finaliste	finalista
humaine	humana
échange	intercambio
usa	usa
riche	rico
complète	completa
néo	neo
langage	lenguaje
feuilles	hojas
maréchal	mariscal
répondre	responder
herzégovine	herzegovina
spectacle	espectáculo
plans	planos
moulin	molino
déclare	declara
débat	debate
numérique	digital
mayotte	mayotte
musicien	músico
champagne	champaña
disparu	desaparecido
biens	bienes
poésie	poesía
choisi	selecto
choisi	elegido
valeurs	valores
accueil	inicio
tar	tar
productions	producciones
fédéral	federal
big	big
montagnes	montañas
louise	luisa
supprimer	eliminar
aventure	aventura
harry	harry
claire	claire
dirigé	dirigido
carlos	carlos
guide	guía
solid	solid
anna	anna
jésus	jesús
steve	steve
initialement	originalmente
initialement	inicialmente
actif	activo
événement	evento
installe	instala
fonctionnement	funcionamiento
rennes	rennes
extrême	extremo
populations	poblaciones
contributions	contribuciones
venise	venecia
associé	asociado
zonage	zonificación
civil	civil
connaître	conocer
tunisie	túnez
group	group
élus	elegidos
tiers	terceros
commande	pedido
porté	portado
interprète	intérprete
tony	tony
standard	estándar
médias	medios
introduction	introducción
porter	porter
approche	enfoque
reconnaissance	reconocimiento
boston	boston
effectue	efectúa
eric	eric
provinces	provincias
pose	posando
orange	naranja
adam	adán
fleurs	flores
missions	misiones
flotte	flota
dessins	dibujos
monsieur	señor
côtes	costas
chefs	jefes
amateurs	aficionados
turquie	turquía
localisation	localización
gagne	gana
officiers	oficiales
origines	orígenes
indépendant	independiente
émile	émile
écrits	escritos
house	house
importe	importa
marquis	marqués
pouvoirs	poderes
commercial	comercial
bat	bat
césar	césar
suédois	sueco
young	young
victimes	víctimas
mille	mil
direct	directo
couronne	corona
attaquant	delantero
mini	mini
privé	privado
appareil	aparato
commons	commons
diffusé	difundido
outils	herramientas
complet	completo
florence	florencia
trophée	trofeo
finlande	finlandia
paroles	letras
envoyé	enviado
tôt	temprano
comportement	comportamiento
contributeur	colaborador
humain	humano
info	info
signé	firmado
texas	texas
russes	rusos
septième	séptimo
sélections	selecciones
pascal	pascal
étend	extiende
maillot	camiseta
lune	luna
orbite	órbita
championne	campeona
développer	desarrollar
extension	extensión
scènes	escenas
amiral	almirante
murs	paredes
francs	francos
norvège	noruega
college	college
life	life
corse	córcega
mario	mario
initiative	iniciativa
déroulant	desplegable
autonome	autónoma
marguerite	margarita
mathématiques	matemáticas
brown	brown
améliorer	mejorar
sénateur	senador
montpellier	montpellier
morte	muerta
serge	sergio
rouen	rouen
profondeur	profundidad
partage	comparte
changer	cambiar
croissance	crecimiento
interne	interna
interne	interno
portugais	portugués
stations	estaciones
profil	perfil
hans	hans
maximum	máximo
cabinet	gabinete
toi	tú
toi	ti
thierry	thierry
saône	saône
ère	era
présidence	presidencia
voyageurs	viajeros
sculpteur	escultor
alexander	alexander
vision	visión
miss	miss
metz	metz
forêts	bosques
étapes	pasos
céleste	celeste
sam	sam
contenant	conteniendo
modifier	editar
dehors	fuera
servir	servir
protéger	proteger
pacifique	pacífico
madame	señora
fédérale	federal
sébastien	sebastián
défenseur	defensor
œil	ojo
diplôme	diploma
lié	vinculado
récit	narración
réaction	reacción
cyclisme	ciclismo
fabrication	fabricación
nucléaire	nuclear
karl	karl
chevaux	caballos
climat	clima
instrument	instrumento
respectivement	respectivamente
représentants	representantes
automne	otoño
caractères	caracteres
secondaire	secundaria
trains	trenes
grenoble	grenoble
animal	animal
roumanie	rumania
victime	víctima
semi	semi
reconnu	reconocido
rues	calles
véhicules	vehículos
garonne	garona
interprétation	interpretación
considérée	considerada
proposé	propuesto
papier	papel
gray	gray
emmanuel	emmanuel
plante	planta
boulevard	bulevar
interdit	prohibido
entier	entero
london	london
angle	ángulo
contemporain	contemporáneo
barrage	presa
immédiatement	inmediatamente
anvers	amberes
giovanni	giovanni
sable	arena
présents	presentes
toronto	toronto
domicile	domicilio
aime	ama
routes	rutas
routes	carreteras
impose	impone
programmes	programas
flore	flora
budget	presupuesto
noblesse	nobleza
précise	precisa
toile	lienzo
inspiré	inspirado
évaluation	evaluación
classification	clasificación
détruit	destruido
quartiers	barrios
principes	principios
disparition	desaparición
bistro	bistro
échec	fracaso
rédaction	redacción
serveur	servidor
liée	vinculada
hausse	subida
oise	oise
signature	firma
trône	trono
prennent	toman
carl	carl
produire	producir
chien	perro
urss	urss
correspondant	corresponsal
time	time
zélande	zelanda
secondes	segundos
studios	estudios
roche	roca
connus	conocidos
largeur	anchura
largeur	ancho
remplacer	reemplazar
org	org
françoise	françoise
spécial	especial
foi	fe
professionnels	profesionales
récemment	recientemente
munich	múnich
institutions	instituciones
vii	vii
pêche	pesca
complètement	totalmente
complètement	completamente
volumes	volúmenes
nation	nación
accueille	acoge
symbole	símbolo
alger	argel
catalogue	catálogo
prisonniers	prisioneros
francophone	francófona
tir	tiro
puits	pozo
salles	salas
philosophe	filósofo
étudie	estudia
facilement	fácilmente
benoît	benedicto
décidé	decidido
end	end
coups	golpes
johnson	johnson
hongrois	húngaro
rois	reyes
modification	modificación
pieds	pies
pensée	pensamiento
phénomène	fenómeno
bel	bel
planètes	planetas
engage	contrata
vaste	vasto
déposé	depositado
roy	roy
exemples	ejemplos
nomme	nombra
marins	marineros
poèmes	poemas
tendance	tendencia
libéral	liberal
orientation	orientación
post	post
xxx	xxx
congo	congo
street	street
ennemi	enemigo
moselle	mosela
multiples	múltiples
indien	indio
comptes	cuentas
joueuse	jugadora
calendrier	calendario
clocher	campanario
mécanique	mecánica
jérusalem	jerusalén
étrangers	extranjeros
cavalerie	caballería
écran	pantalla
concerts	conciertos
organise	organiza
jim	jim
industriel	industrial
rester	permanecer
consommation	consumo
brian	brian
condition	condición
utilisateurs	usuarios
plaine	llanura
perte	pérdida
méthodes	métodos
impact	impacto
candidats	candidatos
victoria	victoria
attaques	ataques
portée	alcance
quitter	abandonar
oscar	oscar
définitivement	definitivamente
établi	establecido
compose	compone
collectif	colectivo
compétitions	competiciones
quantité	cantidad
conseillers	consejeros
versailles	versalles
anniversaire	cumpleaños
conservateur	conservador
niveaux	niveles
alex	alex
noter	calificar
capable	capaz
communautés	comunidades
estime	estima
couverture	portada
cuisine	cocina
arbres	árboles
émissions	emisiones
disposition	disposición
racing	racing
conservatoire	conservatorio
parallèle	paralelo
sénat	senado
humains	humanos
donnant	dando
ray	ray
huitième	octavo
pos	pos
bertrand	bertrand
blues	blues
entrer	entrar
réseaux	redes
édité	editado
prit	tomó
duché	ducado
alliés	aliados
hauts	altos
tentative	tentativa
progressivement	gradualmente
dragon	dragón
canons	cañones
vandalisme	vandalismo
difficultés	dificultades
penser	pensar
tableaux	cuadros
affirme	afirma
vaisseau	nave
café	café
company	company
cher	caro
inscription	inscripción
luis	luis
isabelle	isabel
confiance	confianza
propriétés	propiedades
aix	aix
aventures	aventuras
instruments	instrumentos
conserve	conserva
finances	finanzas
galles	gales
onze	once
moteurs	motores
pratiques	prácticas
procédure	procedimiento
charente	charente
pleine	llena
dimensions	dimensiones
pertes	pérdidas
ajoute	agrega
ajoute	añade
laval	laval
ontario	ontario
document	documento
augmentation	aumento
limites	límites
qualification	cualificación
condamné	condenado
ernest	ernest
oncle	tío
conservé	conservado
génie	genio
voitures	coches
contemporaine	contemporánea
jackson	jackson
blancs	blancos
best	best
démocrate	demócrata
plage	playa
drame	drama
entretien	entrevista
vide	vacío
musiciens	músicos
accepte	acepta
show	show
félix	félix
handball	balonmano
benjamin	benjamin
benjamin	benjamín
reims	reims
windows	windows
canon	cañón
collections	colecciones
anthony	anthony
active	activa
organisée	organizada
initiale	inicial
ali	alí
décors	decorados
sculpture	escultura
chance	suerte
attendre	esperar
destruction	destrucción
samuel	samuel
dir	dir
real	real
avignon	avignon
amsterdam	ámsterdam
auvergne	auvernia
enregistrement	registro
davis	davis
quotidien	diario
leader	líder
trafic	tráfico
spécifique	específico
peau	piel
duo	dúo
espaces	espacios
impossible	imposible
ukraine	ucrania
maine	maine
vieille	vieja
incendie	incendio
acide	ácido
gilbert	gilbert
auraient	habrían
poule	gallina
succession	sucesión
kevin	kevin
technologie	tecnología
kim	kim
madeleine	magdalena
utile	útil
saut	salto
pré	pre
enceinte	embarazada
conservation	conservación
sacré	sagrado
sortir	salir
centres	centros
affluent	afluente
ministres	ministros
stephen	stephen
clairement	claramente
athènes	atenas
urbain	urbano
xiii	xiii
clermont	clermont
préfet	prefecto
essentiel	esencial
assure	asegura
stéphane	stéphane
laboratoire	laboratorio
distingue	distingue
primaire	primaria
restent	permanecen
wiki	wiki
équipage	tripulación
tuer	matar
logique	lógica
night	night
adapté	adaptado
xavier	xavier
orgue	órgano
bulletin	boletín
impression	impresión
dépend	depende
conséquence	consecuencia
visible	visible
habitat	hábitat
breton	bretón
souris	ratón
photographe	fotógrafo
autoroute	autopista
ponts	puentes
taylor	taylor
vérité	verdad
quinze	quince
quinze	quinze
mérite	merece
mérite	mérito
constituée	constituida
jérôme	jerome
day	day
assistant	asistente
bavière	baviera
marié	casado
satellite	satélite
samedi	sábado
alan	alan
chili	chile
exécution	ejecución
carlo	carlo
boîte	caja
rôles	roles
légèrement	ligeramente
gallimard	gallimard
alice	alicia
saxe	sajonia
intermédiaire	intermedio
distinctions	distinciones
thèmes	temas
installation	instalación
rapports	informes
circulation	circulación
australien	australiano
tournage	rodaje
relief	relieve
pierres	piedras
histoires	historias
faites	haga
pdd	pdd
équivalent	equivalente
phrase	frase
récompense	recompensa
lancement	lanzamiento
conçu	diseñado
structures	estructuras
aviation	aviación
chrétiens	cristianos
syndicat	sindicato
lewis	lewis
menace	amenaza
basque	vasco
mans	mans
lot	lote
débit	caudal
commissaire	comisionado
commissaire	comisario
araignées	arañas
employé	empleado
installé	instalado
conserver	conservar
reprendre	reanudar
notice	prospecto
manga	manga
conseils	consejos
latine	latina
bases	bases
andrew	andrew
diamètre	diámetro
peintures	pinturas
invasion	invasión
adversaire	oponente
conduite	conducción
seraient	serían
individus	individuos
franchise	franquicia
iran	irán
blessés	heridos
conscience	conciencia
représenté	representado
expositions	exposiciones
naples	nápoles
lion	león
peur	miedo
prague	praga
administratif	administrativo
lausanne	lausanne
peuples	pueblos
nomination	nombramiento
crime	crimen
little	little
respect	respeto
mobile	móvil
chiffres	cifras
british	british
sœurs	hermanas
bientôt	pronto
vendredi	viernes
commentaire	comentario
véhicule	vehículo
véhicule	vehiculo
départemental	departamental
della	della
irlandais	irlandés
densité	densidad
catholiques	católicos
apparaissent	aparecen
rare	raras
transfert	transferencia
laissé	dejado
blessé	herido
annoncé	anunciado
aile	ala
carré	cuadrado
dimension	dimensión
var	var
lit	cama
floride	florida
fera	hará
servi	servido
situés	ubicados
seuil	umbral
loup	lobo
détroit	estrecho
mémoires	memorias
préparation	preparación
chronologie	cronología
classiques	clásicos
minimum	mínimo
révolutionnaire	revolucionario
nécessaires	necesarios
bibliographie	bibliografía
grave	grave
lord	lord
tourne	gira
brunswick	brunswick
infobox	infobox
million	millón
poème	poema
extrait	extracto
contribution	contribución
hill	hill
rivières	ríos
directe	directa
inférieure	inferior
renommé	renombrado
gris	gris
aquitaine	aquitania
clément	clément
barbara	barbara
notoriété	notoriedad
euro	euro
léger	ligero
disponibles	disponibles
danger	peligro
land	land
désigné	designado
utilisent	utilizan
wilson	wilson
similaire	similar
travaillé	trabajado
municipalités	municipios
viennent	vienen
cordes	cuerdas
golden	golden
détail	detalle
dan	dan
accompagné	acompañado
hypothèse	hipótesis
matériaux	materiales
risques	riesgos
confluence	confluencia
charlotte	charlotte
jury	jurado
anglo	anglo
révolte	revuelta
enseigne	enseña
franc	franco
révèle	revela
didier	didier
mac	mac
variété	variedad
ascension	ascensión
vendu	vendido
ford	ford
jane	jane
frontières	fronteras
observatoire	observatorio
ailes	alas
machines	máquinas
julie	julie
institution	institución
donna	donna
caen	caen
organisations	organizaciones
varsovie	varsovia
déclaré	declarado
présidentielle	presidencial
compter	contar
normale	normal
résolution	resolución
pilotes	pilotos
conquête	conquista
rowspan	rowspan
hélène	elena
besoins	necesidades
genres	géneros
bref	breve
inférieur	inferior
cannes	cannes
neige	nieve
postes	puestos
discussions	discusiones
installer	instalar
défaut	defecto
discipline	disciplina
responsabilité	responsabilidad
paysage	paisaje
poissons	pescados
couvent	convento
violence	violencia
coût	coste
coût	costo
comics	comics
africain	africano
bandes	bandas
sir	sir
cellules	células
fosse	fosa
costumes	trajes
johnny	johnny
précisément	precisamente
espoir	esperanza
actuels	actuales
jardins	jardines
médailles	medallas
angers	angers
détails	detalles
déclaration	declaración
extrémité	extremidad
colonne	columna
populaires	populares
dirigée	dirigida
monaco	mónaco
fêtes	fiestas
gagner	ganar
dijon	dijon
invité	invitado
affiche	cartel
outil	herramienta
prêt	listo
publiés	publicados
mauvaise	mala
inventaire	inventario
violon	violín
élevage	cría
élevage	ganadería
remplacement	sustitución
islam	islam
envoie	envía
réduit	reducido
égalité	igualdad
créateur	creador
expliquer	explicar
environs	alrededores
coalition	coalición
intérêts	intereses
fox	fox
inspecteur	inspector
marais	pantanos
moines	monjes
kong	kong
chimie	química
prenant	tomando
poisson	pescado
inter	inter
fruits	frutas
fruits	fruta
passion	pasión
start	start
présentent	presentan
soi	soi
chercheurs	investigadores
chat	gato
stratégie	estrategia
johann	johann
semblent	parecen
sarah	sarah
interprété	interpretado
retrait	retiro
retrait	retirada
coopération	cooperación
laissant	dejando
archipel	archipiélago
compagnies	compañías
géorgie	georgia
âme	alma
gothique	gótico
bloc	bloque
méditerranée	mediterráneo
visiteurs	visitantes
clan	clan
répond	responde
caractérisée	caracterizada
surnom	apodo
express	express
express	expreso
électricité	electricidad
mit	mit
facile	fácil
différent	diferente
découvrir	descubrir
changements	cambios
fred	fred
chrétien	cristiano
oxford	oxford
croatie	croacia
ange	ángel
chasseurs	cazadores
gaston	gastón
robin	robin
bonnes	buenas
classements	clasificaciones
xiv	xiv
conflits	conflictos
transformation	transformación
remplace	reemplaza
remplace	sustituye
cultures	culturas
étudier	estudiar
lundi	lunes
viii	viii
limitée	limitada
andrea	andrea
accessible	accesible
universités	universidades
virginie	virginia
avantage	ventaja
monts	montes
engagé	contratado
objectifs	objetivos
ann	ann
écossais	escocés
métier	oficio
mélange	mezcla
montée	subida
alphonse	alfonso
acquis	adquirido
lucien	lucien
disques	discos
représentent	representan
support	soporte
sydney	sydney
qualifié	cualificado
qualifié	calificado
caractéristique	característica
belles	hermosas
belles	bellas
nba	nba
howard	howard
charlie	charlie
guitariste	guitarrista
évêques	obispos
défendre	defender
conséquences	consecuencias
maires	alcaldes
elizabeth	elizabeth
recevoir	recibir
performances	rendimiento
brest	brest
pianiste	pianista
friedrich	friedrich
occupé	ocupado
musées	museos
traversée	travesía
réussi	logrado
armand	armand
antiquité	antigüedad
brésilien	brasileño
doctorat	doctorado
centaines	cientos
maîtrise	maestría
encyclopédique	enciclopédico
réédition	reedición
calcul	cálculo
rêve	sueño
camille	camille
dérivés	derivados
aspects	aspectos
simples	simples
plaque	placa
fondateurs	fundadores
ffffff	ffffff
body	body
nez	nariz
démocratie	democracia
meurtre	asesinato
barre	barra
meilleures	mejores
métropole	metrópolis
vigueur	vigor
neuvième	noveno
minute	minuto
élite	élite
applications	aplicaciones
aîné	mayor
abandon	abandono
queue	cola
ivoire	marfil
hong	hong
ivan	iván
design	diseño
pistes	pistas
exécutif	ejecutivo
jonathan	jonathan
tenue	celebrada
jacob	jacob
mythologie	mitología
belgrade	belgrado
revenu	renta
guinée	guinea
gamme	gama
basilique	basílica
confédération	confederación
dessinateur	dibujante
jimmy	jimmy
arrêter	detener
regard	mirada
rallye	rally
valence	valencia
amitié	amistad
colspan	colspan
dossier	carpeta
diego	diego
maladies	enfermedades
oiseau	pájaro
ump	ump
citer	citar
constructeur	constructor
péninsule	península
francesco	francesco
campagnes	campañas
compilation	compilación
connaissances	conocimientos
copié	copiado
budapest	budapest
représentations	representaciones
noble	noble
ambassadeur	embajador
inverse	inverso
inverse	inversa
opérateur	operador
possession	posesión
forteresse	fortaleza
ennemis	enemigos
sections	secciones
viens	ven
positions	posiciones
engagement	compromiso
languedoc	languedoc
são	são
localités	localidades
inscrits	inscritos
quarante	cuarenta
quarante	quarante
hectares	hectáreas
golfe	golfo
italiens	italianos
title	title
situées	situadas
supprimé	eliminado
supprimé	suprimido
douglas	douglas
listes	listas
boy	boy
arbitrage	arbitraje
lecteur	lector
idem	ídem
remise	descuento
tire	dispara
hop	hop
christopher	christopher
réduire	reducir
anderson	anderson
christine	christine
morceaux	pedazos
sélectionné	seleccionado
miller	miller
dédié	dedicado
exil	exilio
terminé	terminado
cambridge	cambridge
construits	construidos
fixe	fijo
sncf	sncf
ventes	ventas
relative	relativa
instruction	instrucción
cancer	cáncer
donald	donald
agents	agentes
observation	observación
fréquence	frecuencia
dure	dura
vins	vinos
employés	empleados
out	out
forum	foro
lanceur	lanzador
solaire	solar
alimentation	alimentación
neutre	neutral
orthodoxe	ortodoxa
citoyens	ciudadanos
vladimir	vladímir
ouvriers	obreros
pseudonyme	seudónimo
humanité	humanidad
clé	clave
manuscrit	manuscrito
déterminer	determinar
défaites	derrotas
colline	colina
who	who
divisions	divisiones
dédiée	dedicada
gustave	gustave
longues	largas
régionales	regionales
continent	continente
naturelles	naturales
trésor	tesoro
ruines	ruinas
technologies	tecnologías
existent	existen
picardie	picardía
porto	oporto
bourbon	bourbon
difficulté	dificultad
désignations	designaciones
franz	franz
ombre	sombra
cousin	primo
vapeur	vapor
bay	bay
colonnes	columnas
pôle	polo
républicain	republicano
attribué	asignado
rédacteur	redactor
stanley	stanley
muet	mudo
historiens	historiadores
pétersbourg	petersburgo
couvre	cubre
western	western
vérifier	verificar
vérifier	comprobar
proposer	proponer
transmission	transmisión
soldat	soldado
présentée	presentada
canadiens	canadienses
jersey	jersey
sénégal	senegal
option	opción
pluie	lluvia
commentaires	comentarios
fpu	fpu
turin	turín
poitou	poitou
touche	tecla
évoque	evoca
automatique	automático
automatique	automática
compétences	habilidades
extrêmement	extremadamente
neveu	sobrino
pictures	pictures
mohamed	mohamed
hubert	hubert
cinquante	cincuenta
publicité	publicidad
souverain	soberano
associés	asociados
chargée	cargada
chronique	crónica
charte	carta
imposer	imponer
renault	renault
préface	prefacio
échecs	ajedrez
frais	fresco
figures	figuras
pérou	perú
bac	bandeja
bloqué	bloqueado
palette	paleta
tramway	tranvía
peintres	pintores
amiens	amiens
louvre	louvre
marco	marco
lès	lès
entertainment	entertainment
offensive	ofensiva
amie	amiga
alias	alias
concentration	concentración
intention	intención
nombres	números
précision	precisión
passagers	pasajeros
can	can
degré	grado
puissant	poderoso
correspondance	correspondencia
hamilton	hamilton
partiellement	parcialmente
tim	tim
organismes	organismos
sauver	salvar
juniors	juniors
visage	cara
possibles	posibles
country	country
provoque	provoca
danois	danés
conférences	conferencias
paramètres	parámetros
réflexion	reflexión
philadelphie	filadelfia
that	that
prononciation	pronunciación
aube	amanecer
mariée	novia
mariée	casada
meuse	mosa
billy	billy
répertoire	directorio
entraîne	entrena
écrivains	escritores
poser	posar
mazovie	mazovia
traditionnel	tradicional
lacs	lagos
suprême	supremo
suprême	suprema
ain	ain
autorisation	autorización
sexe	sexo
séjour	estancia
installations	instalaciones
andy	andy
travailleurs	trabajadores
appareils	aparatos
gordon	gordon
ordinateur	ordenador
graphique	gráfico
repose	descansa
ligues	ligas
nick	nick
surprise	sorpresa
juif	judío
efficace	eficiente
bulgarie	bulgaria
séparation	separación
perdre	perder
puy	puy
contes	cuentos
longs	largos
votes	votaciones
tibet	tíbet
spectateurs	espectadores
favorable	favorable
baroque	barroco
secteurs	sectores
pavillon	pabellón
will	will
tournois	torneos
ateliers	talleres
distinction	distinción
den	den
four	horno
venezuela	venezuela
your	your
triple	triple
eure	eure
vécu	vivido
high	high
autel	altar
manoir	mansión
continuer	continuar
fournir	proveer
propriétaires	propietarios
efforts	esfuerzos
créés	creados
roussillon	rosellón
influencé	influenciado
vacances	vacaciones
treize	trece
exclusivement	exclusivamente
reconstruction	reconstrucción
columbia	columbia
bons	buenos
choisir	elegir
administrateurs	administradores
rarement	raramente
global	global
bruce	bruce
consensus	consenso
troupe	tropa
sauvage	salvaje
consulté	consultado
clip	clip
optique	óptica
fantastique	fantástico
occidental	occidental
navigation	navegación
augmenter	aumentar
synthèse	síntesis
pourraient	podrían
phare	faro
surveillance	vigilancia
déplacement	desplazamiento
championship	championship
francophones	francófonos
prieuré	priorato
désert	desierto
ibn	ibn
nam	nam
back	back
signes	signos
bourse	bolsa
territoriale	territorial
dépôt	depósito
exactement	exactamente
exactement	exacto
hollywood	hollywood
presses	prensas
prusse	prusia
théologie	teología
sun	sun
augustin	agustín
peint	pintado
froid	frío
réputation	reputación
not	not
syrie	siria
flandre	flandes
villeneuve	villeneuve
alexis	alexis
lublin	lublin
playstation	playstation
allen	allen
colonies	colonias
responsables	responsables
riches	ricos
pékin	pekín
apparence	apariencia
couche	capa
fortune	fortune
changé	cambiado
châteaux	castillos
animateur	animador
master	máster
master	master
mathématicien	matemático
autonomie	autonomía
expansion	expansión
particuliers	particulares
partielle	parcial
dragons	dragones
formations	formaciones
besançon	besançon
giuseppe	giuseppe
communal	comunal
malheureusement	desafortunadamente
malheureusement	lamentablemente
classés	clasificados
veuve	viuda
apporter	traer
nicole	nicole
programmation	programación
cameroun	camerún
soins	cuidados
cesse	cesa
exercice	ejercicio
héritier	heredero
lah	lah
bot	bot
fonctionne	funciona
botanique	botánica
connues	conocidas
amoureux	amantes
east	east
amélioration	mejora
successivement	sucesivamente
manchester	manchester
vivent	viven
spécifiques	específicos
vouloir	querer
virus	virus
iso	iso
fermeture	cierre
participent	participan
voile	vela
aisne	aisne
monarchie	monarquía
spécialisé	especializado
soutenu	apoyado
décisions	decisiones
remarquable	notable
yougoslavie	yugoslavia
hugues	hugo
zurich	zúrich
restaurant	restaurante
first	first
abandonné	abandonado
fernando	fernando
wilhelm	wilhelm
tribu	tribu
hebdomadaire	semanal
belges	belgas
rotation	rotación
apporte	trae
composés	compuestos
attitude	actitud
transféré	transferido
jugement	sentencia
jugement	juicio
bible	biblia
cyrillique	cirílico
clark	clark
paulo	paulo
civils	civiles
limoges	limoges
têtes	cabezas
métal	metal
space	space
vocation	vocación
facteur	cartero
facteur	factor
rangers	rangers
ryan	ryan
fini	terminado
épée	espada
commencent	comienzan
salut	hola
banlieue	suburbios
appartenait	pertenecía
courts	cortos
toulon	toulon
pic	pic
voisins	vecinos
inconnue	desconocida
fantasy	fantasy
devoir	deber
servant	sirviendo
opposé	opuesto
irak	irak
bruges	brujas
progrès	progreso
this	this
soixante	sesenta
tonnes	toneladas
poche	bolsillo
dieux	dioses
producteurs	productores
copie	copia
intégré	integrado
jason	jason
surnommé	apodado
carbone	carbono
modifié	modificado
mâle	macho
ouvrir	abrir
pétrole	petróleo
normal	normal
illinois	illinois
jura	jura
confirme	confirma
corporation	corporation
gras	negrita
hervé	hervé
cible	objetivo
extra	extra
toponyme	topónimo
dark	dark
morceau	pedazo
évoluant	evolucionando
tenter	tentar
dixième	décimo
pyramide	pirámide
pasteur	pastor
nintendo	nintendo
apprentissage	aprendizaje
adopté	adoptado
entraînement	entrenamiento
kelly	kelly
arnaud	arnaud
actifs	activos
volontaires	voluntarios
filiale	filial
plaisir	placer
limousin	lemosín
organiser	organizar
bateaux	barcos
lisa	lisa
individuel	individual
anime	anime
croire	creer
présentant	presentando
domination	dominación
moto	moto
tunnel	túnel
échapper	escapar
fenêtres	ventanas
mineur	menor
vertical	vertical
équilibre	equilibrio
variable	variable
sanctuaire	santuario
illustrations	ilustraciones
erreurs	errores
bis	bis
slovaquie	eslovaquia
statistique	estadística
paramètre	parámetro
psychologie	psicología
constantinople	constantinopla
diplômé	graduado
sel	sal
princes	príncipes
découvertes	descubrimientos
examen	examen
héritage	herencia
hitler	hitler
commencer	comenzar
lancée	lanzada
madagascar	madagascar
combattants	combatientes
candidature	candidatura
home	home
théorème	teorema
darkgrey	darkgrey
tracé	trazado
expériences	experiencias
concurrence	competencia
étudié	estudiado
jeff	jeff
massacre	masacre
potentiel	potencial
annuel	anual
voisin	vecino
représenter	representar
free	free
fortes	fuertes
dialogue	diálogo
évidemment	obviamente
annuelle	anual
thérèse	teresa
grotte	cueva
pain	pan
décident	deciden
opus	opus
individu	individuo
russell	russell
death	death
réduction	reducción
alberto	alberto
tension	tensión
chaînes	cadenas
soviétiques	soviéticos
secrets	secretos
intégration	integración
wimbledon	wimbledon
rythme	ritmo
intervient	interviene
arriver	llegar
voulait	quería
montré	mostrado
rupture	ruptura
das	das
signal	señal
poitiers	poitiers
otto	otto
steven	steven
suicide	suicidio
accords	acuerdos
margaret	margaret
périodes	periodos
ter	ter
mentionné	mencionado
hollande	holanda
indiquer	indicar
song	song
crédit	crédito
xvi	xvi
librairie	librería
audio	audio
vosges	vosgos
fuite	fuga
associée	socia
reproduction	reproducción
christianisme	cristianismo
parcs	parques
hasard	azar
pouvaient	podían
habitant	habitante
acier	acero
réélu	reelegido
traditions	tradiciones
formant	formando
générique	genérico
civilisation	civilización
consacre	consagra
occuper	ocupar
silence	silencio
admis	admitido
détruite	destruida
isère	isère
raoul	raoul
définit	define
publier	publicar
arguments	argumentos
contribue	contribuye
lait	leche
parisien	parisino
matt	matt
antenne	antena
charbon	carbón
léopold	leopoldo
éponyme	epónimo
maxi	maxi
archéologie	arqueología
agir	actuar
financement	financiación
uefa	uefa
soutenir	apoyar
traducteur	traductor
ambassade	embajada
miami	miami
propositions	propuestas
men	men
dur	duro
dénomination	denominación
constante	constante
inclus	incluye
inclus	incluido
montant	importe
jouent	juegan
journalistes	periodistas
incluant	incluyendo
marbre	mármol
agissait	actuaba
sicile	sicilia
clients	clientes
souvenirs	recuerdos
bad	bad
insectes	insectos
prisonnier	prisionero
edmond	edmond
interdiction	prohibición
montrent	muestran
transition	transición
durable	sostenible
intelligence	inteligencia
précédents	anteriores
photographies	fotografías
payer	pagar
libéré	liberado
chaleur	calor
catalogne	cataluña
blog	blog
ingénieurs	ingenieros
indonésie	indonesia
chaussée	calzada
variétés	variedades
urgence	emergencia
passent	pasan
loisirs	ocio
lambert	lambert
liquide	líquido
gary	gary
présidents	presidentes
femelle	hembra
power	power
écliptique	eclíptica
beauté	belleza
indépendants	independientes
achat	compra
camps	campamentos
marques	marcas
boulogne	boulogne
réponses	respuestas
admin	admin
solutions	soluciones
inauguré	inaugurado
gaulle	gaulle
rev	rev
apparaître	aparecer
traiter	tratar
graves	graves
cuba	cuba
testament	testamento
attaquer	atacar
contribuer	contribuir
seize	dieciséis
old	old
great	great
décoration	decoración
fermé	cerrado
times	times
alphabet	alfabeto
arrivent	llegan
jordan	jordan
schéma	esquema
contribué	contribuido
campus	campus
représentée	representada
dis	di
solide	sólido
philip	philip
fiat	fiat
charges	cargas
bureaux	oficinas
atmosphère	atmósfera
réception	recepción
dave	dave
mourir	morir
retire	retira
nelson	nelson
témoin	testigo
conte	cuento
règlement	reglamento
shorts	shorts
horreur	horror
manifeste	manifiesto
pirates	piratas
fenêtre	ventana
occident	occidente
reich	reich
délégation	delegación
acquisition	adquisición
inclut	incluye
défini	definido
clés	llaves
certainement	ciertamente
morale	moral
nobel	nobel
adultes	adultos
spectacles	espectáculos
voisine	vecina
emblème	emblema
alternative	alternativa
littéralement	literalmente
trace	trace
ours	oso
portraits	retratos
wild	wild
limité	limitado
chevaliers	caballeros
bla	bla
loir	lirón
normes	normas
électriques	eléctricos
pauvres	pobres
refuge	refugio
nourriture	comida
participant	participante
facteurs	factores
devaient	debían
balle	bala
dynamique	dinámica
partenaire	socio
ross	ross
boris	boris
branches	ramas
démission	dimisión
démission	renuncia
aragon	aragón
batailles	batallas
assassiné	asesinado
illustré	ilustrado
colin	colin
consulter	consultar
zéro	cero
atp	atp
gironde	gironda
réunit	reúne
intéressant	interesante
remix	remix
biais	sesgo
fra	fra
identique	idéntica
identique	idéntico
clôture	clausura
clôture	valla
cheveux	cabello
varie	varía
fournit	proporciona
fournit	provee
traités	tratados
respecter	respetar
apparemment	aparentemente
bbc	bbc
trio	trío
communistes	comunistas
lourd	pesado
sérieux	seriedad
obligatoire	obligatorio
dordogne	dordoña
moore	moore
reconnue	reconocida
explosion	explosión
relégation	relegación
honoré	honrado
exerce	ejerce
augmente	aumenta
existait	existía
esclaves	esclavos
médecins	médicos
nathalie	nathalie
quentin	quentin
désir	deseo
grégoire	gregorio
sec	seco
divisé	dividido
comtesse	condesa
paysans	campesinos
parisienne	parisina
complexes	complejos
noyau	núcleo
germanique	germánico
santiago	santiago
flux	flujo
courants	corrientes
ohio	ohio
motifs	motivos
lisbonne	lisboa
fleur	flor
dizaines	decenas
séance	sesión
turc	turco
charentes	charentes
increment	increment
tirer	disparar
navarre	navarra
hambourg	hamburgo
envoyer	enviar
morgan	morgan
définir	definir
oblast	óblast
micro	micro
oriental	oriental
géant	gigante
consul	cónsul
lourdes	lourdes
paradis	paraíso
relégué	relegado
ian	ian
marqués	marcados
anjou	anjou
tempête	tormenta
abréviations	abreviaturas
constantin	constantino
embouchure	boquilla
bonheur	felicidad
moine	monje
arm	arm
négociations	negociaciones
oliver	oliver
bâle	basilea
congrégation	congregación
conclusion	conclusión
band	band
nîmes	nîmes
franck	franck
stockholm	estocolmo
accent	acento
efficacité	eficacia
cuivre	cobre
per	per
concile	concilio
cents	centavos
ferrari	ferrari
apostolique	apostólica
grosse	gorda
viande	carne
communications	comunicaciones
romancier	novelista
probable	probable
ken	ken
escalier	escalera
diable	diablo
argentin	argentino
récupérer	recuperar
herbert	herbert
berne	berna
roberto	roberto
chante	canta
jerry	jerry
talent	talento
invités	invitados
natation	natación
apprendre	aprender
sols	suelos
détruire	destruir
castille	castilla
movie	movie
client	cliente
syndrome	síndrome
book	book
prêtres	sacerdotes
alcool	alcohol
inspiration	inspiración
retiré	retirado
sombre	oscuro
lourds	pesados
data	data
habituellement	normalmente
habituellement	generalmente
nécessite	requiere
coordonnées	coordenadas
dead	dead
racine	raíz
fidèle	fiel
lecteurs	lectores
illustration	ilustración
intégrer	integrar
écologie	ecología
spécialistes	especialistas
ajouté	agregado
ajouté	añadido
pseudo	pseudo
constructions	construcciones
accompagne	acompaña
variations	variaciones
descente	descenso
remplacée	sustituida
remplacée	reemplazada
magasin	tienda
landes	landas
punk	punk
sucre	azúcar
manifestation	manifestación
installée	instalada
gold	gold
symphonie	sinfonía
vêtements	ropa
explication	explicación
différences	diferencias
vendus	vendidos
trad	trad
considérer	considerar
variante	variante
redirection	redirección
stone	stone
entité	entidad
bottom	bottom
duchesse	duquesa
play	play
abraham	abraham
couvert	cubierto
précédemment	anteriormente
délégué	delegado
cahiers	cuadernos
logement	alojamiento
phases	fases
tribus	tribus
vraie	verdadera
astronome	astrónomo
contemporains	contemporáneos
régionaux	regionales
wikimedia	wikimedia
carter	carter
francfort	fráncfort
flèche	flecha
#ffffff	#ffffff
circonscriptions	circunscripciones
experts	expertos
attentat	atentado
arles	arles
colorado	colorado
feuille	hoja
difficiles	difíciles
dep	dep
michigan	michigan
descendants	descendientes
khan	khan
indre	indre
case	case
case	casilla
enfer	infierno
districts	distritos
inutile	inútil
déchets	residuos
comique	cómico
bell	bell
doté	dotado
manuscrits	manuscritos
matières	materias
atlanta	atlanta
essence	esencia
séminaire	seminario
provenance	procedencia
vancouver	vancouver
orthographe	ortografía
lucas	lucas
biologie	biología
massachusetts	massachusetts
essayer	probar
marchés	mercados
last	last
cellule	célula
fou	loco
accepter	aceptar
heinrich	heinrich
coréen	coreano
courage	ánimo
moulins	molinos
humour	humor
banques	bancos
nommés	nombrados
battre	batir
clavier	teclado
norvégien	noruego
cologne	colonia
positif	positivo
minnesota	minnesota
compléter	completar
singles	singles
paysages	paisajes
barry	barry
kansas	kansas
garros	garros
dissolution	disolución
grève	huelga
marchandises	mercancías
qualités	calidades
qualités	cualidades
fichiers	archivos
patrice	patrice
pratiquement	prácticamente
disparue	desaparecida
quatorze	catorce
arménie	armenia
norman	norman
tirant	tirando
allier	allier
leipzig	leipzig
dites	digan
dites	diga
possédait	poseía
fernand	fernand
bonaparte	bonaparte
rural	rural
codes	códigos
warner	warner
récente	reciente
malade	enfermo
imprimerie	imprenta
évaluer	evaluar
perspective	perspectiva
edgar	edgar
doctrine	doctrina
walt	walt
tourner	girar
impérial	imperial
sultan	sultán
liban	líbano
calédonie	caledonia
hermann	hermann
sociologie	sociología
messages	mensajes
ballet	ballet
accusé	acusado
onu	onu
ernst	ernst
effort	esfuerzo
affecté	afectado
stuart	stuart
implique	implica
index	índice
veulent	quieren
téléphone	teléfono
documentation	documentación
bouche	boca
queen	queen
hiérarchie	jerarquía
lyonnais	lyonnais
blessure	herida
équateur	ecuador
fine	fine
bourgeois	burgués
statues	estatuas
anneau	anillo
chambres	habitaciones
youtube	youtube
xii	xii
sporting	sporting
pire	peor
profite	disfruta
onde	onda
abc	abc
définie	definida
masque	máscara
combattre	combatir
ouvrier	obrero
gloire	gloria
basses	bajas
protégé	protegido
tâche	tarea
monter	montar
monter	subir
fidèles	fieles
causes	causas
papillon	mariposa
comparaison	comparación
panneaux	paneles
vendée	vendée
illustre	ilustre
automatiquement	automáticamente
accepté	aceptado
pousse	crece
luigi	luigi
grant	grant
globe	globe
procureur	fiscal
ardennes	ardenas
atlas	atlas
génétique	genética
ballon	balón
choc	shock
choc	choque
ondes	ondas
gérer	gestionar
romantique	romántico
frappe	golpea
philippines	filipinas
entouré	rodeado
anonyme	anónima
applique	aplica
assurance	seguro
phil	phil
helsinki	helsinki
lawrence	lawrence
unesco	unesco
littoral	litoral
danny	danny
module	módulo
enterré	enterrado
bonus	bono
théories	teorías
hot	hot
éliminatoires	eliminatorias
restera	permanecerá
uci	uci
diversité	diversidad
garnison	guarnición
résoudre	resolver
résistant	resistente
islande	islandia
macédoine	macedonia
sculptures	esculturas
investissement	inversión
absolument	absolutamente
incident	incidente
are	are
chêne	roble
transformé	transformado
adversaires	oponentes
privés	privados
boys	boys
chroniques	crónicas
tue	mata
paolo	paolo
radical	radical
partenariat	asociación
entrées	entradas
stratégique	estratégico
réfugiés	refugiados
berger	pastor
cache	caché
tentatives	intentos
particularité	particularidad
emma	emma
miles	miles
miles	millas
demandes	solicitudes
distinguer	distinguir
réalisées	realizadas
doublé	duplicado
boxe	boxeo
industriels	industriales
tarn	tarn
challenge	challenge
adolphe	adolphe
serpent	serpiente
jeudi	jueves
georg	georg
parker	parker
tes	tus
métropolitaine	metropolitana
isaac	isaac
traits	rasgos
comtes	condes
invite	invita
anges	ángeles
étang	estanque
rassemble	reúne
symboles	símbolos
vols	vuelos
voûte	bóveda
murray	murray
racines	raíces
houston	houston
équipé	equipado
parfait	perfecto
roumain	rumano
affluents	afluentes
mali	malí
repos	descanso
gardes	guardias
gand	gante
évolué	evolucionado
romane	románica
vents	vientos
rap	rap
circulaire	circular
vive	viva
fribourg	friburgo
décennies	décadas
assistance	asistencia
family	family
uruguay	uruguay
esthétique	estética
servent	sirven
adams	adams
permanente	permanente
wayne	wayne
malte	malta
ahmed	ahmed
anton	anton
spéciaux	especiales
loiret	loiret
républicains	republicanos
indiens	indios
appliquer	aplicar
traditionnellement	tradicionalmente
âges	edades
gridcolor	gridcolor
neutralité	neutralidad
sépare	separa
bière	cerveza
arr	arr
faibles	débiles
arnold	arnold
élue	elegida
julia	julia
books	books
angel	angel
invention	invención
ottawa	ottawa
podium	podio
professeurs	profesores
what	what
emplois	empleos
occupée	ocupada
confusion	confusión
paroisses	parroquias
clergé	clero
mosquée	mezquita
personnellement	personalmente
étrange	extraño
crimes	crímenes
éteint	apagado
nobles	nobles
exprimer	expresar
vicomte	vizconde
session	sesión
marshall	marshall
sorbonne	sorbona
lang	lang
vallées	valles
inc	inc
just	just
project	project
suites	suites
inauguration	inauguración
pietro	pietro
colons	colonos
ferrand	ferrand
arsenal	arsenal
adrien	adrien
larry	larry
récentes	recientes
armement	armamento
exprime	expresa
off	off
mayenne	mayenne
marion	marion
robe	vestido
golf	golf
baker	baker
normalement	normalmente
jay	jay
mystère	misterio
stewart	stewart
phénomènes	fenómenos
sint	sint
similaires	similares
sage	sabio
vaisseaux	naves
béton	hormigón
lions	leones
idéal	ideal
lionel	lionel
good	good
particules	partículas
écurie	establo
baby	baby
soprano	soprano
kennedy	kennedy
harris	harris
shakespeare	shakespeare
masters	masters
refusé	denegado
coureurs	corredores
extraits	extractos
cadet	cadete
tribune	tribune
reconnaît	reconoce
expose	expone
hip	hip
lightgrey	lightgrey
coule	fluye
down	down
pau	pau
mineurs	menores
dei	dei
round	round
faciliter	facilitar
montrant	mostrando
physicien	físico
immense	inmenso
immense	inmensa
bobby	bobby
dangereux	peligroso
modes	modos
fief	feudo
adoption	adopción
robinson	robinson
usines	fábricas
panneau	panel
pomme	manzana
inscriptions	inscripciones
messieurs	caballeros
nil	nilo
bologne	bolonia
seed	seed
justification	justificación
saga	saga
party	party
reconnaître	reconocer
principauté	principado
volant	volante
textcolor	textcolor
créant	creando
dents	dientes
may	may
algérien	argelino
tommy	tommy
richesse	riqueza
acquiert	adquiere
ports	puertos
terry	terry
mardi	martes
sprint	sprint
exploration	exploración
travaillant	trabajando
matthew	matthew
cerveau	cerebro
fabrique	fabrica
voter	votar
diplomate	diplomático
maternelle	materna
relatif	relativo
journées	jornadas
sommets	cumbres
dramaturge	dramaturgo
centrales	centrales
joan	joan
collaborateur	colaborador
profondément	profundamente
sentiment	sentimiento
théodore	teodoro
architectes	arquitectos
transformer	transformar
médical	medico
eurent	tuvieron
eurent	hubieron
publiées	publicadas
modeste	modesto
interface	interfaz
fantôme	fantasma
animé	animado
ludwig	ludwig
marchands	mercaderes
dérivé	derivado
marcus	marcus
ottoman	otomano
universal	universal
imaginaire	imaginario
microsoft	microsoft
bucarest	bucarest
inscrite	inscrita
interventions	intervenciones
témoignage	testimonio
arizona	arizona
nuls	nulos
satellites	satélites
mâles	machos
wrestling	wrestling
circonstances	circunstancias
chancelier	canciller
désignation	designación
heart	heart
déclin	declive
thermique	térmica
énorme	enorme
réformes	reformas
pôles	polos
partenaires	socios
tombeau	tumba
bruit	ruido
tchécoslovaquie	checoslovaquia
devise	moneda
universel	universal
annie	annie
mercredi	miércoles
limiter	limitar
sons	sonidos
circuits	circuitos
mono	mono
clinique	clínica
pennsylvanie	pensilvania
équation	ecuación
tenté	tentado
gouvernements	gobiernos
cirque	circo
dépit	despecho
eddie	eddie
progression	progresión
cooper	cooper
intégrée	integrado
intégrée	integrada
vichy	vichy
tendances	tendencias
dick	dick
urbanisme	urbanismo
électeurs	electores
simone	simone
thompson	thompson
variantes	variantes
aéronautique	aeronáutica
rochelle	rochelle
aigle	águila
salariés	asalariados
namur	namur
suspension	suspensión
royaumes	reinos
pen	pen
gravure	grabado
corriger	corregir
rangs	filas
prière	oración
dallas	dallas
admins	admins
nationalités	nacionalidades
colonisation	colonización
appeler	llamar
religions	religiones
volontaire	voluntario
lloyd	lloyd
communs	comunes
chaud	caliente
year	year
fans	fans
aus	aus
adjectifs	adjetivos
socks	socks
attraction	atracción
poètes	poetas
tri	tri
abandonner	abandonar
colère	ira
dépasse	supera
réactions	reacciones
symbolique	simbólico
louvain	lovaina
transforme	transforma
patricia	patricia
races	razas
way	way
renaud	renaud
armé	armado
graham	graham
sensible	sensible
compositions	composiciones
walker	walker
vertu	virtud
rhénanie	renania
divisée	dividida
messe	misa
french	spanish
jugé	juzgado
jennifer	jennifer
obligation	obligación
considérable	considerable
franklin	franklin
palestine	palestina
chiens	perros
collabore	colabora
species	species
foule	multitud
priori	priori
bryan	bryan
impliquant	involucrando
impliquant	implicando
registre	registro
extraction	extracción
berry	berry
froide	fría
kurt	kurt
mécanisme	mecanismo
angoulême	angulema
ensembles	conjuntos
mentionne	menciona
séville	sevilla
geneviève	genevieve
bulgare	búlgaro
ordonnance	ordenanza
morbihan	morbihan
soul	soul
alpha	alfa
abus	abuso
tube	tubo
miroir	espejo
acheter	comprar
lumières	luces
alberta	alberta
rick	rick
primaires	primarias
descendant	descendiente
magie	magia
fromage	queso
exécuté	ejecutado
indiana	indiana
estimé	estimado
conjoint	cónyuge
chaire	cátedra
trinité	trinidad
traduire	traducir
identifier	identificar
éditeurs	editores
nov	nov
protocole	protocolo
éthiopie	etiopía
galaxie	galaxia
construites	construidas
blessures	lesiones
blessures	heridas
jacqueline	jacqueline
roues	ruedas
stefan	stefan
allan	allan
harold	harold
vidéos	videos
pauvre	pobre
confirmé	confirmado
enseignants	profesores
émis	emitidos
émis	emitido
copenhague	copenhague
rayonnement	radiación
ordinaire	ordinario
marines	marines
gênes	génova
alto	alto
sky	sky
sergent	sargento
yyy	yyy
retard	retraso
maxime	maxime
cleveland	cleveland
rebelles	rebeldes
biologique	biológica
biologique	biológico
inventeur	inventor
bank	bank
chars	tanques
sea	sea
hérault	hérault
couches	capas
venue	venida
manches	mangas
profonde	profunda
brabant	brabante
bach	bach
coin	esquina
coin	rincón
conventions	convenciones
rénovation	renovación
débutant	principiante
identification	identificación
trouble	trastorno
typique	típico
kate	kate
collines	colinas
molière	molière
arcade	arcade
delta	delta
pakistan	pakistán
yvelines	yvelines
bloquer	bloquear
socialistes	socialistas
kosovo	kosovo
nordique	nórdico
afghanistan	afganistán
ncaa	ncaa
people	people
helen	helen
arrêts	sentencias
aimé	amado
projection	proyección
arbitres	árbitros
popularité	popularidad
han	han
organisées	organizadas
synagogue	sinagoga
simpson	simpson
calvados	calvados
campbell	campbell
verdun	verdún
courbe	curva
mercure	mercurio
plomb	plomo
synonyme	sinónimo
gymnastique	gimnasia
naturellement	naturalmente
light	light
troyes	troyes
prononcé	pronunciado
constellation	constelación
annales	anales
diane	diane
déplacer	mover
mitchell	mitchell
ngc	ngc
gagnant	ganador
emploie	emplea
apparu	apareció
commandes	pedidos
mickey	mickey
légendes	leyendas
adaptée	adaptada
africains	africanos
mercedes	mercedes
bâton	palo
raphaël	rafael
kiev	kiev
flûte	flauta
arabie	arabia
plaques	placas
dispositions	disposiciones
cratère	cráter
johannes	johannes
annexe	anexo
hard	hard
feat	feat
ralph	ralph
leo	leo
games	games
traction	tracción
géologie	geología
parlé	hablado
cnrs	cnrs
army	army
harvard	harvard
bowl	bowl
chasseur	cazador
vend	vende
java	java
sénateurs	senadores
trou	agujero
trou	hoyo
courrier	correo
permanent	permanente
lorient	lorient
neil	neil
sondage	encuesta
inspire	inspira
inspire	inspire
constitutionnel	constitucional
pure	pura
rapides	rápidos
organisés	organizados
pourcentage	porcentaje
carrefour	encrucijada
traditionnels	tradicionales
evans	evans
alexandrie	alejandría
patients	pacientes
culminant	culminante
susan	susan
dublin	dublín
harvey	harvey
justin	justin
dunkerque	dunkerque
patient	paciente
approximativement	aproximadamente
missouri	missouri
référendum	referéndum
roses	rosas
pèlerinage	peregrinación
robot	robot
sony	sony
turcs	turcos
calcaire	caliza
stockage	almacenamiento
réservé	reservado
interprétée	interpretada
traductions	traducciones
url	url
tellement	tan
wright	wright
jon	jon
brut	bruto
pur	puro
nœuds	nudos
triangle	triángulo
pittsburgh	pittsburgh
défend	defiende
adopte	adopta
propagande	propaganda
convaincre	convencer
témoins	testigos
thaïlande	tailandia
flamand	flamenco
hier	ayer
recettes	recetas
quatuor	cuarteto
créées	creadas
mexicain	mexicano
agnès	agnes
act	act
oublier	olvidar
conversion	conversión
folie	locura
caire	cairo
orne	orne
network	network
dauphin	delfín
évoluer	evolucionar
femelles	hembras
prototype	prototipo
dom	dom
magasins	tiendas
athlètes	atletas
assuré	asegurado
impulsion	impulso
stuttgart	stuttgart
luke	luke
températures	temperaturas
dépression	depresión
dean	dean
liverpool	liverpool
générations	generaciones
séquence	secuencia
polytechnique	politécnica
oct	oct
marge	marge
vatican	vaticano
woman	woman
apparitions	apariciones
croate	croata
rachel	rachel
shanghai	shanghái
byzantin	bizantino
conduire	conducir
capture	captura
cadres	marcos
disparaît	desaparece
magique	mágico
timbres	sellos
déesse	diosa
lituanie	lituania
valenciennes	valenciennes
chapitres	capítulos
paragraphe	párrafo
adn	adn
égal	igual
für	für
joués	jugados
situations	situaciones
perdue	perdida
géométrie	geometría
sexuelle	sexual
gard	gard
nathan	nathan
wallon	valón
finistère	finisterre
possibilités	posibilidades
décennie	década
beaumont	beaumont
austin	austin
influences	influencias
fausse	falsa
century	century
like	like
gendarmerie	gendarmería
estonie	estonia
suggère	sugiere
chypre	chipre
explorateur	explorador
jun	jun
dell	dell
over	over
surfaces	superficies
sentiments	sentimientos
qualifiés	calificados
vitesses	velocidades
canal+	canal+
instance	instancia
vigne	viña
obligé	obligado
brouillon	borrador
vilaine	traviesa
réalisations	realizaciones
réalisations	logros
puissante	poderosa
astronomie	astronomía
escadron	escuadrón
immatriculation	matrícula
juridiction	jurisdicción
terminer	finalizar
terminer	terminar
claviers	teclados
conclut	concluye
database	database
mandats	mandatos
sarthe	sarthe
istanbul	estambul
témoignages	testimonios
laurence	laurence
consacrer	dedicar
łódź	łódź
aviron	remo
sorties	salidas
timbre	timbre
baptisé	bautizado
mons	mons
théorique	teórico
sean	sean
dégâts	daños
wolf	wolf
doublage	doblaje
louisiane	luisiana
absolue	absoluta
médiéval	medieval
spécialité	especialidad
intégrale	integral
prime	prime
occupent	ocupan
oracle	oráculo
melbourne	melbourne
polémique	polémica
sauvages	salvajes
vivants	vivos
compréhension	comprensión
three	three
field	field
larges	anchos
catastrophe	catástrofe
démonstration	demostración
citoyen	ciudadano
thriller	thriller
configuration	configuración
creuse	hueca
greg	greg
nuits	noches
lincoln	lincoln
cavaliers	jinetes
volcan	volcán
kent	kent
parlant	hablando
grille	rejilla
fernández	fernández
marvel	marvel
remarques	observaciones
tend	tiende
spirou	spirou
sofia	sofía
special	special
hébreu	hebreo
pat	pat
variables	variables
vignoble	viñedo
roue	rueda
autorisé	autorizado
cavalier	jinete
puissances	potencias
sierra	sierra
navigateur	navegador
albin	albin
organes	órganos
originaires	originarias
originaires	originarios
causer	causar
sylvain	sylvain
compétence	competencia
provinciale	provincial
fonctionnaires	funcionarios
caractérise	caracteriza
permettait	permitía
démocrates	demócratas
bords	bordes
directrice	directora
fragments	fragmentos
seattle	seattle
existant	existente
bond	bond
mulhouse	mulhouse
missiles	misiles
ordonné	ordenado
certifié	certificado
chercheur	buscador
prépare	prepara
innovation	innovación
combiné	combinado
ref	ref
amy	amy
turner	turner
ardèche	ardèche
fortifications	fortificaciones
burkina	burkina
yonne	yonne
sachant	sabiendo
chargés	cargados
girls	girls
assisté	asistido
effectifs	efectivos
devraient	deberían
comprenait	comprendía
répression	represión
blé	trigo
inaugurée	inaugurada
conrad	conrad
rousseau	rousseau
meyer	meyer
stable	estable
ecclésiastique	eclesiástica
fonctionnaire	funcionario
catholicisme	catolicismo
rayons	radios
silva	silva
linéaire	lineal
bretonne	bretona
brevet	patente
propulsion	propulsión
mythe	mito
faso	faso
manger	comer
fire	fire
bouches	bocas
mohammed	mohammed
grey	grey
prochaine	próxima
degrés	grados
flammarion	flammarion
styles	estilos
doubs	doubs
nazis	nazis
guyane	guayana
esprits	espíritus
talk	talk
aude	aude
caméra	cámara
assiste	asiste
andreas	andreas
legend	legend
régulier	regular
contiennent	contengan
contiennent	contienen
mix	mix
grandeur	grandeza
sound	sound
immigration	inmigración
werner	werner
airlines	airlines
pollution	contaminación
garcia	garcia
garcia	garcía
fayard	fayard
marocain	marroquí
filmographie	filmografía
hôte	anfitrión
revers	revés
calme	tranquilo
signification	significado
todd	todd
duel	duelo
panama	panamá
poétique	poético
épaisseur	espesor
hunter	hunter
heureux	feliz
alaska	alaska
entreprend	emprende
august	august
perdues	perdidas
bébé	bebé
moments	momentos
illustrateur	ilustrador
dépendant	dependiente
diesel	diesel
indiquant	indicando
phoenix	phoenix
erik	erik
délai	plazo
magic	magic
solidarité	solidaridad
peugeot	peugeot
piémont	piamonte
successifs	sucesivas
chapeau	sombrero
vénus	venus
régiments	regimientos
portait	llevaba
comptant	contando
ted	ted
uniforme	uniforme
serment	juramento
comprise	comprendida
libéraux	liberales
éliminé	eliminado
disciplines	disciplinas
supérieurs	superiores
scandale	escándalo
débarquement	desembarque
festivals	festivales
wta	wta
ducs	duques
alphabétique	alfabético
juliette	julieta
attribution	atribución
attribution	adjudicación
harmattan	harmattan
protestants	protestantes
arrestation	arresto
combinaison	combinación
favoriser	favorecer
radar	radar
malaisie	malasia
nominations	nombramientos
nés	nacidos
insurrection	insurgencia
éthique	ética
hesse	hesse
arms	arms
halle	halle
supercoupe	supercopa
luxe	lujo
grenade	granada
rob	rob
casablanca	casablanca
dennis	dennis
mail	mail
terminant	terminando
compositeurs	compositores
artisans	artesanos
cat	cat
wood	wood
bourges	bourges
strictement	estrictamente
tâches	tareas
impératrice	emperatriz
ressort	resorte
gère	gestiona
marquer	marcar
chartres	chartres
léo	leo
hof	hof
condé	condé
détective	detective
cohen	cohen
sarkozy	sarkozy
pole	pole
wagner	wagner
mondes	mundos
wurtemberg	wurtemberg
salomon	salomón
barbe	barba
allié	aliado
proposant	proponiendo
proposant	proponente
dette	deuda
auront	tendrán
dream	dream
moyennes	promedios
meurthe	meurthe
bibliothèques	bibliotecas
dessert	postre
blake	blake
nationaliste	nacionalista
peuplée	poblada
expert	experto
normand	normando
lourde	pesada
holmes	holmes
faisaient	hacían
renard	zorro
esclavage	esclavitud
magnétique	magnético
mississippi	mississippi
collègues	colegas
attire	atrae
graines	semillas
rébellion	rebelión
rtl	rtl
nova	nova
isolées	aisladas
tueur	asesino
envoyés	enviados
galeries	galerías
apparente	aparente
parlent	hablan
évident	obvio
coûts	costos
coûts	costes
auxerre	auxerre
libérer	liberar
munitions	municiones
divine	divina
warren	warren
observe	observa
bouddhisme	budismo
fraction	fracción
présentés	presentados
aidé	ayudado
concepts	conceptos
harmonie	armonía
magnus	magnus
révélé	revelado
parlementaires	parlamentarios
collins	collins
blocs	bloques
acheté	comprado
bolivie	bolivia
#aaa	#aaa
législation	legislación
cerf	ciervo
courtes	cortas
révolutionnaires	revolucionarios
proportion	proporción
palatinat	palatinado
poméranie	pomerania
posthume	póstumo
wolfgang	wolfgang
reçoivent	reciben
câble	cable
mers	mares
amoureuse	enamorada
lost	lost
johan	johan
cbs	cbs
reconstruit	reconstruido
canaux	canales
figaro	figaro
exercer	ejercitar
brièvement	brevemente
implantation	implantación
boucle	bucle
produisent	producen
maçonnerie	albañilería
slovénie	eslovenia
correctement	correctamente
piliers	pilares
disposent	disponen
coordination	coordinación
talents	talentos
diplomatique	diplomática
doux	suave
pères	padres
capables	capaces
partagé	compartido
syndicats	sindicatos
immédiate	inmediata
nigeria	nigeria
lou	lou
gaulois	galo
gaulois	galos
émilie	emilia
convaincu	convencido
malades	enfermos
leonard	leonard
concession	concesión
hainaut	henao
dérive	deriva
eurovision	eurovisión
égyptien	egipcio
évêché	obispado
naturaliste	naturalista
juges	jueces
hms	hms
avantages	ventajas
prévention	prevención
keith	keith
dommages	daños
prononce	pronuncia
organique	orgánica
impôt	impuesto
vengeance	venganza
research	research
bombardement	bombardeo
guadeloupe	guadalupe
violoncelle	chelo
impliqué	implicado
ancêtre	antepasado
datent	datan
sfondo	sfondo
bros	bros
demain	mañana
nasa	nasa
mensuel	mensual
équipée	equipada
dakar	dakar
souveraineté	soberanía
profond	profundo
occitan	occitano
spécialisés	especializados
continuité	continuidad
systématiquement	sistemáticamente
intensité	intensidad
protéines	proteínas
récent	reciente
accompagnée	acompañada
hollandais	holandés
attentats	atentados
intéressé	interesado
décrire	describir
sauveur	salvador
éclairage	iluminación
betty	betty
rochefort	rochefort
vernaculaire	vernácula
martinique	martinica
esp	esp
ita	ita
baccalauréat	bachillerato
gonzález	gonzález
wikidata	wikidata
dialogues	diálogos
appliquée	aplicada
mesurer	medir
sèvres	sèvres
gallois	galés
jupiter	júpiter
wwe	wwe
marquant	marcando
grace	grace
précipitations	precipitaciones
marianne	marianne
bohême	bohemia
sidi	sidi
paire	par
console	consola
santos	santos
tombes	tumbas
adolf	adolf
récents	recientes
réservoir	embalse
approfondir	profundizar
transformée	transformada
more	more
connaissent	conocen
vocabulaire	vocabulario
missile	misil
appelait	llamaba
utiles	útiles
glasgow	glasgow
écoute	escucha
harrison	harrison
wallonie	valonia
transept	transepto
représentés	representados
anneaux	anillos
cyr	cyr
sentier	sendero
richelieu	richelieu
get	get
croisade	cruzada
boxeur	boxeador
parisiens	parisinos
qualifiée	cualificada
fifa	fifa
was	was
critère	criterio
inédit	inédito
stanislas	stanislas
tensions	tensiones
lucie	lucía
lucie	lucie
casse	rompe
bête	bestia
immobilier	inmobiliaria
impôts	impuestos
brigitte	brigitte
pattes	patas
économiste	economista
adapter	adaptar
disparaître	desaparecer
verbe	verbo
bull	bull
craig	craig
évalué	evaluado
saintes	santas
rond	redondo
bnf	bnf
érigé	erigido
rudolf	rudolf
pokémon	pokémon
linux	linux
retable	retablo
fabricant	fabricante
syntaxe	sintaxis
celtique	celta
singapour	singapur
michelle	michelle
joie	alegría
costume	traje
puissants	poderosos
hymne	himno
douleur	dolor
restauré	restaurado
gay	gay
vitraux	vidrieras
intense	intenso
appartiennent	pertenecen
vegas	vegas
chimiste	químico
flash	flash
pacte	pacto
foire	feria
renvoie	devuelve
excellence	excelencia
plateforme	plataforma
stock	stock
fritz	fritz
corruption	corrupción
dépenses	gastos
vampire	vampiro
comtés	condados
platine	platino
perrin	perrin
pin	pino
angelo	angelo
moreau	moreau
haïti	haití
pédagogique	pedagógico
nécessairement	necesariamente
european	european
cécile	cecilia
return	return
loge	camerino
loge	logia
tissu	tela
abside	ábside
continu	continuo
mets	mets
rire	reír
créations	creaciones
coupable	culpable
report	report
apport	aporte
channel	channel
cylindres	cilindros
monténégro	montenegro
terreur	terror
temporaire	temporal
verlag	verlag
wang	wang
brooklyn	brooklyn
ultra	ultra
fourni	suministrado
fourni	proporcionado
sonde	sonda
baltimore	baltimore
télécommunications	telecomunicaciones
assurances	seguros
vélo	bicicleta
cloche	campana
stabilité	estabilidad
rabbin	rabino
marketing	marketing
dotée	dotada
essonne	essonne
touché	tocado
globalement	globalmente
attirer	atraer
végétation	vegetación
souffle	aliento
pol	pol
diagnostic	diagnóstico
conservés	conservados
caraïbes	caribe
casino	casino
musulman	musulmán
observé	observado
serre	invernadero
complot	conspiración
appris	aprendido
fan	fan
sara	sara
remarqué	notado
taïwan	taiwán
müller	müller
mammifères	mamíferos
potter	potter
doré	dorado
toscane	toscana
rêves	sueños
chômage	desempleo
subsiste	subsiste
signaler	reportar
temples	templos
antilles	antillas
survivants	sobrevivientes
étroite	estrecha
métallique	metálico
xbox	xbox
