des	dei
des	delle
les	le
est	est
une	una
dans	in
catégorie	categoria
par	da
pour	per
sur	su
qui	che
que	che
avec	con
son	suono
plus	più
pas	non
sont	sono
elle	lei
aux	ai
aux	alle
été	estate
avancement	avanzamento
comme	come
mais	ma
cette	questa
pop	pop
deux	due
naissance	nascita
aussi	anche
france	francia
après	dopo
fait	fatto
notes	note
entre	tra
entre	fra
sous	sotto
même	anche
être	essere
nom	nome
français	francese
ont	hanno
paris	parigi
lui	lui
lieu	luogo
autres	altri
décès	decessi
références	referenze
liens	collegamenti
était	era
commune	comune
ville	città
jean	giovanni
leur	loro
date	data
dont	dont
peut	può
ans	anni
alors	allora
externes	esterni
site	sito
premier	primo
ces	questi
http	http
ainsi	così
film	film
voir	vedere
pays	paese
source	sorgente
grand	grande
tout	tutto
groupe	gruppo
titre	titolo
monde	mondo
nord	nord
années	anni
bien	bene
contre	contro
liste	elenco
puis	poi
équipe	squadra
club	club
sud	sud
partie	parte
avant	anteriore
trois	tre
articles	articoli
article	articolo
guerre	guerra
sans	senza
saison	stagione
fin	fine
vers	verso
année	anno
temps	tempo
faire	fare
mars	mars
histoire	storia
série	serie
joueur	giocatore
mai	maggio
tour	torre
mort	morte
juin	giugno
jpg	jpg
française	francese
pierre	pietro
région	regione
janvier	gennaio
avoir	avere
fois	volte
autre	altro
septembre	settembre
juillet	luglio
état	stato
église	chiesa
octobre	ottobre
place	piazza
famille	famiglia
états	stati
général	generale
avril	aprile
insee	insee
tous	tutti
politique	politica
album	album
décembre	dicembre
août	agosto
todo	todo
novembre	novembre
avait	aveva
donc	quindi
prix	prezzo
prix	prezzi
align	align
nouvelle	nuova
février	febbraio
département	dipartimento
grande	grande
peu	poco
américain	americano
début	inizio
ligne	linea
suite	suite
nationale	nazionale
championnat	campionato
encore	ancora
image	immagine
vie	vita
unis	uniti
lien	link
football	calcio
pendant	durante
jeux	giochi
moins	meno
ouest	ovest
page	pagina
nouveau	nuovo
vous	voi
centre	centro
cours	corsi
village	villaggio
université	università
louis	louis
louis	luigi
nombre	numero
siècle	secolo
coupe	coppa
coupe	taglio
population	popolazione
connexes	correlati
homme	uomo
communes	comuni
division	divisione
président	presidente
national	nazionale
société	società
quatre	quattro
cas	caso
jeu	gioco
genre	tipo
musique	musica
fils	figlio
roi	re
parti	partito
jour	giorno
mise	scommessa
forme	forma
époque	epoca
new	new
devient	diventa
ancien	antico
origine	origine
ordre	ordine
château	castello
école	scuola
carrière	carriera
deuxième	seconda
deuxième	secondo
bar	bar
située	situata
charles	charles
points	punti
ayant	avendo
paul	paolo
chef	capo
père	padre
exemple	esempio
trouve	trova
durant	durant
rapport	relazione
rapport	rapporto
art	arte
canton	canton
dernier	ultimo
type	tipo
habitants	abitanti
point	punto
compte	conto
période	periodo
armée	esercito
eau	acqua
marie	marie
sorti	uscito
projet	progetto
chaque	ogni
anglais	inglese
province	provincia
john	john
international	internazionale
conseil	consiglio
françois	francesco
demande	richiesta
fonction	funzione
toujours	sempre
doit	deve
production	produzione
certains	alcuni
membre	membro
près	vicino
rôle	ruolo
meilleur	migliore
droit	diritto
mois	mese
île	isola
république	repubblica
service	servizio
jacques	giacomo
score	punteggio
langue	lingua
dit	detto
gouvernement	governo
petit	piccolo
toutes	tutte
argent	argento
souvent	spesso
style	stile
face	face
quand	quando
top	top
ministre	ministro
ensemble	insieme
théâtre	teatro
épisode	episodio
scène	scena
situé	situato
toute	tutta
asp	asp
étaient	erano
musée	museo
troisième	terzo
nombreux	molti
auteur	autore
cependant	tuttavia
nous	noi
système	sistema
création	creazione
stade	stadio
tard	tardi
reste	rimani
roman	romanzo
jours	giorni
édition	edizione
éditions	edizioni
sera	sarà
permet	permette
permet	consente
âge	età
robert	robert
officiel	ufficiale
environ	circa
effet	effetto
version	versione
membres	membri
niveau	livello
champion	campione
espèce	specie
michel	michel
raison	ragione
modèle	modello
travail	lavoro
femme	donna
cinq	cinque
déjà	già
bas	calze
texte	testo
terre	terra
allemagne	germania
from	from
compétition	competizione
wikipédia	wikipedia
allemand	tedesco
britannique	britannico
porte	porta
hommes	uomini
italie	italia
bataille	battaglia
corps	corpo
demi	demi
personnes	persone
nommé	nominato
route	strada
finale	finale
jeune	giovane
match	partita
peuvent	possono
york	york
royaume	regno
long	long
latitude	latitudine
base	base
études	studi
communauté	comunità
association	associazione
militaire	militare
section	sezione
longitude	longitudine
bronze	bronzo
livre	libro
américaine	americana
haut	alto
suisse	svizzera
canada	canada
valign	valign
suivant	successivo
beaucoup	molto
dire	dire
seul	solo
fille	ragazza
buts	gol
enfants	bambini
direction	direzione
position	posizione
pouvoir	potere
but	gol
but	goal
ailleurs	altrove
merci	grazie
tête	testa
territoire	territorio
union	unione
construction	costruzione
ancienne	antica
premiers	primi
maire	sindaco
présente	presente
personnalité	personalità
ligue	lega
public	pubblico
pages	pagine
agit	agisce
externe	esterno
simple	semplice
dernière	ultima
dernière	ultimo
henri	enrico
chanson	canzone
culture	cultura
grâce	grazia
développement	sviluppo
sortie	uscita
empire	impero
québec	québec
david	david
loi	legge
équipes	squadre
côté	lato
mer	mare
haute	alta
vue	vista
espagne	spagna
mère	madre
fichier	file
acteur	attore
parcours	percorso
recherche	ricerca
classement	classifica
code	codice
double	doppia
entraîneur	allenatore
web	web
arrondissement	arrondissement
directeur	direttore
joseph	giuseppe
ici	qui
vainqueur	vincitore
réalisé	realizzato
existe	esiste
six	sei
créé	creato
devant	davanti
écrit	scritto
petite	piccola
bois	legno
entreprise	azienda
retour	ritorno
numéro	numero
principale	principale
sainte	santa
comté	contea
second	second
terme	termine
connu	conosciuto
formation	formazione
arts	arti
technique	tecnica
révolution	rivoluzione
etc	ecc
objet	oggetto
mon	mio
philippe	filippo
question	domanda
lorsque	quando
cinéma	cinema
plan	piano
plan	mappa
van	van
médaille	medaglia
serait	sarebbe
œuvres	opere
zone	zona
écrivain	scrittore
compagnie	compagnia
italien	italiano
championnats	campionati
films	film
surtout	soprattutto
parfois	talvolta
sources	fonti
parc	parco
moyenne	media
mouvement	movimento
furent	furono
succès	successo
rivière	fiume
jamais	mai
vidéo	video
martin	martin
député	deputato
claude	claude
superficie	superficie
moyen	medio
till	till
notre	nostro
bon	buono
peintre	pittore
voix	voce
rouge	rosso
district	distretto
seulement	solo
pont	ponte
libre	libero
air	aria
sein	mammella
festival	festival
belgique	belgio
grands	grandi
georges	giorgio
blanc	bianco
gauche	sinistra
travaux	lavori
donne	dà
passe	passa
produit	prodotto
diffusion	diffusione
aide	aiuto
action	azione
andré	andré
font	fanno
réseau	rete
utilisé	usato
victoire	vittoria
femmes	donne
minutes	minuti
aurait	avrebbe
autour	intorno
left	left
belge	belga
certaines	alcune
durée	durata
espèces	specie
angleterre	inghilterra
afrique	africa
monuments	monumenti
sens	senso
personne	nessuno
mis	messo
municipalité	municipalità
frère	fratello
rencontre	incontro
trop	troppo
matchs	partite
japon	giappone
publié	pubblicato
domaine	dominio
eux	loro
professeur	professore
particulier	particolare
quartier	quartiere
color	color
scientifique	scienziato
honneur	onore
seule	sola
cause	causa
rien	niente
nouvelles	notizie
iii	iii
administration	amministrazione
comte	conte
suivante	successiva
fort	forte
hockey	hockey
journal	diario
moi	io
différents	diversi
rome	roma
possible	possibile
dix	dieci
taille	dimensione
sport	sport
principal	principale
sujet	soggetto
référence	riferimento
croix	croce
élections	elezioni
mettre	mettere
titres	titoli
enfin	finalmente
millions	milioni
noir	nero
joue	gioca
londres	londra
agglomération	agglomerazione
moment	momento
chapelle	cappella
russe	russo
prince	principe
activités	attività
réalisateur	regista
monument	monumento
sciences	scienze
radio	radio
classe	classe
aucun	nessun
droite	destra
lieux	luoghi
née	nata
actuel	attuale
espace	spazio
villes	città
fer	ferro
activité	attività
commence	inizia
organisation	organizzazione
sélection	selezione
assez	abbastanza
participe	partecipa
institut	istituto
james	james
internationale	internazionale
cadre	cornice
sept	sette
lac	lago
fiche	scheda
affaires	affari
télévision	televisione
duc	duca
personnage	personaggio
précédent	precedente
évêque	vescovo
cour	cortile
richard	riccardo
adresse	indirizzo
php	php
william	william
thomas	tommaso
ball	ball
résultats	risultati
problème	problema
bonne	buona
nature	natura
grandes	grandi
michael	michael
vol	volo
port	porto
right	right
donné	donato
discussion	discussione
historiques	storici
axe	asse
mesure	misurazione
mesure	misura
prendre	prendere
important	importante
données	dati
george	giorgio
force	forza
pologne	polonia
couleur	colore
collection	collezione
actrice	attrice
élu	prescelto
élu	eletto
régiment	reggimento
dessus	sopra
loire	loira
capitale	capitale
width	width
étape	tappa
créée	creata
combat	combattimento
footballeur	calciatore
forces	forze
royal	royal
aucune	nessuna
russie	russia
nicolas	nicolas
mètres	metri
presse	stampa
académie	accademia
construit	costruito
tournoi	torneo
épisodes	episodi
passage	passaggio
entrée	entrata
jeunes	giovani
présence	presenza
course	corsa
ceinture	cintura
meilleure	migliore
tableau	tabella
heures	ore
maître	maestro
services	servizi
marque	marchio
single	singolo
intérieur	interni
intérieur	interno
appelé	chiamato
locales	locali
olympique	olimpico
bernard	bernard
qualité	qualità
langues	lingue
propre	pulito
chine	cina
politiques	politiche
lettres	lettere
patrimoine	patrimonio
com	com
évolution	evoluzione
tours	tours
obtient	ottiene
compositeur	compositore
joueurs	giocatori
lyon	lione
généralement	generalmente
von	von
mal	mal
rock	rock
abbaye	abbazia
nuit	notte
principalement	principalmente
prise	presa
bretagne	bretagna
clubs	club
générale	generale
met	met
vitesse	velocità
scénario	sceneggiatura
chemin	percorso
réalisation	realizzazione
statut	statuto
groupes	gruppi
avis	avviso
éléments	elementi
carte	mappa
périhélie	perielio
sociale	sociale
travers	travers
valeur	valore
utilisation	uso
utilisation	utilizzo
utilisation	utilizzazione
palais	palazzo
émission	emissione
composé	composto
situation	situazione
droits	diritti
court	corto
court	breve
vallée	valle
comité	comitato
anciens	antichi
rugby	rugby
basse	bassa
pro	pro
occasion	occasione
total	totale
for	for
nationalité	nazionalità
chambre	camera
nouveaux	nuovi
savoir	sapere
glace	ghiaccio
originale	originale
mot	parola
main	mano
huit	otto
voïvodie	voivodato
populaire	popolare
critique	critica
publication	pubblicazione
dieu	dio
japonais	giapponese
australie	australia
catholique	cattolica
mission	missione
https	https
accord	accordo
campagne	campagna
rapidement	rapidamente
traduction	traduzione
anne	anna
départ	partenza
montréal	montréal
programme	programma
bgcolor	bgcolor
importante	importante
retrouve	ritrova
choix	scelta
coup	colpo
enfant	bambino
information	informazione
mieux	meglio
maurice	maurizio
défense	difesa
vice	vizio
contrôle	controllo
noms	nomi
produits	prodotti
internet	internet
label	etichetta
hiver	inverno
fondation	fondazione
troupes	truppe
antoine	antoine
daniel	daniel
cœur	cuore
îles	isole
pris	preso
marine	marine
peter	peter
juste	giusto
fondé	fondato
der	der
seine	senna
amour	amore
faisant	facendo
mont	monte
statistiques	statistiche
science	scienza
personnages	personaggi
bonjour	buongiorno
marc	marco
marc	marc
altitude	altitudine
économique	economico
unité	unità
particulièrement	particolarmente
lignes	righe
lignes	linee
traité	trattato
montre	orologio
idée	idea
éditeur	editore
éditeur	editor
littérature	letteratura
attaque	attacco
records	record
records	records
principaux	principali
sol	pavimento
sol	suolo
sol	sol
chaîne	canale
fondée	fondata
actuellement	attualmente
reçoit	riceve
format	formato
mode	moda
mode	modalità
original	originale
espagnol	spagnolo
producteur	produttore
artiste	artista
créer	creare
composition	composizione
los	los
décide	decide
garde	guardia
sécurité	sicurezza
fédération	federazione
quatrième	quarto
junior	junior
police	polizia
comédie	commedia
albert	albert
bruxelles	bruxelles
empereur	imperatore
infanterie	fanteria
ministère	ministero
chevalier	cavaliere
armes	armi
livres	libri
principales	principali
personnalités	personalità
unique	unico
capitaine	capitano
large	large
large	ampia
large	ampio
guillaume	guglielmo
tel	tel
commission	commissione
demandé	richiesto
demandé	chiesto
divers	varie
divers	vari
décision	decisione
actuelle	attuale
classique	classico
présent	presente
fit	fit
passé	passato
mandat	mandato
berlin	berlino
isbn	isbn
taux	tasso
surface	superficie
architecture	architettura
inscrit	iscritto
astéroïde	asteroide
transport	trasporto
sort	esce
rené	rené
alexandre	alessandro
oui	sì
annonce	annuncio
pratique	pratica
conseiller	consigliere
portail	portale
terrain	terreno
comprend	comprende
secrétaire	segretario
world	world
tennis	tennis
donner	donner
pièces	monete
fonctions	funzioni
accès	accesso
informations	informazione
marché	mercato
charge	carica
alpes	alpi
basket	pallacanestro
utiliser	utilizzare
utiliser	usare
économie	economia
longueur	lunghezza
légende	leggenda
pense	pensa
vingt	venti
arrivée	arrivo
conditions	condizioni
élection	elezione
élection	elezioni
protection	protezione
scénariste	sceneggiatore
bibliothèque	biblioteca
influence	influenza
énergie	energia
devenu	diventato
publique	pubblica
petits	piccoli
parties	parti
fiction	fiction
intérêt	interesse
structure	struttura
laurent	laurent
kilomètres	chilometri
jeunesse	gioventù
régions	regioni
majorité	maggioranza
passer	passare
veut	vuole
exposition	esposizione
poids	peso
santé	salute
feu	fuoco
italienne	italiana
atteint	raggiunto
profession	professione
trouver	trova
voyage	viaggio
supérieur	superiore
logo	logo
gestion	gestione
permettant	permettendo
derniers	ultimi
localité	località
arrière	posteriore
city	city
régime	dieta
black	black
henry	henry
autriche	austria
résultat	risultato
couleurs	colori
comment	come
nations	nazioni
signe	segno
apparaît	compare
orchestre	orchestra
concours	concorso
moderne	moderno
longue	lunga
termine	termina
wikipedia	wikipedia
phase	fase
problèmes	problemi
journaliste	giornalista
record	record
célèbre	famoso
doivent	devono
mariage	matrimonio
devenir	divenire
devenir	diventare
svg	svg
powiat	distretto
architecte	architetto
message	messaggio
artistes	artisti
constitution	costituzione
nos	nostri
roger	roger
géolocalisation	geolocalizzazione
presque	quasi
propose	propone
esprit	spirito
suivi	monitoraggio
moteur	motore
ouverture	apertura
alain	alain
élève	allievo
séries	serie
vienne	vienna
galerie	galleria
peuple	popolo
découvert	scoperto
parlement	parlamento
zip	zip
étudiant	studente
techniques	tecniche
théorie	teoria
doute	dubbio
mémoire	memoria
ami	amico
images	immagini
éducation	istruzione
éducation	educazione
magazine	rivista
don	don
pourquoi	perché
situe	situa
aller	andare
note	nota
hauteur	altezza
morts	morti
camp	camp
considéré	considerato
secteur	settore
probablement	probabilmente
social	sociale
représentant	rappresentante
saisons	stagioni
temple	tempio
forêt	foresta
importance	importanza
maintenant	ora
forte	forte
conflit	conflitto
commandant	comandante
meurt	muore
ben	ben
docteur	dottore
christian	christian
gouverneur	governatore
artistique	artistico
loin	lontano
collège	collegio
bassin	bacino
victoires	vittorie
rend	rende
bureau	scrivania
bureau	ufficio
contrat	contratto
féminin	femminile
romain	romano
professionnel	professionista
marseille	marsiglia
arbitre	arbitro
justice	giustizia
directement	direttamente
appel	chiamata
semaine	settimana
pied	piede
you	you
chanteur	cantante
neuf	nove
photographie	fotografia
principe	principio
latin	latino
victor	victor
connue	conosciuta
bord	bordo
distribution	distribuzione
environnement	ambiente
canadien	canadese
utilisée	usata
fontsize	fontsize
entreprises	aziende
lumière	luce
supérieure	superiore
frères	fratelli
train	treno
soviétique	sovietica
soviétique	sovietico
lieutenant	tenente
textes	testi
royale	royale
moitié	metà
pilote	pilota
josé	josé
studio	monolocale
réponse	risposta
reine	regina
patrick	patrick
chacun	ciascuno
chacun	ognuno
physique	fisica
auteurs	autori
chansons	canzoni
compris	compreso
compris	capito
étienne	stefano
représente	rappresenta
californie	california
volume	volume
militaires	militari
pape	papa
quoi	cosa
questions	domande
parle	parla
courant	corrente
lire	leggere
lire	leggi
industrie	industria
lettre	lettera
terres	terre
denis	denis
brésil	brasile
man	man
opération	operazione
piste	pista
paix	pace
vieux	vecchio
propriétaire	proprietario
faible	debole
faible	bassa
pyrénées	pirenei
algérie	algeria
journée	giornata
chargé	caricato
cathédrale	cattedrale
participation	partecipazione
puissance	potenza
final	finale
simon	simon
endémique	endemica
formule	formula
value	value
sœur	sorella
rendre	rendere
opéra	opera
reçu	ricevuto
joué	giocato
derrière	dietro
locale	locale
piano	pianoforte
montagne	montagna
diverses	varie
découverte	scoperta
red	red
beaux	belli
front	fronte
circonscription	circoscrizione
poète	poeta
marcel	marcel
champ	campo
val	val
religieux	religioso
archives	archivio
vote	votazione
projets	progetti
formes	forme
lycée	liceo
proximité	prossimità
seront	saranno
romaine	romana
alt	alt
obtenir	ottenere
blanche	bianca
belle	bellissima
motif	motivo
continue	continua
chant	canto
colonel	colonnello
congrès	congresso
chinois	cinese
frédéric	federico
soleil	sole
utilisateur	utente
allemands	tedeschi
moscou	mosca
sportif	sportivo
amis	amici
shift	shift
lnh	nhl
toulouse	tolosa
peinture	pittura
eut	ebbe
légion	legione
inclinaison	inclinazione
figure	figura
mexique	messico
limite	limite
dernières	ultime
cinquième	quinto
gens	persone
guitare	chitarra
liberté	libertà
html	html
contenu	contenuto
star	star
fête	festa
rhône	rodano
photo	foto
canal	canale
vincent	vincent
jouer	giocare
jules	jules
précédente	precedente
aphélie	afelio
polonais	polacco
analyse	analisi
côtés	lati
offre	offerta
sauf	salvo
travaille	lavora
frontière	confine
max	max
américains	americani
existence	esistenza
indépendance	indipendenza
bâtiments	edifici
love	love
uniquement	solo
entière	intera
résistance	resistenza
mes	miei
dessous	sotto
smith	smith
caractère	carattere
contient	contiene
bleu	blu
asie	asia
jack	jack
classé	archiviato
excentricité	eccentricità
www	www
guy	guy
signifie	significa
tome	tomo
objets	oggetti
sommet	vertice
border	border
faits	fatti
construite	costruita
matière	materia
licence	licenza
juifs	ebrei
médecin	medico
écrire	scrivere
lance	lancia
ehess	ehess
besoin	bisogno
fondateur	fondatore
avance	anticipo
grec	greco
bordeaux	bordeaux
règles	regole
soldats	soldati
mark	mark
chicago	chicago
provence	provenza
religion	religione
successeur	successore
cimetière	cimitero
composée	composta
somme	somma
éviter	evitare
réserve	riserva
défaite	sconfitta
sports	sport
background	background
cardinal	cardinale
encyclopédie	enciclopedia
résumé	riassunto
lorraine	lorraine
lutte	lotta
parents	genitori
tournée	tour
rose	rosa
disque	disco
recensement	censimento
philosophie	filosofia
open	open
hôpital	ospedale
propriété	proprietà
cycliste	ciclista
collaboration	collaborazione
ouvert	aperto
parler	parlare
expression	espressione
astéroïdes	asteroidi
nécessaire	necessario
suède	svezia
difficile	difficile
inconnu	sconosciuto
tom	tom
champions	campioni
modèles	modelli
vit	vive
meilleurs	migliori
animaux	animali
cheval	cavallo
soutien	sostegno
navires	navi
débuts	debutto
milan	milano
animation	animazione
raymond	raymond
méthode	metodo
communication	comunicazione
petites	piccole
jardin	giardino
min	min
avion	aereo
paroisse	parrocchia
internes	interni
mots	parole
portugal	portogallo
devint	divenne
devint	diventò
vert	verde
strasbourg	strasburgo
personnel	personale
local	locale
frank	frank
olivier	olivier
catherine	caterina
historien	storico
inde	india
crée	crea
navire	nave
dessinée	disegnata
baptiste	baptiste
étudiants	studenti
apparition	apparizione
manque	mancanza
plein	pieno
naturel	naturale
opposition	opposizione
franco	franco
simplement	semplicemente
essentiellement	essenzialmente
pourtant	eppure
adaptation	adattamento
abbé	abate
gérard	gérard
argument	argomento
semaines	settimane
familles	famiglie
expérience	esperimento
gardien	guardiano
appelle	chiama
dramatique	drammatico
extérieur	esterno
restauration	ristorazione
draft	draft
médecine	medicina
marne	marne
marne	marna
régional	regionale
thème	tema
prison	carcere
distance	distanza
capacité	capacità
écoles	scuole
arrêté	arrestato
tradition	tradizione
réalité	realtà
savoie	savoia
connaissance	conoscenza
étoile	stella
jaune	giallo
serbie	serbia
permettent	permettono
traitement	trattamento
masse	massa
arc	arco
devait	doveva
tombe	tomba
risque	rischio
socialiste	socialista
réalise	realizza
vrai	vero
armées	eserciti
baseball	baseball
arabe	arabo
acte	atto
arthur	arthur
live	live
grèce	grecia
major	major
major	maggiore
civile	civile
essai	prova
décrit	descritto
écosse	scozia
albums	album
héros	eroe
reprend	riprende
termes	termini
permis	permessi
nantes	nantes
filles	ragazze
midi	midi
aura	aura
pdf	pdf
géographique	geografico
ciel	cielo
anti	anti
rang	rango
occidentale	occidentale
washington	washington
rurale	rurale
maladie	malattia
aéroport	aeroporto
king	king
dictionnaire	dizionario
autorité	autorità
portant	recante
préfecture	prefettura
officielle	ufficiale
futur	futuro
objectif	obiettivo
cap	cap
ingénieur	ingegnere
actes	atti
irlande	irlanda
hongrie	ungheria
peine	pena
britanniques	britannici
absence	assenza
importants	importanti
guerres	guerre
yves	yves
chanteuse	cantante
crise	crisi
brigade	brigata
chapitre	capitolo
laisse	lascia
madrid	madrid
cordialement	cordialmente
drapeau	bandiera
utilisés	utilizzati
utilisés	usati
application	applicazione
responsable	responsabile
circuit	circuito
japonaise	giapponese
banque	banca
décédé	deceduto
danse	danza
désigner	designare
genève	ginevra
développé	sviluppato
systèmes	sistemi
officiellement	ufficialmente
remplacé	sostituito
fleuve	fiume
univers	universo
villages	villaggi
critiques	recensioni
vraiment	veramente
vraiment	davvero
american	american
argentine	argentina
salon	salotto
salon	salone
écriture	scrittura
libération	liberazione
entièrement	interamente
die	die
jazz	jazz
caractéristiques	caratteristiche
réunion	riunione
trente	trento
julien	giuliano
chasse	caccia
processus	processo
awards	awards
gaz	gas
orléans	orléans
catégories	categorie
park	park
propres	puliti
press	press
united	united
mixte	misto
régulièrement	regolarmente
juan	juan
lee	lee
rapide	veloce
agriculture	agricoltura
traduit	tradotto
chœur	coro
décret	decreto
léon	léon
naturelle	naturale
plantes	piante
permettre	consentire
résidence	residenza
fusion	fusione
critères	criteri
commandement	comando
portrait	ritratto
mairie	municipio
choses	cose
jan	jan
sang	sangue
jeanne	giovanna
indique	indica
yeux	occhi
all	all
types	tipi
moyens	mezzi
reprise	ripresa
prédécesseur	predecessore
description	descrizione
table	tavolo
antonio	antonio
magnitude	magnitudo
blue	blue
emploi	occupazione
promotion	promozione
québécois	québec
alliance	alleanza
dite	detta
obtenu	ottenuto
unités	unità
importantes	importanti
brun	marrone
originaire	originario
remporté	vinto
participé	partecipato
actions	azioni
baron	barone
contributeurs	collaboratori
biographie	biografia
effets	effetti
bosnie	bosnia
explique	spiega
égypte	egitto
avenue	avenue
blocage	blocco
dominique	dominique
nœud	nodo
serbe	serbo
événements	eventi
christophe	christophe
atelier	workshop
atelier	officina
auguste	augusto
raisons	motivi
devrait	dovrebbe
francis	francis
atlantique	atlantico
voiture	macchina
agent	agente
disney	disney
écrite	scritta
chute	caduta
communiste	comunista
présentation	presentazione
étranger	straniero
documentaire	documentario
cartes	mappa
sièges	sedili
secret	segreto
secret	secret
couple	coppia
col	colle
métro	metropolitana
mary	mary
mines	miniere
conférence	conferenza
alsace	alsazia
mains	mani
alfred	alfred
locaux	locali
museum	museum
publiée	pubblicato
coureur	corridore
basé	basato
différence	differenza
enregistré	registrato
xls	xls
connexe	correlati
changement	cambiamento
privée	privato
commencé	iniziato
électrique	elettrico
opérations	operazioni
diocèse	diocesi
rhin	reno
identité	identità
normandie	normandia
culturel	culturale
variation	variazione
romans	romanzi
bourg	borgo
hommage	omaggio
collecte	raccolta
transports	trasporti
seuls	soli
rio	rio
juge	giudice
francisco	francisco
néerlandais	olandese
lille	lilla
complexe	complesso
und	und
concept	concetto
universitaire	accademico
titulaire	titolare
contexte	contesto
contact	contatto
vis	vis
vis	viti
concert	concerto
lois	leggi
douze	dodici
ferme	fattoria
one	one
correspond	corrisponde
édouard	edoardo
massif	massiccio
vente	vendita
athlétisme	atletica
culte	culto
répartition	ripartizione
avocat	avvocato
bras	braccio
calais	calais
conduit	condotto
perdu	perso
nice	nizza
visite	visita
solution	soluzione
atteindre	raggiungere
volley	volley
promu	promosso
portes	porte
informatique	informatica
conception	progettazione
mur	muro
scientifiques	scienziati
tourisme	turismo
passant	passante
green	green
façade	facciata
statue	statua
photos	foto
construire	costruire
tente	tenda
scott	scott
liège	liegi
huile	olio
convention	convenzione
orient	oriente
tourné	girato
dessin	disegno
barcelone	barcellona
manuel	manuale
joe	joe
pression	pressione
maroc	marocco
faux	falso
constitué	costituito
christ	cristo
colombie	colombia
baie	baia
documents	documenti
athlète	atleta
bourgogne	borgogna
contraire	contraria
destination	destinazione
champs	campi
vierge	vergine
température	temperatura
enfance	infanzia
acteurs	attori
candidat	candidato
lancé	lanciato
dates	date
cercle	cerchio
essais	prove
aider	aiutare
mention	menzione
agence	agenzia
perd	perde
mari	mari
élément	elemento
pouvait	poteva
représentation	rappresentazione
représentation	rappresentanza
cycle	ciclo
renaissance	rinascita
renaissance	rinascimento
pouvant	potendo
hall	hall
attention	attenzione
jones	jones
marin	marin
domaines	domini
usine	fabbrica
fontaine	fontana
roland	roland
printemps	primavera
prêtre	prete
étoiles	stelle
réforme	riforma
chris	chris
gabriel	gabriel
élevé	alto
monastère	monastero
organisé	organizzato
dos	schiena
dos	dos
noël	natale
enquête	indagine
trouvé	trovato
anomalie	anomalia
ign	ign
majeur	maggiorenne
beau	bello
beau	bellissimo
villa	villa
lecture	lettura
montage	montaggio
dollars	dollari
professionnelle	professionale
masculin	maschile
masculin	maschio
cantons	cantoni
branche	ramo
batterie	batteria
pointe	punta
thèse	tesi
rgb	rgb
démocratique	democratica
démocratique	democratico
géographie	geografia
nancy	nancy
amateur	dilettante
amateur	dilettanti
ascendant	ascendente
caroline	caroline
participer	partecipare
autorités	autorità
clair	chiaro
test	test
west	west
relativement	relativamente
exemplaires	esemplari
exemplaires	copie
versions	versioni
venir	venire
laisser	lasciare
gilles	gilles
plateau	vassoio
bataillon	battaglione
vin	vino
devenue	diventata
découvreur	scopritore
spécialiste	specialista
vivant	vivente
vivant	vivo
ressources	risorse
ajouter	aggiungi
rencontres	incontri
demander	chiedere
israël	israele
tué	ucciso
généraux	generali
siècles	secoli
présenté	presentato
territoires	territori
png	png
mike	mike
revanche	rivincita
napoléon	napoleone
net	netto
planète	pianeta
intervention	intervento
législature	legislatura
bob	bob
white	white
océan	oceano
idées	idee
combats	combattimenti
corée	corea
tokyo	tokyo
totale	totale
finales	finali
certaine	certa
comprendre	comprensione
vivre	vivere
edward	edward
edward	edoardo
ordres	ordini
arme	arma
dynastie	dinastia
erreur	errore
publications	pubblicazioni
coll	coll
organisme	organismo
williams	williams
faculté	facoltà
génération	generazione
expédition	spedizione
tchèque	ceco
google	google
arbre	albero
tribunal	tribunale
appartient	appartiene
règle	regola
walter	walter
possibilité	possibilità
euros	euro
eugène	eugène
avions	aerei
archevêque	arcivescovo
participants	partecipanti
dvd	dvd
artillerie	artiglieria
mesures	misure
vent	vento
logiciel	software
définition	definizione
danemark	danimarca
administrateur	amministratore
bruno	bruno
travailler	lavorare
églises	chiese
mouvements	movimenti
princesse	principessa
volonté	volontà
germain	germain
oiseaux	uccelli
homonymie	disambigua
race	razza
sûr	sicuro
disponible	disponibile
continentale	continentale
ouvre	apre
ouvre	apri
échelle	scala
machine	macchina
sujets	argomenti
change	cambia
luxembourg	lussemburgo
antique	antico
antique	antica
manche	manica
canadienne	canadese
buteur	centravanti
dimanche	domenica
électronique	elettronica
fil	filo
suivre	seguire
sixième	sesto
accident	incidente
cérémonie	cerimonia
discours	discorso
bill	bill
finaliste	finalista
humaine	umana
échange	scambio
usa	usa
riche	ricco
néo	neo
langage	linguaggio
effectif	effettivo
feuilles	foglie
maréchal	maresciallo
répondre	rispondi
herzégovine	erzegovina
spectacle	spettacolo
plans	piani
moulin	mulino
déclare	dichiara
débat	dibattito
numérique	digitale
mayotte	mayotte
rendu	rendering
rendu	reso
musicien	musicista
champagne	champagne
disparu	scomparso
rouges	rosse
poésie	poesia
ouverte	aperto
ouverte	aperta
choisi	prescelto
valeurs	valori
accueil	accoglienza
tar	tar
productions	produzioni
fédéral	federale
big	big
montagnes	montagna
louise	louise
supprimer	rimuovi
aventure	avventura
harry	harry
claire	chiara
religieuse	religiosa
carlos	carlos
guide	guida
solid	solid
anna	anna
jésus	gesù
adjoint	vice
steve	steve
initialement	inizialmente
actif	attivo
événement	evento
installe	installa
fonctionnement	funzionamento
rennes	rennes
exception	eccezione
extrême	estremo
populations	popolazioni
contributions	contributi
venise	venezia
associé	associato
zonage	zonizzazione
civil	civile
connaître	conoscere
tunisie	tunisia
group	group
élus	eletti
lancer	lanciare
tiers	terzi
retrouver	ritrovare
commande	comando
porté	indossato
interprète	interprete
tony	tony
standard	standard
réalisée	realizzata
introduction	introduzione
porter	porter
approche	approccio
reconnaissance	riconoscimento
metal	metal
boston	boston
effectue	effettua
eric	eric
provinces	province
pose	posa
orange	arancione
adam	adam
fleurs	fiori
matin	mattina
missions	missioni
flotte	flotta
dessins	disegni
monsieur	signore
amateurs	dilettanti
turquie	turchia
localisation	localizzazione
gagne	vince
officiers	ufficiali
origines	origini
indépendant	indipendente
nef	navata
blason	stemma
émile	émile
écrits	scritti
house	house
importe	importa
marquis	marchese
pouvoirs	poteri
commercial	commerciale
bat	bat
césar	cesare
suédois	svedese
young	young
victimes	vittime
mille	mille
direct	diretto
dames	dama
siren	siren
couronne	corona
attaquant	attaccante
mini	mini
privé	privato
réaliser	realizzare
commons	commons
outils	strumenti
complet	completo
florence	firenze
trophée	trofeo
finlande	finlandia
paroles	testi
sinon	altrimenti
envoyé	inviato
rares	rari
donnée	dato
comportement	comportamento
contributeur	collaboratore
humain	umano
info	info
signé	firmato
texas	texas
russes	russi
septième	settimo
sélections	selezioni
pascal	pascal
internationales	internazionali
maillot	maglia
lune	luna
orbite	orbita
championne	campionessa
développer	sviluppare
extension	estensione
scènes	scene
amiral	ammiraglio
murs	mura
francs	franchi
modifications	modifiche
norvège	norvegia
life	life
corse	corsica
mario	mario
prises	prese
initiative	iniziativa
autonome	autonoma
autonome	autonomo
marguerite	margherita
datant	datazione
mathématiques	matematica
majeure	maggiorenne
brown	brown
améliorer	migliorare
sénateur	senatore
montpellier	montpellier
morte	morta
serge	serge
rouen	rouen
profondeur	profondità
partage	condivisione
apprend	impara
changer	cambiare
croissance	crescita
interne	interno
portugais	portoghese
profil	profilo
refuse	rifiuta
hans	hans
maximum	massimo
cabinet	gabinetto
thierry	thierry
saône	saona
présidence	presidenza
voyageurs	viaggiatori
demeure	dimora
sculpteur	scultore
alexander	alexander
vision	visione
metz	metz
forêts	foreste
étapes	fasi
céleste	celeste
associations	associazioni
grade	grado
impériale	imperiale
sam	sam
contenant	contenente
modifier	modifica
dehors	fuori
servir	servire
protéger	proteggere
baisse	goccia
pacifique	pacifico
madame	signora
grecque	greco
fédérale	federale
sébastien	sebastiano
défenseur	difensore
œil	occhio
diplôme	diploma
réaction	reazione
cyclisme	bicicletta
nucléaire	nucleare
karl	karl
chevaux	cavalli
partis	partiti
climat	clima
instrument	strumento
respectivement	rispettivamente
automne	autunno
caractères	caratteri
secondaire	secondario
grenoble	grenoble
animal	animale
roumanie	romania
appelés	chiamati
victime	vittima
semi	semi
reconnu	riconosciuto
véhicules	veicoli
garonne	garonna
interprétation	interpretazione
proposé	proposto
gray	gray
emmanuel	emanuele
plante	pianta
repris	ripreso
boulevard	boulevard
interdit	vietato
entier	intero
london	london
angle	angolo
contemporain	contemporaneo
preuve	prova
barrage	diga
immédiatement	immediatamente
anvers	anversa
présents	presenti
toronto	toronto
courte	breve
domicile	domicilio
aime	ama
programmes	programmi
budget	budget
budget	bilancio
noblesse	nobiltà
policier	poliziotto
précise	precisa
toile	ragnatela
secondaires	secondari
inspiré	ispirato
chercher	cerca
évaluation	valutazione
classification	classificazione
détruit	distrutto
quartiers	quartieri
chacune	ognuna
chacune	ciascuna
principes	principi
disparition	scomparsa
bistro	bistrot
échec	fallimento
rédaction	redazione
serveur	server
oise	oise
signature	firma
trône	trono
prennent	prendono
carl	carl
produire	produrre
profit	profitto
chien	cane
urss	urss
correspondant	corrispondente
time	time
traverse	attraversa
nationaux	nazionali
marqué	segnato
marqué	contrassegnato
secondes	secondi
ruisseau	ruscello
roche	roccia
connus	conosciuti
connus	noti
largeur	larghezza
remplacer	sostituire
org	org
françoise	francesca
spécial	speciale
foi	fede
professionnels	professionisti
récemment	recentemente
munich	monaco
institutions	istituzioni
vii	vii
pêche	pescare
complètement	completamente
volumes	volumi
nation	nazione
développe	sviluppa
accueille	accoglie
notion	nozione
symbole	simbolo
alger	algeri
catalogue	catalogo
prisonniers	prigionieri
francophone	francofona
tir	tiro
puits	pozzo
emplacement	posizione
unies	unite
philosophe	filosofo
étudie	studia
facilement	facilmente
benoît	benoît
benoît	benedetto
décidé	deciso
souhaite	augura
end	end
coups	colpi
forment	formano
johnson	johnson
hongrois	ungherese
rois	re
modification	modifica
mineures	minorenni
pieds	piedi
pensée	pensiero
phénomène	fenomeno
planètes	pianeti
engage	impegna
vaste	vasto
relais	relè
déposé	depositato
roy	roy
exemples	esempi
marins	marinai
poèmes	poesie
tendance	tendenza
libéral	liberale
orientation	orientamento
post	post
xxx	xxx
congo	congo
street	street
ennemi	nemico
moselle	mosella
multiples	multiple
indien	indiano
comptes	conti
joueuse	giocatrice
calendrier	calendario
clocher	campanile
avenir	futuro
mécanique	meccanica
jérusalem	gerusalemme
étrangers	stranieri
réel	reale
cavalerie	cavalleria
écran	schermo
concerts	concerti
organise	organizza
jim	jim
industriel	industriale
rester	rimanere
consommation	consumo
mauvais	cattivo
brian	brian
condition	condizione
utilisateurs	utenti
plaine	pianura
perte	perdita
intégral	integrale
méthodes	metodi
impact	impatto
candidats	candidati
victoria	victoria
classes	classi
attaques	attacchi
portée	portata
performance	prestazioni
oscar	oscar
définitivement	definitivamente
romains	romani
établi	stabilito
compose	compone
basée	basata
collectif	collettivo
quantité	quantità
conseillers	consiglieri
versailles	versailles
anniversaire	anniversario
anniversaire	compleanno
conservateur	conservatore
niveaux	livelli
alex	alex
capable	capace
internationaux	internazionali
couverture	copertura
cuisine	cucina
arbres	alberi
émissions	emissioni
disposition	disposizione
racing	racing
conservatoire	conservatorio
parallèle	parallelo
sénat	senato
humains	umani
ray	ray
milliards	miliardi
huitième	ottavo
pos	pos
bertrand	bertrand
blues	blues
modernes	moderni
xxie	xxi
entrer	entrare
réseaux	reti
édité	pubblicato
duché	ducato
alliés	alleati
hauts	alti
tentative	tentativo
progressivement	progressivamente
progressivement	gradualmente
dragon	drago
mène	conduce
vandalisme	vandalismo
difficultés	difficoltà
religieuses	religiose
penser	pensare
personnelle	personale
présenter	presentare
café	caffè
inscription	iscrizione
luis	luis
isabelle	isabelle
confiance	fiducia
propriétés	proprietà
polonaise	polacco
aix	aix
aventures	avventure
instruments	strumenti
conserve	conserva
départements	dipartimenti
finances	finanza
galles	galles
onze	undici
moteurs	motori
pratiques	pratiche
prévu	previsto
procédure	procedura
charente	charente
pleine	piena
noirs	neri
célèbres	famosi
dimensions	dimensioni
pertes	perdite
ajoute	aggiunge
laval	laval
ontario	ontario
document	documento
augmentation	aumento
limites	limiti
qualification	qualificazione
qualification	qualifica
éric	eric
condamné	condannato
ernest	ernest
oncle	zio
conservé	conservato
contemporaine	contemporaneo
contemporaine	contemporanea
jackson	jackson
blancs	bianchi
best	best
démocrate	democratico
plage	spiaggia
drame	dramma
entretien	manutenzione
vide	vuoto
musiciens	musicisti
accepte	accetta
saints	santi
show	show
félix	félix
revenir	ritornare
handball	pallamano
benjamin	benjamin
chiffre	cifra
reims	reims
windows	windows
canon	cannone
collections	collezioni
anthony	anthony
active	attiva
organisée	organizzata
initiale	iniziale
ali	ali
décors	scenografia
sculpture	scultura
chance	fortuna
attendre	attendere
destruction	distruzione
samuel	samuel
dir	dir
cross	cross
history	history
real	real
avignon	avignone
amsterdam	amsterdam
sophie	sophie
auvergne	auvergne
enregistrement	registrazione
davis	davis
quotidien	quotidiano
leader	leader
trafic	traffico
auto	auto
spécifique	specifica
spécifique	specifico
peau	pelle
ferdinand	ferdinand
duo	duetto
duo	duo
espaces	spazi
impossible	impossibile
ukraine	ucraina
maine	maine
vieille	vecchia
incendie	incendio
acide	acido
gilbert	gilbert
poule	gallina
succession	successione
kevin	kevin
technologie	tecnologia
kim	kim
madeleine	madeleine
utile	utile
saut	salto
pré	pre
enceinte	incinta
conservation	conservazione
hugo	hugo
sacré	sacro
sacré	sacra
régulière	regolare
sortir	uscire
affluent	affluente
ministres	ministri
stephen	stephen
clairement	chiaramente
athènes	atene
urbain	urbano
xiii	xiii
clermont	clermont
préfet	prefetto
essentiel	essenziale
stéphane	stefano
laboratoire	laboratorio
distingue	distingue
primaire	primario
primaire	primaria
restent	restano
portent	indossano
wiki	wiki
équipage	equipaggio
tuer	uccidere
logique	logica
adapté	adattato
xavier	xavier
orgue	organo
bulletin	bollettino
impression	stampa
dépend	dipende
conséquence	conseguenza
visible	visibile
habitat	habitat
breton	breton
souris	mouse
photographe	fotografo
autoroute	autostrada
ponts	ponti
taylor	taylor
vérité	verità
quinze	quinze
quinze	quindici
mérite	merito
mérite	merita
constituée	costituita
jérôme	jérôme
day	day
assistant	assistente
bavière	baviera
marié	sposato
satellite	satellite
samedi	sabato
alan	alan
chili	cile
exécution	esecuzione
carlo	carlo
boîte	scatola
rôles	ruoli
légèrement	leggermente
gallimard	gallimard
alice	alice
las	las
saxe	sassonia
intermédiaire	intermediario
intermédiaire	intermedio
distinctions	distinzioni
thèmes	temi
installation	installazione
australien	australiano
chinoise	cinese
relief	rilievo
pierres	pietra
north	north
histoires	storie
équivalent	equivalente
phrase	frase
récompense	ricompensa
lancement	lancio
patron	capo
conçu	progettato
structures	strutture
culturelle	culturale
aviation	aviazione
chrétiens	cristiani
syndicat	sindacato
lewis	lewis
menace	minaccia
poursuite	inseguimento
basque	basco
mans	mans
lot	lotto
lot	lot
commissaire	commissario
araignées	ragni
employé	impiegato
parole	parola
manifestations	manifestazioni
installé	installato
arabes	arabi
conserver	conservare
reprendre	riprendere
manga	manga
conseils	suggerimenti
latine	latina
bases	basi
andrew	andrew
diamètre	diametro
peintures	dipinti
invasion	invasione
adversaire	avversario
individus	individui
franchise	franchigia
iran	iran
blessés	feriti
conscience	coscienza
conscience	consapevolezza
maîtres	maestri
représenté	rappresentato
expositions	mostre
naples	napoli
lion	leone
peur	paura
prague	praga
administratif	amministrativo
lausanne	losanna
peuples	popoli
nomination	nomina
crime	delitto
chrétienne	cristiana
respect	rispetto
mobile	mobile
chiffres	cifre
raconte	racconta
sœurs	sorelle
bientôt	presto
vendredi	venerdì
spéciale	speciale
commentaire	commento
véhicule	veicolo
départemental	dipartimentale
irlandais	irlandese
densité	densità
catholiques	cattolici
apparaissent	appaiono
rare	rari
rare	raro
transfert	trasferimento
laissé	lasciato
blessé	ferito
annoncé	annunciato
aile	ala
carré	quadrato
juive	ebraica
var	var
lit	letto
floride	florida
fera	farà
servi	servito
seuil	soglia
milliers	migliaia
dirigeant	dirigente
loup	lupo
détroit	stretto
mémoires	memorie
préparation	preparazione
chronologie	cronologia
classiques	classici
minimum	minimo
révolutionnaire	rivoluzionario
nécessaires	necessari
bibliographie	bibliografia
grave	grave
brunswick	brunswick
infobox	infobox
million	milione
poème	poesia
extrait	estratto
contribution	contributo
hill	hill
rivières	fiumi
directe	diretta
directe	diretto
inférieure	inferiore
renommé	rinominato
gris	grigio
aquitaine	aquitania
clément	clément
barbara	barbara
notoriété	notorietà
euro	euro
léger	leggero
disponibles	disponibili
danger	pericolo
land	land
désigné	designato
utilisent	usano
utilisent	utilizzano
wilson	wilson
libres	liberi
plate	piana
similaire	simile
travaillé	lavorato
municipalités	municipalità
cordes	corde
golden	golden
détail	dettaglio
dan	dan
accompagné	accompagnato
hypothèse	ipotesi
matériaux	materiali
risques	rischi
confluence	confluenza
charlotte	charlotte
jury	giuria
anglo	anglo
révolte	rivolta
monnaie	valuta
enseigne	insegna
franc	franco
révèle	rivela
didier	didier
mac	mac
variété	varietà
ascension	ascensione
vendu	venduto
ford	ford
jane	jane
frontières	frontiere
frontières	confini
observatoire	osservatorio
ailes	ali
machines	macchine
julie	julie
institution	istituzione
caen	caen
organisations	organizzazioni
river	river
varsovie	varsavia
déclaré	dichiarato
présidentielle	presidenziali
compter	contare
normale	normale
résolution	risoluzione
pilotes	piloti
conquête	conquista
rowspan	rowspan
hélène	elena
besoins	bisogni
genres	generi
bref	breve
inférieur	inferiore
tenir	tenere
cannes	cannes
neige	neve
discussions	discussioni
installer	installare
défaut	difetto
discipline	disciplina
responsabilité	responsabilità
paysage	paesaggio
poissons	pesci
poissons	pesce
couvent	convento
violence	violenza
coût	costo
espoirs	speranze
comics	comics
africain	africano
bandes	nastri
trouvait	trovava
sir	sir
cellules	celle
fosse	fossa
costumes	costumi
johnny	johnny
espoir	speranza
actuels	attuali
jardins	giardini
destinée	destino
médailles	medaglie
angers	angers
détails	dettagli
déclaration	dichiarazione
extrémité	estremità
colonne	colonna
populaires	popolare
populaires	popolari
monaco	monaco
mises	puntate
fêtes	festeggiamenti
gagner	vincere
dijon	digione
invité	invitato
outil	strumento
prêt	prestito
publiés	pubblicati
mauvaise	cattiva
inventaire	inventario
violon	violino
effectué	effettuato
élevée	elevata
élevage	allevamento
traditionnelle	tradizionale
remplacement	sostituzione
islam	islam
battu	battuto
réduit	ridotto
traces	tracce
war	war
égalité	uguaglianza
créateur	creatore
expliquer	spiegare
environs	dintorni
juridique	legale
coalition	coalizione
intérêts	interessi
fox	fox
inspecteur	ispettore
marais	palude
moines	monaci
kong	kong
chimie	chimica
prenant	prendendo
poisson	pesce
inter	inter
fruits	frutta
passion	passione
start	start
chercheurs	ricercatori
secours	soccorso
chat	gatto
stratégie	strategia
johann	johann
sarah	sarah
interprété	interpretato
retrait	ritiro
coopération	cooperazione
laissant	lasciando
archipel	arcipelago
géorgie	georgia
âme	anima
gothique	gotico
bloc	blocco
méditerranée	mediterraneo
visiteurs	visitatori
clan	clan
répond	risponde
capital	capitale
caractérisée	caratterizzata
surnom	soprannome
express	express
naît	nasce
électricité	elettricità
mit	mit
deviendra	diventerà
facile	facile
différent	differente
découvrir	scoprire
changements	cambiamenti
fred	fred
chrétien	cristiano
oxford	oxford
croatie	croazia
ange	angelo
gaston	gaston
robin	robin
opinion	opinione
bonnes	buone
classements	classifiche
récompenses	riconoscimenti
xiv	xiv
conflits	conflitti
transformation	trasformazione
remplace	sostituisce
cultures	colture
étudier	studiare
consacrée	consacrata
lundi	lunedì
viii	viii
limitée	limitata
andrea	andrea
accessible	accessibile
universités	università
virginie	virginia
avantage	vantaggio
monts	monti
deviennent	diventano
partout	ovunque
engagé	impegnato
objectifs	obiettivi
ann	ann
écossais	scozzese
soirée	serata
mélange	miscela
mine	miniera
montée	salita
alphonse	alphonse
acquis	acquisito
lucien	lucien
disques	dischi
représentent	rappresentano
support	supporto
sydney	sydney
qualifié	qualificato
introduit	introdotto
caractéristique	caratteristica
caractéristique	caratteristico
belles	belle
nba	nba
howard	howard
charlie	charlie
guitariste	chitarrista
évêques	vescovi
défendre	difendere
conséquences	conseguenze
maires	sindaci
elizabeth	elisabetta
recevoir	ricevere
performances	prestazioni
autrichien	austriaco
brest	brest
pianiste	pianista
étrangère	straniera
friedrich	friedrich
occupé	occupato
archéologique	archeologico
musées	musei
traversée	traversata
réussi	riuscita
réussi	riuscito
armand	armand
antiquité	antichità
brésilien	brasiliano
produite	prodotta
doctorat	dottorato
centaines	centinaia
maîtrise	padronanza
encyclopédique	enciclopedica
réédition	riedizione
calcul	calcolo
rêve	sogno
mathieu	matteo
camille	camille
dérivés	derivati
simples	semplici
plaque	placca
plaque	piastra
fondateurs	fondatori
ffffff	ffffff
body	body
nez	naso
quai	banchina
démocratie	democrazia
meurtre	omicidio
barre	barra
meilleures	migliori
métropole	metropoli
vigueur	vigore
neuvième	nono
minute	minuto
élite	élite
élite	elite
applications	applicazioni
verre	vetro
abandon	abbandono
queue	coda
ivoire	avorio
hong	hong
chantier	cantiere
ivan	ivan
partisans	sostenitori
design	design
pistes	piste
exécutif	esecutivo
jonathan	jonathan
jacob	giacobbe
mythologie	mitologia
belgrade	belgrado
revenu	reddito
guinée	guinea
gamme	gamma
basilique	basilica
girl	girl
confédération	confederazione
dessinateur	disegnatore
jimmy	jimmy
regard	sguardo
rallye	rally
valence	valencia
amitié	amicizia
colspan	colspan
dossier	cartella
diego	diego
maladies	malattie
oiseau	uccello
ump	ump
verte	verde
citer	citare
constructeur	costruttore
péninsule	penisola
francesco	francesco
campagnes	campagne
compilation	compilazione
connaissances	conoscenze
connaissances	conoscenza
copié	copiato
terrestre	terrestre
budapest	budapest
représentations	rappresentanze
noble	nobile
ambassadeur	ambasciatore
inverse	inverso
inverse	inversa
opérateur	operatore
possession	possesso
souvenir	ricordo
forteresse	fortezza
ennemis	nemici
sections	sezioni
positions	posizioni
engagement	impegno
languedoc	languedoc
são	são
localités	località
inscrits	iscritti
quarante	quaranta
hectares	ettari
golfe	golfo
seigneurie	signoria
italiens	italiani
commandeur	commendatore
title	title
supprimé	eliminato
douglas	douglas
lady	lady
listes	elenchi
boy	boy
arbitrage	arbitrato
lecteur	lettore
idem	idem
remise	sconto
établie	stabilita
tire	spara
hop	hop
christopher	christopher
maintenir	mantenere
réduire	ridurre
anderson	anderson
christine	christine
goût	sapore
sélectionné	selezionato
venus	venus
miller	miller
dédié	dedicato
exil	esilio
terminé	completato
cambridge	cambridge
construits	costruiti
fixe	fisso
sncf	sncf
ventes	vendite
relative	relativa
cancer	cancro
donald	donald
agents	agenti
observation	osservazione
parallèlement	parallelamente
fréquence	frequenza
dure	dura
scrutin	scrutinio
sortant	uscente
vins	vini
employés	impiegati
out	out
forum	forum
lanceur	lanciatore
administrativement	amministrativamente
solaire	solare
alimentation	alimentazione
neutre	neutrale
neutre	neutro
tués	uccisi
empêcher	impedire
orthodoxe	ortodosso
citoyens	cittadini
vladimir	vladimir
stadium	stadium
ouvriers	operai
pseudonyme	pseudonimo
humanité	umanità
clé	chiave
manuscrit	manoscritto
déterminer	determinare
défaites	sconfitte
colline	collina
who	who
divisions	divisioni
dédiée	dedicata
gustave	gustave
longues	lunghe
continent	continente
naturelles	naturali
trésor	tesoro
ruines	rovine
technologies	tecnologie
existent	esistono
picardie	piccardia
porto	porto
bourbon	bourbon
difficulté	difficoltà
franz	franz
ombre	ombra
cousin	cugino
vapeur	vapore
interview	intervista
bay	bay
colonnes	colonne
pôle	polo
républicain	repubblicano
attribué	attribuito
attribué	assegnato
choisit	sceglie
rédacteur	redattore
stanley	stanley
muet	muto
historiens	storici
pétersbourg	pietroburgo
couvre	copre
garçon	ragazzo
western	western
vérifier	verificare
proposer	proporre
transmission	trasmissione
soldat	soldato
veille	veglia
canadiens	canadese
jersey	jersey
sénégal	senegal
option	opzione
pluie	pioggia
commentaires	commenti
fpu	fpu
turin	torino
poitou	poitou
touche	tasto
évoque	evoca
automatique	automatico
compétences	competenze
compétences	abilità
extrêmement	estremamente
neveu	nipote
pictures	pictures
mohamed	mohamed
hubert	hubert
cinquante	cinquanta
publicité	pubblicità
souverain	sovrano
associés	soci
chronique	cronaca
imposer	imporre
renault	renault
arrivé	arrivato
préface	prefazione
échecs	scacchi
frais	freschi
figures	figure
traite	mungitura
pérou	perù
bloqué	bloccato
palette	tavolozza
indépendante	indipendente
tramway	tram
peintres	pittori
élisabeth	elisabetta
amiens	amiens
louvre	louvre
troubles	disturbi
marco	marco
lès	lès
entertainment	entertainment
offensive	offensiva
amie	amica
alias	alias
concentration	concentrazione
series	series
précision	precisione
passagers	passeggeri
can	can
degré	grado
puissant	potente
espagnols	spagnoli
correspondance	corrispondenza
hamilton	hamilton
partiellement	parzialmente
tim	tim
sauver	salvare
juniors	juniores
visage	viso
possibles	possibili
country	country
provoque	provoca
future	futura
danois	danese
montrer	mostrare
conférences	conferenze
paramètres	impostazioni
réflexion	riflessione
philadelphie	philadelphia
prononciation	pronuncia
actualité	attualità
aube	alba
mariée	sposata
meuse	mosa
billy	billy
répertoire	directory
écrivains	scrittori
admissibilité	ammissibilità
poser	posare
mazovie	masovia
traditionnel	tradizionale
lacs	laghi
suprême	supremo
musulmans	musulmani
ain	ain
autorisation	autorizzazione
sexe	sesso
séjour	soggiorno
installations	installazioni
andy	andy
suivent	seguono
norme	norma
gordon	gordon
ordinateur	computer
graphique	grafico
repose	riposa
ligues	leghe
nick	nick
surprise	sorpresa
juif	ebreo
efficace	efficiente
bulgarie	bulgaria
grecs	greci
séparation	separazione
perdre	perdere
puy	puy
contes	racconti
longs	lunghi
votes	votazioni
tibet	tibet
spectateurs	spettatori
stars	stars
versant	versante
parfaitement	perfettamente
âgé	anziano
favorable	favorevole
baroque	barocco
secteurs	settori
will	will
tournois	tornei
gagné	vinto
retirer	rimuovi
accueillir	accogliere
distinction	distinzione
xviiie	xviii
den	den
four	forno
garder	mantenere
venezuela	venezuela
your	your
triple	triplo
eure	eure
vécu	vissuto
high	high
autel	altare
continuer	continuare
fournir	fornire
propriétaires	proprietari
efforts	sforzi
créés	creati
roussillon	roussillon
influencé	influenzato
treize	tredici
démographique	demografico
exclusivement	esclusivamente
plat	piatto
azur	azur
reconstruction	ricostruzione
columbia	columbia
bons	bravi
choisir	scegliere
administrateurs	amministratori
rarement	raramente
spécialisée	specializzata
global	global
bruce	bruce
consensus	consenso
troupe	truppa
sauvage	selvaggio
consulté	consultato
clip	clip
optique	ottica
fantastique	fantastica
fantastique	fantastico
occidental	occidentale
navigation	navigazione
augmenter	aumentare
instant	instant
synthèse	sintesi
pourraient	potrebbero
voyages	viaggi
phare	faro
surveillance	sorveglianza
initial	iniziale
story	story
déplacement	spostamento
différente	differente
différente	diversa
championship	championship
francophones	francofoni
prieuré	priorato
revenus	reddito
désert	deserto
mourut	morì
musiques	musiche
naturels	naturali
ibn	ibn
nam	nam
enseignant	insegnante
signes	segni
bourse	borsa
pedro	pedro
dépôt	deposito
exactement	esattamente
hollywood	hollywood
tunis	tunisi
presses	presse
prusse	prussia
théologie	teologia
laura	laura
intérieure	interiore
sun	sun
augustin	augustin
peint	dipinto
froid	freddo
réputation	reputazione
not	not
syrie	siria
flandre	fiandre
villeneuve	villeneuve
fréquemment	frequentemente
alexis	alexis
lublin	lublino
playstation	playstation
allen	allen
colonies	colonie
responsables	responsabili
riches	ricchi
pékin	pechino
academy	academy
apparence	aspetto
retrouvé	ritrovato
couche	strato
fortune	fortuna
changé	cambiato
châteaux	castelli
animateur	animatore
master	master
mathématicien	matematico
autonomie	autonomia
expansion	espansione
partielle	parziale
dragons	draghi
réalisés	realizzati
numéros	numeri
besançon	besançon
communal	comunale
malheureusement	purtroppo
provisoire	provvisorio
veuve	vedova
nicole	nicole
programmation	programmazione
cameroun	camerun
linguistique	linguistica
cesse	cessa
exercice	esercitazione
héritier	erede
lah	lah
bot	bot
fonctionne	funziona
botanique	botanica
amoureux	innamorato
amélioration	miglioramento
manchester	manchester
reçut	ricevette
vivent	vivono
spécifiques	specifiche
vouloir	volere
virus	virus
iso	iso
fermeture	chiusura
poursuivre	perseguire
poursuivre	proseguire
voile	vela
aisne	aisne
monarchie	monarchia
spécialisé	specializzato
soutenu	sostenuto
soutenu	supportato
décisions	decisioni
remarquable	notevole
yougoslavie	jugoslavia
universelle	universale
hugues	ugo
zurich	zurigo
assassinat	assassinio
restaurant	ristorante
first	first
abandonné	abbandonato
wilhelm	wilhelm
franche	franca
tribu	tribù
hebdomadaire	settimanale
belges	belgi
rotation	rotazione
composés	composti
attitude	atteggiamento
transféré	trasferito
jugement	giudizio
bible	bibbia
cyrillique	cirillico
clark	clark
rayon	raggio
paulo	paulo
présentes	presenti
civils	civili
nécessité	necessità
limoges	limoges
têtes	teste
métal	metallo
space	space
vocation	vocazione
facteur	fattore
matches	partite
rangers	rangers
ryan	ryan
fini	finito
road	road
spatiale	spaziale
épée	spada
appartenait	apparteneva
courts	corti
toulon	tolone
pic	picco
pic	pic
voisins	vicini
inconnue	sconosciuta
fantasy	fantasy
devoir	dovere
opposé	opposto
bleue	blu
irak	iraq
bruges	bruges
progrès	progresso
métiers	mestieri
soixante	sessanta
tonnes	tonnellate
poche	tasca
dieux	divinità
producteurs	produttori
copie	copia
intégré	integrato
jason	jason
surnommé	soprannominato
chimique	chimica
carbone	carbonio
modifié	modificato
mâle	maschio
ouvrir	apri
pétrole	petrolio
normal	normale
illinois	illinois
jura	giura
attaché	addetto
quarts	quarti
confirme	conferma
corporation	corporation
gras	grassetto
hervé	hervé
médiévale	medievale
cible	bersaglio
cible	obiettivo
africaine	africana
extra	extra
dark	dark
morceau	pezzo
tenter	tentare
dixième	decimo
dixième	decima
pyramide	piramide
pasteur	pastore
nintendo	nintendo
apprentissage	apprendimento
adopté	adottato
entraînement	allenamento
kelly	kelly
arnaud	arnaud
volontaires	volontari
filiale	filiale
plaisir	piacere
limousin	limousin
organiser	organizzare
lisa	lisa
soutient	sostiene
individuel	individuale
anime	anime
croire	credere
domination	dominazione
débats	discussioni
moto	motocicletta
moto	moto
tunnel	tunnel
fenêtres	finestre
mineur	minore
vertical	verticale
équilibre	equilibrio
empêche	impedisce
variable	variabile
sanctuaire	santuario
illustrations	illustrazioni
erreurs	errori
bis	bis
slovaquie	slovacchia
statistique	statistica
paramètre	parametro
psychologie	psicologi
constantinople	costantinopoli
fouilles	scavi
diplômé	laureato
sel	sale
princes	principi
découvertes	scoperte
examen	recensione
héritage	eredità
recours	ricorsi
hitler	hitler
commencer	iniziare
lancée	lanciata
madagascar	madagascar
combattants	combattenti
candidature	candidatura
théorème	teorema
darkgrey	darkgrey
tracé	tracciato
expériences	esperienze
concurrence	concorrenza
étudié	studiato
jeff	jeff
massacre	massacro
potentiel	potenziale
annuel	annuale
représenter	rappresentare
fortes	forti
dialogue	dialogo
annuelle	annuale
thérèse	teresa
grotte	grotta
pain	pane
décident	decidono
toit	tetto
opus	opus
entraineur	allenatore
suivie	seguita
individu	individuo
russell	russell
death	death
dits	detti
réduction	riduzione
alberto	alberto
tension	tensione
chaînes	catene
soviétiques	sovietici
soumis	sottomesso
secrets	segreti
intégration	integrazione
wimbledon	wimbledon
rythme	ritmo
intervient	interviene
voulait	voleva
écart	divario
montré	mostrato
rupture	rottura
vague	onda
das	das
signal	segnale
poitiers	poitiers
commença	cominciò
steven	steven
suicide	suicidio
accords	accordi
margaret	margaret
refus	rifiuto
périodes	periodi
ter	ter
mentionné	menzionato
hollande	olanda
box	box
indiquer	indicare
song	song
crédit	accreditamento
crédit	credito
xvi	xvi
librairie	libreria
audio	audio
vosges	vosgi
fuite	fuga
dôme	duomo
associée	associata
reproduction	riproduzione
christianisme	cristianesimo
parcs	parchi
entendu	sentito
signifiant	significante
dispositif	dispositivo
pouvaient	potevano
habitant	abitante
acier	acciaio
réélu	rieletto
traditions	tradizioni
formant	formando
générique	generico
civilisation	civiltà
occuper	occupare
silence	silenzio
admis	ammessi
verts	verdi
détruite	distrutta
isère	isère
raoul	raoul
publier	pubblicare
arguments	argomenti
contribue	contribuisce
lait	latte
matt	matt
antenne	antenna
charbon	carbone
léopold	leopold
maxi	maxi
archéologie	archeologia
agir	agire
financement	finanziamento
uefa	uefa
soutenir	sostenere
traducteur	traduttore
ambassade	ambasciata
miami	miami
propositions	proposte
men	men
dur	duro
dénomination	denominazione
constante	costante
inclus	incluso
two	two
fruit	frutta
montant	importo
jouent	giocano
journalistes	giornalisti
légère	leggera
miguel	miguel
marbre	marmo
agissait	agiva
sicile	sicilia
clients	clienti
souvenirs	ricordi
bad	bad
insectes	insetti
prisonnier	prigioniero
edmond	edmond
interdiction	divieto
montrent	mostrano
transition	transizione
durable	sostenibile
mar	mar
intelligence	intelligenza
précédents	precedenti
photographies	fotografie
payer	pagare
formée	formata
libéré	liberato
chaleur	calore
catalogne	catalogna
blog	blog
square	square
ingénieurs	ingegneri
indonésie	indonesia
chaussée	carreggiata
retrouvent	ritrovano
variétés	varietà
urgence	emergenza
passent	passano
lambert	lambert
liquide	liquido
capacités	capacità
gary	gary
officiels	ufficiali
présidents	presidenti
femelle	femmina
power	power
écliptique	eclittica
beauté	bellezza
indépendants	indipendenti
achat	acquisto
marques	marchi
boulogne	boulogne
réponses	risposte
admin	admin
gallo	gallo
solutions	soluzioni
inauguré	inaugurato
gaulle	gaulle
rev	rev
apparaître	apparire
rencontrent	incontrano
traiter	trattare
graves	graves
cuba	cuba
testament	testamento
attaquer	attaccare
contribuer	contribuire
seize	sedici
old	old
great	great
décoration	decorazione
fermé	chiuso
développée	sviluppata
times	times
voient	vedono
alphabet	alfabeto
jordan	jordan
supplémentaire	supplementare
schéma	schema
contribué	contribuito
campus	campus
représentée	rappresentata
pie	pie
vues	visualizzazioni
resté	rimasto
solide	solido
philip	philip
fiat	fiat
charges	carichi
bureaux	uffici
atmosphère	atmosfera
réelle	reale
ajout	aggiunta
réception	ricezione
dave	dave
retire	ritira
nelson	nelson
témoin	testimone
conte	conte
règlement	regolamento
shorts	shorts
horreur	orrore
manifeste	manifesto
pirates	pirati
fenêtre	finestra
occident	occidente
reich	reich
assaut	assalto
délégation	delegazione
acquisition	acquisizione
inclut	include
défini	definito
clés	chiavi
certainement	sicuramente
system	system
morale	morale
préfère	preferisce
nobel	nobel
adultes	adulti
spectacles	spettacoli
emblème	emblema
alternative	alternativa
littéralement	letteralmente
trace	traccia
trace	trace
ours	orso
portraits	ritratti
wild	wild
limité	limitato
chevaliers	cavalieri
loir	loir
récits	racconti
pauvres	poveri
refuge	rifugio
nourriture	cibo
nourriture	alimento
participant	partecipante
facteurs	fattori
devaient	dovevano
balle	palla
dynamique	dinamica
partenaire	partner
ross	ross
boris	boris
branches	rami
démission	dimissioni
aragon	aragona
batailles	battaglie
assassiné	assassinato
alpin	alpino
illustré	illustrato
colin	colin
management	management
consulter	consultare
zéro	zero
atp	atp
gironde	gironda
intéressant	interessante
remix	remix
départementales	dipartimentali
identique	identico
clôture	recinzione
cheveux	capelli
fournit	fornisce
traités	trattati
respecter	rispettare
apparemment	apparentemente
bbc	bbc
trio	trio
communistes	comunisti
lourd	pesante
sérieux	serietà
obligatoire	obbligatorio
dordogne	dordogna
fermée	chiusa
moore	moore
reconnue	riconosciuta
explosion	esplosione
honoré	onorato
exerce	esercita
augmente	aumenta
existait	esisteva
esclaves	schiavi
nathalie	nathalie
quentin	quentin
désir	desiderio
grégoire	gregorio
sec	asciutto
divisé	diviso
comtesse	contessa
paysans	contadini
complexes	complessi
noyau	kernel
noyau	nucleo
germanique	germanica
mené	condotto
flux	flusso
courants	correnti
sportifs	sportivi
forts	forti
ohio	ohio
motifs	motivi
lisbonne	lisbona
fleur	fiore
dizaines	decine
turc	turco
charentes	charentes
réserves	riserve
tirer	sparare
navarre	navarra
hambourg	amburgo
envoyer	invia
morgan	morgan
définir	imposta
définir	definire
micro	microfono
oriental	orientale
maría	maría
wilaya	provincia
géant	gigante
consul	console
lourdes	lourdes
logiciels	software
paradis	paradiso
relégué	relegato
ian	ian
anjou	anjou
tempête	tempesta
remettre	rimettere
abréviations	abbreviazioni
constantin	costantino
embouchure	bocchino
bonheur	felicità
moine	monaco
arm	arm
négociations	negoziati
oliver	oliver
bâle	basilea
congrégation	congregazione
conclusion	conclusione
nîmes	nîmes
franck	franck
stockholm	stoccolma
accent	accento
efficacité	efficienza
cuivre	rame
concile	concilio
cents	centesimi
ferrari	ferrari
apostolique	apostolica
viande	carne
indiqué	indicato
indiqué	indicata
communications	comunicazioni
week	week
romancier	romanziere
probable	probabile
ken	ken
escalier	scala
diable	diavolo
argentin	argentino
récupérer	recuperare
herbert	herbert
berne	berna
roberto	roberto
chante	canta
jerry	jerry
talent	talento
invités	ospiti
town	town
natation	nuoto
apprendre	imparare
sols	pavimenti
détruire	distruggere
ardenne	ardenne
castille	castiglia
client	cliente
syndrome	sindrome
book	book
prêtres	sacerdoti
alcool	alcool
alcool	alcol
elena	elena
passages	passaggi
centaine	centinaio
inspiration	ispirazione
retiré	ritirato
sombre	buio
lourds	pesante
habituellement	solitamente
vainqueurs	vincitori
nécessite	richiede
coordonnées	coordinate
dead	dead
allait	andava
racine	radice
fidèle	fedele
lecteurs	lettori
illustration	illustrazione
intégrer	integrare
écologie	ecologia
spécialistes	specialisti
ajouté	aggiunto
pseudo	pseudo
accompagne	accompagna
variations	variazioni
descente	discesa
remplacée	sostituita
épousa	sposò
magasin	negozio
landes	landes
punk	punk
sucre	zucchero
manifestation	manifestazione
installée	installato
installée	installata
gold	gold
cite	cita
symphonie	sinfonia
vêtements	abbigliamento
dance	dance
adulte	adulti
paroissiale	parrocchiale
explication	spiegazione
différences	differenze
biographique	biografico
vendus	venduti
trad	trad
considérer	considerare
variante	variante
redirection	reindirizzamento
tomber	cadere
roches	rocce
stone	stone
entité	entità
bottom	bottom
duchesse	duchessa
play	play
abraham	abraham
couvert	coperto
précédemment	precedentemente
délégué	delegato
cahiers	quaderni
phases	fasi
tribus	tribù
vraie	vera
vraie	allineare
astronome	astronomo
graveur	masterizzatore
contemporains	contemporanei
wikimedia	wikimedia
battant	battente
carter	carter
francfort	francoforte
flèche	freccia
#ffffff	#ffffff
circonscriptions	circoscrizioni
experts	esperti
attentat	attentato
arles	arles
colorado	colorado
feuille	foglia
difficiles	difficili
coupes	tagli
douce	dolce
remarquables	notevoli
contraint	costretto
dep	dep
michigan	michigan
descendants	discendenti
khan	khan
indre	indre
finlandais	finlandese
intervenir	intervenire
case	casella
enfer	inferno
districts	distretti
inutile	inutile
déchets	rifiuti
comique	comico
bell	bell
bénéficie	beneficia
doté	dotato
manuscrits	manoscritti
atlanta	atlanta
essence	benzina
séminaire	seminario
provenance	provenienza
vancouver	vancouver
orthographe	ortografia
lucas	lucas
biologie	biologia
massachusetts	massachusetts
essayer	provare
marchés	mercati
last	last
cellule	cella
fou	pazzo
accepter	accettare
heinrich	heinrich
coréen	coreano
courage	coraggio
moulins	mulini
humour	umorismo
banques	banche
nommés	nominati
battre	battere
clavier	tastiera
norvégien	norvegese
cologne	colonia
positif	positivo
minnesota	minnesota
compléter	completare
plume	piuma
singles	singles
barry	barry
kansas	kansas
garros	garros
dissolution	dissoluzione
dissolution	scioglimento
grève	sciopero
marchandises	merci
fichiers	file
patrice	patrice
pratiquement	praticamente
disparue	scomparsa
quatorze	quattordici
visibles	visibile
arménie	armenia
norman	norman
tirant	tirando
allier	allier
xviie	xvii
leipzig	lipsia
dites	dite
possédait	possedeva
fernand	fernand
bonaparte	bonaparte
observations	osservazioni
rural	rurale
codes	codici
warner	warner
récente	recente
malade	malato
arena	arena
évaluer	valutare
voulu	desiderato
réduite	ridotta
perspective	prospettiva
edgar	edgar
doctrine	dottrina
walt	walt
militant	attivista
tourner	girare
impérial	imperiale
sultan	sultano
abandonne	abbandona
liban	libano
calédonie	caledonia
hermann	hermann
sociologie	sociologia
messages	messaggi
ballet	balletto
accusé	accusato
onu	onu
ernst	ernst
effort	sforzo
affecté	assegnato
stuart	stuart
implique	coinvolge
implique	implica
index	indice
veulent	vogliono
téléphone	telefono
documentation	documentazione
enregistre	registra
bouche	bocca
queen	queen
hiérarchie	gerarchia
lyonnais	lyonnais
blessure	ferita
équateur	ecuador
bourgeois	borghese
statues	statue
anneau	anello
chambres	camere
youtube	youtube
xii	xii
sporting	sporting
pire	peggiore
pire	peggio
terminus	capolinea
onde	onda
abc	abc
exposé	esposto
définie	definita
masque	maschera
combattre	combattere
ouvrier	operaio
gloire	gloria
ressemble	assomiglia
archive	archivio
protégé	protetto
monter	montare
fidèles	fedeli
causes	cause
papillon	farfalla
comparaison	confronto
panneaux	pannelli
préparer	preparare
vendée	vandea
illustre	illustre
automatiquement	automaticamente
accepté	accettato
mondiaux	mondiali
grant	grant
globe	globe
procureur	procuratore
ardennes	ardenne
atlas	atlas
caisse	cassa
génétique	genetica
ballon	pallone
choc	shock
gérer	gestire
romantique	romantico
philippines	filippine
islamique	islamico
entouré	circondato
anonyme	anonimo
applique	applica
assurance	assicurazione
audience	udienza
phil	phil
helsinki	helsinki
manager	manager
espère	spera
lawrence	lawrence
unesco	unesco
littoral	litorale
danny	danny
module	modulo
enterré	sepolto
bonus	bonus
théories	teorie
hot	hot
éliminatoires	playoff
restera	rimarrà
restera	resterà
disant	dicendo
uci	uci
diversité	diversità
rocher	roccia
garnison	guarnigione
résoudre	risolvere
résistant	resistente
islande	islanda
janeiro	janeiro
macédoine	macedonia
sculptures	sculture
investissement	investimento
absolument	assolutamente
incident	incidente
are	are
chêne	quercia
transformé	trasformato
adversaires	avversari
privés	privati
compagnon	compagno
chroniques	cronache
tue	ammazza
tue	uccidi
radical	radicale
partenariat	partenariato
stratégique	strategico
réfugiés	profughi
berger	pastore
cache	cache
égale	uguale
œufs	uova
tentatives	tentativi
particularité	particolarità
emma	emma
miles	miles
demandes	richieste
distinguer	distinguere
réalisées	realizzate
doublé	doppietta
boxe	inscatolamento
pair	pari
tarn	tarn
compagnons	compagni
challenge	challenge
adolphe	adolphe
serpent	serpente
jeudi	giovedì
livret	libretto
georg	georg
individuelle	individuale
parker	parker
tes	tes
isaac	isaac
invite	invita
anges	angeli
rencontrer	incontrare
étang	stagno
attente	attesa
virginia	virginia
restant	rimanente
symboles	simboli
vols	voli
murray	murray
racines	radici
houston	houston
accueilli	ospitato
équipé	attrezzato
parfait	perfetto
roumain	rumeno
affluents	affluenti
mali	mali
repos	riposo
gardes	guardie
gand	gand
évolué	evoluto
romane	romanica
vents	venti
rap	rap
circulaire	circolare
vive	viva
fribourg	friburgo
décennies	decenni
assistance	assistenza
family	family
uruguay	uruguay
esthétique	estetica
suzanne	suzanne
coloniale	coloniale
adams	adams
permanente	permanente
wayne	wayne
malte	malta
spider	spider
ahmed	ahmed
anton	anton
spéciaux	speciali
citation	citazione
loiret	loiret
républicains	repubblicani
indiens	indiani
appliquer	applicare
traditionnellement	tradizionalmente
tournant	svolta
gridcolor	gridcolor
tests	test
neutralité	neutralità
sépare	separa
bière	birra
arr	arr
faibles	deboli
chelem	slam
arnold	arnold
élue	eletta
destin	destino
angel	angel
précédentes	precedenti
archéologiques	archeologici
invention	invenzione
ottawa	ottawa
podium	podio
professeurs	insegnanti
what	what
occupée	occupata
occupée	occupato
confusion	confusione
paroisses	parrocchie
clergé	clero
mosquée	moschea
personnellement	personalmente
étrange	strano
crimes	crimini
éteint	spento
autrichienne	austriaca
nobles	nobili
exprimer	esprimere
vendre	vendere
maintenance	manutenzione
vicomte	visconte
session	sessione
marshall	marshall
sorbonne	sorbona
lang	lang
vallées	valli
indienne	indiana
inc	inc
just	just
passa	passò
project	project
suites	suites
alentours	dintorni
inauguration	inaugurazione
contrôler	controllare
chœurs	cori
colons	coloni
japan	japan
ferrand	ferrand
brésilienne	brasiliana
arsenal	arsenale
arsenal	arsenal
adrien	adrien
larry	larry
récentes	recenti
armement	armamenti
exprime	esprime
off	off
mayenne	mayenne
marion	marion
robe	vestito
golf	golf
baker	baker
normalement	normalmente
jay	jay
mystère	mistero
stewart	stewart
phénomènes	fenomeni
sint	sint
similaires	simili
sage	saggio
béton	calcestruzzo
lions	lions
idéal	ideale
lionel	lionel
good	good
particules	particelle
écurie	scuderia
baby	baby
soprano	soprano
kennedy	kennedy
harris	harris
shakespeare	shakespeare
masters	masters
refusé	negato
refusé	rifiutato
coureurs	corridori
extraits	estratti
rencontré	incontrato
cadet	cadetto
triomphe	trionfo
tribune	tribuna
reconnaît	riconosce
expose	espone
hip	hip
lightgrey	lightgrey
coule	scorre
down	down
pau	pau
mineurs	minorenni
mineurs	minori
commis	commesso
round	round
faciliter	facilitare
montrant	mostrando
immense	immenso
bobby	bobby
opposant	opponente
dangereux	pericoloso
utilité	utilità
fief	feudo
adoption	adozione
robinson	robinson
panneau	pannello
pomme	mela
inscriptions	iscrizioni
messieurs	signori
nil	nilo
rosa	rosa
bologne	bologna
seed	seed
justification	giustificazione
saga	saga
salvador	salvador
reconnaître	riconoscere
principauté	principato
volant	volante
textcolor	textcolor
créant	creando
dents	denti
may	may
algérien	algerino
tommy	tommy
richesse	ricchezza
ports	porti
terry	terry
mardi	martedì
sprint	sprint
infrastructures	infrastrutture
exploration	esplorazione
matthew	matthew
cerveau	cervello
voter	votare
diplomate	diplomatico
journées	giornate
sommets	vertici
dramaturge	drammaturgo
écologique	ecologico
écologique	ecologica
joan	joan
collaborateur	collaboratore
réside	risiede
profondément	profondamente
sentiment	sentimento
théodore	teodoro
architectes	architetti
transformer	trasformare
médical	medico
eurent	ebbero
publiées	pubblicate
habitude	abitudine
modeste	modesto
interface	interfaccia
fantôme	fantasma
animé	animato
ludwig	ludwig
dérivé	derivato
marcus	marcus
ottoman	ottomano
universal	universal
conservée	conservata
imaginaire	immaginario
microsoft	microsoft
lens	lens
bucarest	bucarest
passée	passata
inscrite	iscritta
interventions	interventi
témoignage	testimonianza
nage	nuoto
arizona	arizona
décrite	descritta
décrite	descritto
satellites	satelliti
mâles	maschi
circonstances	circostanze
chants	canti
chancelier	cancelliere
gratte	gratta
désignation	designazione
heart	heart
déclin	declino
thermique	termica
énorme	enorme
réformes	riforme
pôles	poli
partenaires	partner
tombeau	tomba
bruit	rumore
tchécoslovaquie	cecoslovacchia
devise	valuta
universel	universale
finir	finire
annie	annie
mercredi	mercoledì
limiter	limitare
sons	suoni
circuits	circuiti
mono	mono
clinique	clinica
pennsylvanie	pennsylvania
équation	equazione
tenté	tentato
gouvernements	governi
cirque	circo
dépit	dispetto
obtint	ottenne
eddie	eddie
progression	progressione
cooper	cooper
intégrée	integrato
intégrée	integrata
vichy	vichy
tendances	tendenze
dick	dick
remplaçant	sostituto
urbanisme	urbanistica
électeurs	elettori
simone	simone
thompson	thompson
variantes	varianti
aéronautique	aeronautica
rochelle	rochelle
aigle	aquila
namur	namur
suspension	sospensione
royaumes	regni
pen	pen
gravure	incisione
corriger	correggere
rangs	ranghi
flag	flag
prière	preghiera
dallas	dallas
admins	admins
nationalités	nazionalità
colonisation	colonizzazione
women	women
pablo	pablo
appeler	chiamare
religions	religioni
wars	wars
volontaire	volontario
lloyd	lloyd
chaud	caldo
year	year
fans	tifosi
aus	aus
adjectifs	aggettivi
socks	socks
attraction	attrazione
poètes	poeti
tri	ordinamento
abandonner	abbandonare
colère	rabbia
cruz	cruz
dépasse	supera
réactions	reazioni
symbolique	simbolico
attendant	aspettando
louvain	lovanio
transforme	trasforma
patricia	patricia
races	razze
way	way
renaud	renaud
naval	naval
león	león
armé	armato
graham	graham
digital	digital
sensible	sensibile
compositions	composizioni
walker	walker
vertu	virtù
rhénanie	renania
atteinte	raggiunta
divisée	divisa
rassemblement	raduno
messe	messa
french	french
jugé	giudicato
jennifer	jennifer
obligation	obbligazione
obligation	obbligo
considérable	considerevole
franklin	franklin
palestine	palestina
chiens	cani
species	species
rédigé	scritto
foule	folla
bryan	bryan
registre	registro
extraction	estrazione
berry	berry
froide	fredda
kurt	kurt
eva	eva
préciser	precisare
mécanisme	meccanismo
angoulême	angoulême
ensembles	insiemi
mentionne	menziona
séville	siviglia
ébauche	bozza
geneviève	genevieve
bulgare	bulgaro
ordonnance	ordinanza
morbihan	morbihan
soul	soul
avancée	avanzata
alpha	alfa
abus	abuso
tube	tubo
miroir	specchio
acheter	comprare
actuelles	attuali
sélectionneur	selezionatore
lumières	luci
alberta	alberta
observer	osservare
rick	rick
primaires	primarie
hongroise	ungherese
descendant	discendente
magie	magia
fromage	formaggio
exécuté	eseguito
exécuté	giustiziato
indiana	indiana
estimé	stimato
dut	dovette
conjoint	coniuge
turque	turco
chaire	cattedra
chaire	pulpito
trinité	trinità
traduire	traduci
traduire	tradurre
identifier	identificare
éditeurs	editori
protocole	protocollo
tirage	tiratura
éthiopie	etiopia
galaxie	galassia
construites	costruite
blessures	lesioni
blessures	ferite
jacqueline	jacqueline
batteur	batterista
roues	ruote
stefan	stefan
allan	allan
harold	harold
vidéos	video
pauvre	povero
pauvre	povera
confirmé	confermato
enseignants	insegnanti
émis	emesso
copenhague	copenaghen
rayonnement	radiazione
ordinaire	ordinario
gênes	genova
sky	sky
originales	originali
sergent	sergente
yyy	yyy
retard	ritardo
maxime	maxime
cleveland	cleveland
suédoise	svedese
rebelles	ribelli
biologique	biologico
inventeur	inventore
bank	bank
chars	carri
sea	sea
hérault	hérault
couches	pannolini
renforcer	rinforzare
renforcer	rafforzare
manches	manica
profonde	profonda
profonde	profondo
brabant	brabante
bach	bach
coin	angolo
conventions	convenzioni
rénovation	rinnovamento
débutant	principiante
débutant	principianti
identification	identificazione
typique	tipico
kate	kate
collines	collina
molière	molière
arcade	arcade
delta	delta
rafael	rafael
collective	collettiva
pakistan	pakistan
yvelines	yvelines
bloquer	blocco
sant	sant
socialistes	socialisti
kosovo	kosovo
nordique	nordico
preuves	prove
afghanistan	afghanistan
ncaa	ncaa
people	people
helen	helen
arrêts	sentenze
aimé	amato
projection	proiezione
arbitres	arbitri
popularité	popolarità
han	han
organisées	organizzate
synagogue	sinagoga
simpson	simpson
calvados	calvados
campbell	campbell
verdun	verdun
courbe	curva
pan	pan
domine	domina
mercure	mercurio
installés	installati
plomb	piombo
synonyme	sinonimo
gymnastique	ginnastica
envie	invidia
light	light
troyes	troyes
polo	polo
prononcé	pronunciato
constellation	costellazione
annales	annali
diane	diane
firent	fecero
déplacer	sposta
mitchell	mitchell
ngc	ngc
gagnant	vincitore
armoiries	stemma
qualifications	qualifiche
apparu	apparso
commandes	comandi
mickey	topolino
légendes	leggende
africains	africani
mercedes	mercedes
bâton	bastone
cartons	cartoni
raphaël	raffaello
kiev	kiev
sac	borsa
flûte	flauto
arabie	arabia
plaques	piastre
dispositions	disposizioni
cratère	cratere
johannes	johannes
annexe	allegato
hard	hard
feat	feat
ralph	ralph
leo	leo
games	games
traction	trazione
géologie	geologia
parlé	parlato
cnrs	cnrs
army	army
harvard	harvard
bowl	bowl
remportant	vincendo
chasseur	cacciatore
légers	leggeri
vend	vende
java	java
sénateurs	senatori
signer	firmare
trou	buca
trou	buco
courrier	posta
permanent	permanente
put	put
lorient	lorient
matériau	materiale
neil	neil
ron	ron
sondage	sondaggio
moon	moon
inspire	inspire
tunisien	tunisino
hameaux	frazioni
diriger	dirigere
lutter	lottare
constitutionnel	costituzionale
pure	pura
rapides	rapidi
organisés	organizzati
pourcentage	percentuale
exprimés	espressi
carrefour	carrefour
traditionnels	tradizionale
evans	evans
alexandrie	alessandria
prête	pronta
patients	pazienti
culminant	culminante
susan	susan
garcía	garcía
dublin	dublino
harvey	harvey
justin	justin
dunkerque	dunkerque
couramment	comunemente
patient	paziente
approximativement	approssimativamente
missouri	missouri
référendum	referendum
roses	roses
pèlerinage	pellegrinaggio
robot	robot
sony	sony
turcs	turchi
calcaire	calcare
posé	posato
stockage	stoccaggio
réservé	riservato
interprétée	interpretato
interprétée	interpretata
traductions	traduzioni
url	url
atlantiques	atlantiche
wright	wright
jon	jon
río	río
brut	lordo
brut	greggio
pur	puro
nœuds	nodi
triangle	triangolo
pittsburgh	pittsburgh
défend	difende
adopte	adotta
propagande	propaganda
permit	permise
convaincre	convincere
témoins	testimoni
sánchez	sánchez
thaïlande	thailandia
soin	cura
militants	militanti
militants	attivisti
contacter	contattare
flamand	fiammingo
hier	ieri
recettes	ricette
quatuor	quartetto
créées	create
mexicain	messicano
agnès	agnese
act	act
oublier	dimenticare
conversion	conversione
folie	follia
caire	cairo
orne	orne
dauphin	delfino
titré	titolato
martina	martina
évoluer	evolversi
femelles	femmine
prototype	prototipo
dom	dom
magasins	negozi
athlètes	atleti
comédien	comico
traditionnelles	tradizionali
botaniste	botanico
assuré	assicurato
impulsion	impulso
stuttgart	stoccarda
luke	luke
températures	temperature
dépression	depressione
jorge	jorge
dean	dean
liverpool	liverpool
générations	generazione
générations	generazioni
séquence	sequenza
polytechnique	politecnico
oct	ott
marge	margine
vatican	vaticano
renommage	rinomina
woman	woman
apparitions	apparizioni
bombe	bomba
croate	croato
rachel	rachel
shanghai	shanghai
constant	costante
byzantin	bizantino
conduire	guidare
capture	cattura
cadres	cornici
disparaît	scompare
magique	magico
timbres	francobolli
déesse	dea
lituanie	lituania
valenciennes	valenciennes
chapitres	capitoli
paragraphe	paragrafo
adn	dna
bec	becco
égal	uguale
für	für
joués	giocati
situations	situazioni
perdue	persa
géométrie	geometria
sexuelle	sessuale
gard	gard
nathan	nathan
wallon	vallone
editions	edizioni
semblable	simile
forfait	pacchetto
finistère	finistère
possibilités	possibilità
décennie	decennio
beaumont	beaumont
austin	austin
influences	influenze
fausse	falsa
century	century
enquêtes	indagini
like	like
gendarmerie	gendarmeria
estonie	estonia
suggère	suggerisce
chypre	cipro
explorateur	esploratore
jun	jun
dell	dell
over	over
surfaces	superfici
sentiments	sentimenti
qualifiés	qualificati
canal+	canal+
adoptée	adottata
obligé	obbligato
brouillon	bozza
réalisations	realizzazioni
kings	kings
puissante	potente
astronomie	astronomia
tombé	caduto
escadron	squadrone
immatriculation	immatricolazione
juridiction	giurisdizione
terminer	terminare
claviers	tastiere
conclut	conclude
engagés	impegnati
mandats	mandati
sarthe	sarthe
istanbul	istanbul
témoignages	testimonianze
laurence	laurence
élimination	eliminazione
consacrer	dedicare
łódź	łódź
aviron	canottaggio
timbre	francobollo
baptisé	battezzato
mons	mons
théorique	teorica
théorique	teorico
sean	sean
dégâts	danni
wolf	wolf
doublage	doppiaggio
secrète	segreta
louisiane	louisiana
absolue	assoluto
médiéval	medievale
médiéval	medioevale
spécialité	specialità
intégrale	integrale
prime	prime
occupent	occupano
oracle	oracolo
age	età
melbourne	melbourne
polémique	polemica
sauvages	selvaggi
vivants	vivi
compréhension	comprensione
three	three
field	field
larges	larghi
bade	baden
catastrophe	catastrofe
catastrophe	disastro
démonstration	dimostrazione
réussite	successo
citoyen	cittadino
thriller	thriller
configuration	configurazione
bleus	azzurri
creuse	scava
greg	greg
nuits	notti
lincoln	lincoln
cavaliers	cavalieri
volcan	vulcano
kent	kent
parlant	parlando
grille	griglia
fernández	fernández
marvel	marvel
remarques	osservazioni
spirou	spirou
sofia	sofia
special	special
hébreu	ebraico
pat	pat
variables	variabili
vignoble	vigneto
roue	ruota
autorisé	autorizzato
cavalier	cavaliere
puissances	potenze
retenu	trattenuto
navigateur	navigatore
albin	albin
organes	organi
causer	causare
sylvain	sylvain
compétence	competenza
éliminer	eliminare
fonctionnaires	funzionari
caractérise	caratterizza
permettait	permetteva
démocrates	democratici
bords	bordi
directrice	direttrice
espérance	speranza
fragments	frammenti
seattle	seattle
existant	esistente
bond	bond
mulhouse	mulhouse
missiles	missili
ordonné	ordinato
certifié	certificato
chercheur	ricercatore
innovation	innovazione
combiné	combinata
combiné	combinato
ref	ref
amy	amy
turner	turner
ardèche	ardèche
alternatif	alternativo
écrites	scritte
fortifications	fortificazioni
forest	forest
constate	constata
burkina	burkina
évènement	evento
yonne	yonne
trentaine	trentina
chargés	caricati
girls	girls
assisté	assistito
effectifs	effettivi
devraient	dovrebbero
comprenait	capiva
comprenait	comprendeva
répression	repressione
blé	frumento
inaugurée	inaugurata
his	his
conrad	conrad
rousseau	rousseau
meyer	meyer
stable	stabile
correspondent	corrispondono
symphonique	sinfonica
ecclésiastique	ecclesiastica
fonctionnaire	funzionario
catholicisme	cattolicesimo
rayons	raggi
height	height
silva	silva
linéaire	lineare
commandé	ordinato
bretonne	bretone
brevet	brevetto
mémorial	memoriale
engagée	impegnata
propulsion	propulsione
mythe	mito
faso	faso
manger	mangiare
fire	fire
bouches	bocche
mohammed	mohammed
grey	grey
prochaine	prossimo
prochaine	prossima
léonard	léonard
léonard	leonardo
degrés	gradi
flammarion	flammarion
philosophique	filosofico
styles	stili
doubs	doubs
nazis	nazisti
guyane	guiana
rappeler	richiamare
esprits	spiriti
talk	talk
aude	aude
alexandra	alexandra
caméra	fotocamera
caméra	telecamera
andreas	andreas
legend	legend
régulier	regolare
contiennent	contengono
mix	mix
grandeur	grandezza
sound	sound
immigration	immigrazione
werner	werner
airlines	airlines
pollution	inquinamento
garcia	garcia
fayard	farinella
marocain	marocchino
filmographie	filmografia
attribuée	attribuito
attribuée	attribuita
hôte	ospitante
hôte	host
accède	accede
revers	rovescio
sergio	sergio
organe	organo
signification	significato
todd	todd
duel	duello
panama	panama
poétique	poetica
enregistrements	registrazioni
épaisseur	spessore
#aaaaaa	#aaaaaa
hunter	hunter
heureux	felice
alaska	alaska
entreprend	intraprende
august	august
law	law
bébé	bambina
entré	entrato
moments	momenti
illustrateur	illustratore
perse	persia
diesel	diesel
phoenix	phoenix
valley	valley
lópez	lópez
erik	erik
magic	magic
solidarité	solidarietà
peugeot	peugeot
remonter	risalire
détient	detiene
chapeau	cappello
vénus	venere
régiments	reggimenti
portait	indossava
ted	ted
uniforme	uniforme
serment	giuramento
comprise	compresa
libéraux	liberali
éliminé	eliminato
disciplines	discipline
déroulement	svolgimento
portugaise	portoghese
edition	edizione
supérieurs	superiori
scandale	scandalo
débarquement	sbarco
edit	edit
festivals	festival
jésuites	gesuiti
wta	wta
échoue	fallisce
isle	isle
sebastian	sebastian
ducs	duchi
tmax	tmax
alphabétique	alfabetico
juliette	giulietta
attribution	attribuzione
harmattan	harmattan
