protestants	protestanti
arrestation	arresto
daté	datato
cristal	cristallo
combinaison	combinazione
favoriser	favorire
taxe	tassa
radar	radar
jouée	giocata
malaisie	malesia
nominations	nomine
terminée	completata
nés	nati
repas	pasto
éthique	etica
hesse	hesse
arms	arms
halle	halle
supercoupe	supercoppa
luxe	lusso
estimée	stimato
estimée	stimata
maîtresse	padrona
lorenzo	lorenzo
rob	rob
casablanca	casablanca
dennis	dennis
traitant	trattando
mail	mail
qualifier	qualificare
compositeurs	compositori
artisans	artigiani
cat	cat
wood	wood
bourges	bourges
témoigne	testimonia
strictement	rigorosamente
tâches	compiti
trouvant	trovando
impératrice	imperatrice
ressort	molla
marquer	segna
chartres	chartres
décoré	decorato
humides	bagnate
léo	leo
hof	hof
condé	condé
contraintes	vincoli
détective	detective
cohen	cohen
conçue	progettata
sarkozy	sarkozy
pole	pole
wagner	wagner
devenus	diventati
mondes	mondi
wurtemberg	württemberg
salomon	salomone
barbe	barba
allié	alleato
prouver	dimostrare
proposant	proponente
dette	debito
auront	avranno
dream	dream
moyennes	medie
meurthe	meurthe
bibliothèques	biblioteche
cru	crudo
dessert	dessert
blake	blake
nationaliste	nazionalista
peuplée	popolata
expert	esperto
normand	normanno
lourde	pesante
holmes	holmes
faisaient	facevano
renard	volpe
esclavage	schiavitù
magnétique	magnetico
mississippi	mississippi
collègues	colleghi
ille	ille
attire	attira
graines	semi
rébellion	ribellione
républicaine	repubblicana
rtl	rtl
nova	nova
isolées	isolate
percussions	percussioni
fixé	fissato
tueur	assassino
envoyés	inviati
galeries	gallerie
apparente	apparente
parlent	parlano
provincial	provinciale
évident	ovvio
coûts	costi
auxerre	auxerre
libérer	liberare
munitions	munizioni
divine	divina
warren	warren
observe	osserva
bouddhisme	buddismo
fraction	frazione
présentés	presentati
aidé	aiutato
opera	opera
concepts	concetti
harmonie	armonia
magnus	magnus
révélé	rivelato
collins	collins
blocs	blocchi
voulant	volendo
acheté	comprato
acheté	acquistato
ouvertes	aperte
bolivie	bolivia
coupé	tagliato
#aaa	#aaa
législation	legislazione
localement	localmente
cerf	cervo
révolutionnaires	rivoluzionari
proportion	proporzione
palatinat	palatinato
noces	nozze
poméranie	pomerania
sylvie	sylvie
posthume	postumo
wolfgang	wolfgang
reçoivent	ricevono
câble	cavo
mers	mari
amoureuse	innamorata
lost	lost
johan	johan
cbs	cbs
reconstruit	ricostruito
canaux	canali
figaro	figaro
exercer	esercitare
brièvement	brevemente
irlandaise	irlandese
boucle	fibbia
produisent	producono
maçonnerie	muratura
chevet	capezzale
slovénie	slovenia
correctement	correttamente
piliers	pilastri
coordination	coordinazione
coordination	coordinamento
talents	talenti
diplomatique	diplomatico
doux	dolce
pères	padri
capables	capaci
partagé	condiviso
romaines	romane
achevé	completato
joint	guarnizione
syndicats	sindacati
immédiate	immediata
nigeria	nigeria
lou	lou
gaulois	gallo
émilie	emilia
convaincu	convinto
nacional	nacional
malades	malati
leonard	leonard
concession	concessione
hainaut	hainaut
inspirée	ispirata
dérive	deriva
eurovision	eurovision
naturaliste	naturalista
tort	torto
juges	giudici
hms	hms
avantages	vantaggi
prévention	prevenzione
keith	keith
dommages	danni
eglise	chiesa
organique	organico
vengeance	vendetta
bombardement	bombardamento
guadeloupe	guadalupa
violoncelle	violoncello
impliqué	coinvolto
ancêtre	antenato
memorial	memorial
stage	stage
chantiers	cantieri
bros	bros
demain	domani
nasa	nasa
mensuel	mensile
équipée	attrezzata
dakar	dakar
souveraineté	sovranità
profond	profondo
occitan	occitano
spécialisés	specializzati
continuité	continuità
intensité	intensità
protéines	proteine
récent	recente
accompagnée	accompagnata
hollandais	olandese
attentats	attentati
intéressé	interessato
décrire	descrivere
sauveur	salvatore
éclairage	illuminazione
betty	betty
haye	aia
rochefort	rochefort
assurée	assicurata
vernaculaire	vernacolare
martinique	martinica
esp	esp
mathématique	matematica
ita	ita
baccalauréat	maturità
gonzález	gonzález
wikidata	wikidata
dialogues	dialoghi
appliquée	applicata
atlético	atlético
mesurer	misurare
joachim	joachim
sèvres	sèvres
gallois	gallese
jupiter	giove
protestante	protestante
wwe	wwe
grace	grace
précipitations	precipitazioni
marianne	marianne
bohême	boemia
sidi	sidi
china	china
paire	coppia
console	console
santos	santos
tombes	tombe
adolf	adolf
récents	recenti
réservoir	serbatoio
approfondir	approfondire
transformée	trasformata
more	more
linda	linda
élevés	allevati
connaissent	conoscono
vocabulaire	vocabolario
missile	missile
appelait	chiamava
utiles	utili
glasgow	glasgow
écoute	ascolta
harrison	harrison
wallonie	vallonia
transept	transetto
représentés	rappresentati
anneaux	anelli
cyr	cyr
sentier	sentiero
chapiteaux	capitelli
richelieu	richelieu
get	get
croisade	crociata
boxeur	pugile
qualifiée	qualificata
fifa	fifa
was	was
finance	finanza
critère	criterio
inédit	inedito
stanislas	stanislas
tensions	tensioni
lucie	lucie
rica	rica
casse	rompe
bête	bestia
immobilier	immobiliare
impôts	imposte
brigitte	brigitte
fresques	affreschi
pattes	zampe
économiste	economista
adapter	adattare
disparaître	scomparire
verbe	verbo
bull	bull
reconstruite	ricostruita
adopter	adottare
craig	craig
évalué	valutato
saintes	sante
rond	rotondo
bnf	bnf
érigé	eretto
rudolf	rudolf
pokémon	pokémon
linux	linux
retable	pala
fabricant	produttore
fabricant	fabbricante
syntaxe	sintassi
celtique	celtica
singapour	singapore
michelle	michelle
joie	gioia
costume	costume
puissants	potenti
hymne	inno
douleur	dolore
restauré	restaurato
gay	gay
vitraux	vetrate
mannequin	manichino
mannequin	modella
intense	intensa
intense	intenso
appartiennent	appartengono
vegas	vegas
chimiste	chimico
flash	flash
pacte	patto
analyses	analisi
foire	fiera
renvoie	restituisce
excellence	eccellenza
plateforme	piattaforma
stock	stock
traversé	attraversato
fritz	fritz
corruption	corruzione
dépenses	spese
vampire	vampiro
consultation	consultazione
comtés	contee
platine	platino
perrin	perrin
remplacés	sostituiti
pin	pin
angelo	angelo
moreau	moreau
augmenté	aumentato
haïti	haiti
âgée	anziana
nécessairement	necessariamente
cécile	cécile
return	return
loge	camerino
tissu	tessuto
abside	abside
mets	mets
rire	ridere
rire	risate
créations	creazioni
coupable	colpevole
apport	conferimento
channel	channel
cylindres	cilindri
monténégro	montenegro
terreur	terrore
temporaire	temporaneo
verlag	verlag
wang	wang
brooklyn	brooklyn
ultra	ultra
fourni	fornito
sonde	sonda
baltimore	baltimora
télécommunications	telecomunicazioni
assurances	assicurazioni
vélo	bicicletta
cloche	campana
stabilité	stabilità
rabbin	rabbino
marketing	marketing
dotée	dotata
simultanément	simultaneamente
essonne	essonne
touché	toccato
nicholas	nicholas
globalement	globalmente
attirer	attirare
attirer	attrarre
exploitant	operatore
végétation	vegetazione
souffle	respiro
souffle	soffio
pol	pol
diagnostic	diagnosi
conservés	conservati
caraïbes	caraibi
sacrée	sacra
casino	casino
casino	casinò
musulman	musulmano
observé	osservato
serre	serra
architectural	architettonico
complot	complotto
voyant	veggente
appris	imparato
fan	fan
sara	sara
remarqué	notato
taïwan	taiwan
faces	facce
müller	müller
mammifères	mammiferi
potter	potter
doré	dorato
toscane	toscana
bain	bagno
rêves	sogni
chômage	disoccupazione
signaler	segnala
écrivit	scrisse
marina	marina
temples	templi
antilles	antille
survivants	sopravvissuti
étroite	stretta
métallique	metallico
xbox	xbox
occidentaux	occidentali
entourée	circondata
contacts	contatti
poudre	polvere
avertissement	avvertimento
continental	continental
occupant	occupante
travaillent	lavorano
prolongement	prolungamento
abandonnée	abbandonata
frederick	frederick
studies	studies
géré	gestito
ring	ring
théologien	teologo
algorithme	algoritmo
minuit	mezzanotte
buste	busto
humide	umido
catalan	catalano
modern	modern
contrats	contratti
censure	censura
chapelles	cappelle
parade	parata
bush	bush
marathon	maratona
solitaire	solitario
lombardie	lombardia
lazare	lazzaro
aveyron	aveyron
justifier	giustificare
baies	bacche
beauvais	beauvais
avr	avr
perpignan	perpignan
peste	peste
wallace	wallace
instructions	istruzioni
tiens	tieni
fonder	fondare
angles	angoli
aaron	aaron
soudan	sudan
regarder	guardare
tiennent	tengono
lama	lama
détenu	detenuto
murphy	murphy
purement	puramente
divorce	divorzio
cook	cook
arrêtés	arrestati
manhattan	manhattan
hardy	hardy
parme	parma
paiement	pagamento
imposant	imponente
fair	fair
systématique	sistematico
rémy	rémy
prochain	prossimo
morris	morris
fût	fusto
survie	sopravvivenza
collégiale	collegiale
hydrogène	idrogeno
provoquer	provocare
natural	natural
igor	igor
métaux	metalli
parrain	padrino
km²	km²
parent	genitore
révélation	rivelazione
hudson	hudson
avoue	confessa
fabrice	fabrice
gravité	gravità
valérie	valerie
belfort	belfort
pente	pendenza
multi	multi
adhésion	adesione
remparts	mura
kid	kid
apple	apple
karen	karen
drôme	drôme
nazi	nazista
moral	morale
narrateur	narratore
complément	complemento
futurs	futuri
traverser	attraversare
pacific	pacific
dons	donazioni
patrie	patria
malo	malo
sèche	secco
oxygène	ossigeno
molécules	molecole
signée	firmata
céramique	ceramica
uss	uss
judaïsme	giudaismo
pauvreté	povertà
sévère	severo
souligne	sottolinea
exemplaire	esemplare
wings	wings
enregistrer	salva
monstre	mostro
acides	acidi
séparés	separati
morales	morales
perry	perry
roubaix	roubaix
brève	breve
anthologie	antologia
positive	positivo
positive	positiva
substance	sostanza
geste	gesto
matrice	matrice
nfl	nfl
sardaigne	sardegna
escrime	scherma
perception	percezione
charleroi	charleroi
axes	assi
significations	significati
descendance	discendenza
mayer	mayer
appartenance	appartenenza
commonwealth	commonwealth
retenue	trattenuta
gregory	gregory
arménien	armeno
étymologie	etimologia
composants	componenti
rival	rivale
patriarche	patriarca
constituant	costituente
dominant	dominante
julian	julian
carburant	carburante
téléchargement	scaricamento
voler	volare
kilomètre	chilometro
dubois	dubois
identifié	identificato
vaucluse	vaucluse
honneurs	onori
capturé	catturato
jet	jet
enterrée	sepolta
riz	riso
constance	costanza
affichage	visualizza
guatemala	guatemala
extraordinaire	straordinario
chan	chan
postérité	posterità
doyen	preside
bridge	bridge
décédée	deceduta
créatures	creature
otan	nato
patinage	pattinaggio
indispensable	indispensabile
révision	revisione
const	const
préliminaire	preliminare
name	name
bulle	bolla
israélien	israeliano
modifiée	modificata
pensent	pensano
pete	pete
médicaments	farmaci
cricket	cricket
ancêtres	antenati
olga	olga
développés	sviluppati
touristes	turisti
réédité	ristampato
terrible	terribile
blood	blood
indépendantes	indipendenti
demandant	chiedendo
battle	battle
hilaire	hilaire
confondre	confondere
barrière	barriera
soie	seta
essayé	provato
acoustique	acustica
colonial	coloniale
marches	marche
marches	gradini
amicalement	amichevolmente
sécession	secessione
intellectuelle	intellettuale
aluminium	alluminio
composées	composte
piège	trappola
biélorussie	bielorussia
doc	doc
citations	citazioni
tubes	tubi
écho	eco
tragédie	tragedia
mozart	mozart
organiste	organista
excellent	eccellente
hart	hart
hôtels	alberghi
arras	arras
diminution	diminuzione
horizon	orizzonte
gorge	gola
librement	liberamente
silver	silver
pauline	pauline
offrant	offerente
chronologique	cronologico
indiquent	indicano
hugh	hugh
amphibiens	anfibi
durand	durand
océanie	oceania
kenya	kenya
pilier	pilastro
diamant	diamante
quinzaine	quindicina
drogue	droga
soutenue	sostenuta
derby	derby
libertés	libertà
magazines	riviste
tennessee	tennessee
chaos	chaos
chanter	cantare
abrégé	abbreviato
historiquement	storicamente
fusil	fucile
serbes	serbi
maintient	mantiene
marx	marx
couverte	coperta
reliques	reliquie
roberts	roberts
reprennent	riprendono
roumaine	rumeno
broadway	broadway
rotterdam	rotterdam
salaire	stipendio
rappeur	rapper
plaines	pianure
watson	watson
permettra	permetterà
permettra	consentirà
prêté	prestato
réels	reali
préféré	preferito
coast	coast
ingénierie	ingegneria
bayonne	bayonne
asiatiques	asiatiche
cède	cede
clara	clara
bataillons	battaglioni
pérez	pérez
ouverts	aperti
magistrat	magistrato
chanteurs	cantanti
admissible	ammissibile
ethnique	etnica
ethnique	etnico
haies	siepi
chambéry	chambéry
publia	pubblicò
vignes	vigneti
contrainte	vincolo
folk	folk
portails	portali
billets	biglietti
obtenue	ottenuta
proposent	propongono
antarctique	antartide
contenir	contenere
conducteur	conducente
étendu	esteso
interdite	vietato
how	how
sphère	sfera
lévy	lévy
libye	libia
chirurgie	chirurgia
oublié	dimenticato
résidences	residenze
grammaire	grammatica
yann	yann
mineure	minore
balles	palle
légendaire	leggendario
tigre	tigre
compromis	compromesso
horloge	orologio
middle	middle
séoul	seul
partager	condividere
pluriel	plurale
omar	omar
monica	monica
rey	rey
dépôts	depositi
josef	josef
michèle	michèle
relatifs	relativi
pommes	mele
vannes	valvole
haine	odio
motte	motte
poussée	spinta
picard	picard
set	set
lettonie	lettonia
alerte	allarme
fermes	fattorie
tunisienne	tunisina
copies	copie
restaurer	ripristina
annecy	annecy
edwards	edwards
raid	raid
english	english
distances	distanze
gardiens	guardiani
plafond	soffitto
plafond	massimale
piscine	piscina
minorité	minoranza
ronald	ronald
charité	carità
exceptionnelle	eccezionale
allée	vialetto
allée	vicolo
sienne	siena
emily	emily
explications	spiegazioni
abel	abel
cave	cantina
dessiné	disegnato
about	about
acquérir	acquisire
séparé	separato
graphe	grafo
enregistrée	registrata
enregistrée	registrato
archéologue	archeologo
passés	passati
recommandations	raccomandazioni
plainte	denuncia
ouvrière	operaia
hippolyte	hippolyte
activement	attivamente
doubles	doppi
idéologie	ideologia
summer	summer
cage	gabbia
préserver	preservare
banc	panchina
banc	banco
souverains	sovrani
copyright	copyright
gaule	gallia
martine	martina
indochine	indocina
garden	garden
ménages	famiglie
buffalo	buffalo
italiennes	italiane
juriste	giurista
enlever	rimuovi
démographie	demografia
sonate	sonata
asiatique	asiatico
joueuses	giocatrici
suffixe	suffisso
corde	corda
geoffroy	geoffroy
oklahoma	oklahoma
documentaires	documentari
sep	sep
pâte	pasta
xviii	xviii
organisateur	organizzatore
papa	papà
rames	remi
florent	florent
archidiocèse	arcidiocesi
imagine	immagina
ordinateurs	computer
tables	tavoli
bassiste	bassista
jessica	jessica
gang	gang
martial	martial
subir	subire
bouton	pulsante
toucher	toccare
now	now
aoste	aosta
combattant	combattente
tropicale	tropicale
fossiles	fossili
citadelle	cittadella
plastique	plastica
exister	esistere
décider	decidere
menaces	minacce
restée	rimasta
ventre	pancia
carrières	carriere
identiques	identici
vicaire	vicario
plages	spiagge
barrages	dighe
mayence	magonza
intérim	interim
entraîné	addestrato
brasserie	birreria
prestige	prestigio
châtillon	châtillon
missionnaire	missionario
rico	rico
vendue	venduta
protestant	protestante
spirituel	spirituale
priorité	priorità
constitutionnelle	costituzionale
rivalité	rivalità
valentin	valentino
problématique	problematica
church	church
précédé	preceduto
sex	sex
danseuse	ballerina
conforme	conforme
earth	earth
violent	violento
démon	demone
constructeurs	costruttori
arcades	portici
madonna	madonna
sourire	sorriso
carrés	quadrati
sommeil	sonno
digne	degno
perdus	persi
chirurgien	chirurgo
défi	sfida
rite	rito
consulat	consolato
schmidt	schmidt
indigènes	indigeni
cinéaste	regista
magnifique	bellissima
classic	classic
hôpitaux	ospedali
divinité	divinità
ukrainien	ucraino
confiée	affidata
amanda	amanda
afro	afro
tigers	tigers
démontrer	dimostrare
intellectuels	intellettuali
périodique	periodico
stevens	stevens
trilogie	trilogia
précieux	prezioso
indication	indicazione
danube	danubio
centenaire	centenario
croissant	mezzaluna
croissant	crescente
jul	jul
animée	animata
affluence	affluenza
amant	amante
caps	caps
légal	legale
incapable	incapace
prévenir	prevenire
batman	batman
tibétain	tibetano
carmen	carmen
jungle	giungla
condamnation	condanna
légitime	legittimo
let	let
biodiversité	biodiversità
lys	giglio
disparus	scomparsi
cou	collo
billboard	billboard
accidents	infortuni
blois	blois
kazakhstan	kazakistan
fonte	ghisa
spectre	spettro
ajoutant	aggiungendo
transcription	trascrizione
violoniste	violinista
achille	achille
édit	editto
tag	tag
profiter	godere
sandra	sandra
datée	datato
élémentaire	elementare
recrutement	reclutamento
rohan	rohan
procédures	procedure
présidé	presieduto
terminal	terminale
explorer	explorer
partition	partizione
couples	coppie
considérant	considerando
ana	ana
reconnus	riconosciuti
plastiques	plastica
violation	violazione
conservateurs	conservanti
television	television
entrent	entrano
rappel	promemoria
incarne	incarna
plats	piatti
neuchâtel	neuchâtel
cameron	cameron
miracle	miracolo
amédée	amedeo
gène	gene
cfa	cfa
deutsche	deutsche
anarchiste	anarchico
indo	indo
graphiques	grafica
charlemagne	charlemagne
monique	monique
parallèles	parallele
créature	creatura
accusations	accuse
apporté	portato
négatif	negativo
juger	giudicare
résidents	residenti
provoqué	provocato
opérateurs	operatori
martínez	martínez
albanie	albania
regiment	regiment
thé	tè
assister	assistere
armor	armor
unit	unit
enregistrés	registrati
connexion	connessione
briques	mattoni
créa	creò
opinions	opinioni
distribué	distribuito
tranche	fetta
brothers	brothers
partisan	sostenitore
dumas	dumas
coque	scafo
cloud	cloud
knight	knight
colloque	colloquio
suspendu	sospeso
felix	felix
under	under
exigences	requisiti
homonyme	omonimo
castro	castro
inventé	inventato
sidney	sidney
ténor	tenore
aveugle	cieco
espionnage	spionaggio
vies	vite
segment	segmento
roulant	rotabile
tabac	tabacco
scalemajor	scalemajor
palace	palace
libérale	liberale
timeaxis	timeaxis
étendre	estendere
side	side
monarque	monarca
réunions	riunioni
nbc	nbc
butler	butler
tissus	tessuti
suffisante	sufficiente
spencer	spencer
dépasser	superare
connecticut	connecticut
afficher	visualizza
dominante	dominante
entités	entità
sélectionnés	selezionati
pensez	pensi
pensez	pensate
hercule	ercole
forcé	forzato
forcé	costretto
zur	zur
solde	saldo
récolte	raccolto
gustav	gustav
attaqué	attaccato
oregon	oregon
apprécié	apprezzato
cape	mantello
diff	diff
procéder	procedere
fonctionner	funzionare
infos	info
monté	montato
artificielle	artificiale
jésuite	gesuita
then	then
voyageur	viaggiatore
traitements	trattamenti
leslie	leslie
serpents	serpenti
entourage	entourage
cuir	cuoio
reporter	reporter
imagesize	imagesize
utah	utah
carnaval	carnevale
connut	conobbe
library	library
condamnés	condannati
essayiste	saggista
cacher	nascondi
neuilly	neuilly
intrigue	intrigo
plotarea	plotarea
kentucky	kentucky
disent	dicono
schneider	schneider
ned	ned
probabilité	probabilità
académique	accademico
roll	roll
accusation	accusa
châssis	telaio
responsabilités	responsabilità
lyrique	lirica
gain	guadagno
laser	laser
composant	componente
sérieusement	seriamente
noté	annotato
sauvetage	salvataggio
existé	esistito
nina	nina
doigts	dita
détruits	distrutti
convoi	convoglio
atterrissage	atterraggio
blaise	blaise
encre	inchiostro
hills	hills
remplir	riempire
progressiste	progressista
invitation	invito
souffre	soffre
cercles	cerchi
arche	arca
collaborateurs	collaboratori
éventuelle	eventuale
viaduc	viadotto
comptent	contano
gravures	incisioni
demandent	chiedono
gratuit	libero
préférence	preferenza
composent	compone
composent	compongono
alabama	alabama
stan	stan
queensland	queensland
holstein	holstein
escalade	arrampicata
claudia	claudia
allusion	allusione
mécanismes	meccanismi
mathilde	matilde
oslo	oslo
bombardements	bombardamenti
rennais	rennais
ice	ice
suffisant	sufficiente
foncé	scuro
wendy	wendy
publishing	publishing
ricardo	ricardo
rhodes	rodi
caché	nascosto
klein	klein
oscars	oscar
mrc	mrc
renommer	rinominare
renommer	rinomina
cincinnati	cincinnati
ltd	ltd
cyril	cyril
judith	judith
cie	cie
carol	carol
promenade	passeggiata
rita	rita
dupont	dupont
avancer	avanzare
séparer	separare
massive	massive
visites	visite
atteignent	raggiungono
albanais	albanese
head	head
pub	pub
other	other
portland	portland
antérieure	anteriore
acceptée	accettata
prétexte	pretesto
julius	julius
mitterrand	mitterrand
sacrifice	sacrificio
socialisme	socialismo
difficilement	difficilmente
impasse	stallo
adrian	adrian
dialecte	dialetto
juventus	juventus
genèse	genesi
guerriers	guerrieri
réservée	riservata
recteur	rettore
sabre	sciabola
offert	offerto
loups	lupi
restaurée	restaurata
damien	damien
frise	frisia
itinéraire	itinerario
pertinence	pertinenza
complexité	complessità
zhang	zhang
rechercher	cerca
fondations	fondazioni
béatrice	beatrice
jonas	jonas
slalom	slalom
natal	natal
préside	presiede
antoinette	antonietta
prestigieux	prestigioso
hector	hector
bienvenue	benvenuto
bienvenue	benvenuti
exacte	esatta
shaw	shaw
accompagner	accompagnare
sortent	escono
incline	capovolge
pêcheurs	pescatori
villers	villers
vecteur	vettore
créent	creano
grange	fienile
break	break
choisis	scegli
éclate	scoppia
statuts	statuto
malcolm	malcolm
fonda	fonda
dommage	peccato
slovaque	slovacco
moldavie	moldavia
nationalistes	nazionalisti
armés	armati
script	script
accordé	concesso
détention	detenzione
ward	ward
bastia	bastia
matthieu	matteo
chaux	calce
crête	picco
textile	tessile
pionnier	pioniere
assise	assisi
wehrmacht	wehrmacht
sables	sabbie
mystique	mistica
when	when
zoo	zoo
proposés	proposti
lotus	lotus
fischer	fischer
innocent	innocente
parking	parcheggio
trek	trek
leclerc	leclerc
boule	sfera
fabriqué	fabbricato
comportements	comportamenti
emprisonné	imprigionato
leçons	lezioni
cardinaux	cardinali
gravement	gravemente
locomotives	locomotive
assises	assise
paraguay	paraguay
oran	oran
rodríguez	rodríguez
ruth	ruth
expressions	espressioni
tactique	tattica
balzac	balzac
originaux	originali
vera	vera
boeing	boeing
newton	newton
armstrong	armstrong
sauvé	salvato
récompensé	premiato
sauve	salva
alonso	alonso
phrases	frasi
jambes	gambe
cracovie	cracovia
dissoute	sciolta
transit	transito
sensibilité	sensibilità
épidémie	epidemia
atomique	atomico
atomique	atomica
oreille	orecchio
gil	gil
défenseurs	difensori
céréales	cereali
pts	pts
confirmer	confermare
diminuer	diminuire
castle	castle
intermédiaires	intermediari
obstacles	ostacoli
travées	campate
délégués	delegati
rabat	rabat
cherbourg	cherbourg
habsbourg	asburgo
conclu	concluso
équipés	attrezzati
sociologue	sociologo
ajoutent	aggiungono
voté	votato
chalon	chalon
offrent	offrono
anatomie	anatomia
voltaire	voltaire
rogers	rogers
occurrence	occorrenza
rubrique	rubrica
pcf	pcf
typiquement	tipicamente
cyclo	cyclo
vérification	verifica
renouvellement	rinnovo
corrèze	corrèze
plumes	piume
entra	entrò
entrepreneur	imprenditore
martín	martín
généalogie	genealogia
oricon	oricon
jung	jung
jamie	jamie
psychanalyse	psicoanalisi
manœuvre	manovra
winter	winter
pompiers	pompieri
vagues	onde
combien	quanto
népal	nepal
cérémonies	cerimonie
martyr	martire
assassin	assassino
conversation	conversazione
bactéries	batteri
désignée	designata
véronique	véronique
biographies	biografie
chuck	chuck
discographie	discografia
faillite	fallimento
kyoto	kyoto
invisible	invisibile
cambodge	cambogia
réacteur	reattore
départementaux	dipartimentali
standards	standard
bonsoir	buonasera
dossiers	cartelle
panthéon	pantheon
légumes	verdure
niger	niger
prose	prosa
vain	vano
caserne	caserma
anthropologie	antropologia
mexicaine	messicano
dupuis	dupuis
weber	weber
cédric	alessandro
intervalle	intervallo
quarantaine	quarantena
concurrents	concorrenti
symptômes	sintomi
estimations	stime
jackie	jackie
scope	scope
dissous	disciolto
réplique	replica
mètre	metro
staline	stalin
ban	ban
azerbaïdjan	azerbaigian
arcs	archi
tgv	tgv
walsh	walsh
anecdote	aneddoto
directeurs	direttori
cessé	cessato
canard	anatra
protégés	protetti
monstres	mostri
bits	bit
chirac	chirac
panorama	panorama
icône	icona
progressif	progressivo
garnier	garnier
size	size
osaka	osaka
oreilles	orecchie
patrouille	pattuglia
zagreb	zagabria
creek	creek
méditerranéen	mediterraneo
dauphiné	dauphiné
vaud	vaud
fusée	razzo
prieur	priore
grès	arenaria
notation	notazione
prairies	prati
bennett	bennett
permettrait	consentirebbe
permettrait	permetterebbe
rendement	resa
rendement	rendimento
reynolds	reynolds
obtiennent	ottengono
canvas	canvas
annexion	annessione
brad	brad
notions	nozioni
colmar	colmar
electric	electric
bassins	bacini
téléspectateurs	spettatori
leroy	leroy
athletic	athletic
amélie	amélie
évangile	vangelo
tapis	tappeto
solides	solidi
marius	marius
coach	allenatore
entiers	interi
pratiquer	praticare
wall	wall
exposée	esposta
cahier	quaderno
spécifiquement	specificamente
hélicoptère	elicottero
déplacé	spostato
attribuer	assegnare
saxophone	sassofono
drive	drive
willy	willy
avènement	avvento
marron	marrone
josh	josh
bombes	bombe
crédits	stanziamenti
crédits	crediti
battue	picchiata
heavy	heavy
avocats	avvocati
cia	cia
utc	utc
exécuter	esegui
illustrer	illustrare
constamment	costantemente
transporter	trasportare
glacier	ghiacciaio
prolongation	estensione
prolongation	proroga
époques	epoche
champignons	funghi
attractions	attrazioni
eduardo	eduardo
coton	cotone
artois	artois
insertion	inserimento
insertion	inserisci
extinction	estinzione
trous	fori
implication	coinvolgimento
consécutive	consecutiva
déplace	sposta
tyler	tyler
façades	facciate
portion	porzione
grains	chicchi
résistants	resistenti
sensibles	sensibili
birmingham	birmingham
primes	premi
beatles	beatles
lame	lama
kenneth	kenneth
ellen	ellen
herbe	erba
maximilien	massimiliano
manitoba	manitoba
fabien	fabien
dépendance	dipendenza
nassau	nassau
communiquer	comunicare
détachement	distacco
observateur	osservatore
substances	sostanze
bravo	bravissimi
curtis	curtis
contestation	contestazione
sibérie	siberia
investissements	investimenti
interaction	interazione
wisconsin	wisconsin
trophées	trofei
terrasse	terrazza
flandres	fiandre
herman	herman
maturité	maturità
damas	damasco
financer	finanziare
lima	lima
désaccord	disaccordo
infini	infinito
utc+	utc+
vivante	viva
unicode	unicode
répondu	risposto
boucher	macellaio
