del	du
che	qui
che	que
per	pour
con	avec
una	une
non	pas
dei	des
dell	dell
come	comme
come	comment
sono	sont
delle	des
dal	du
più	plus
anche	aussi
anche	même
seed	seed
all	all
due	deux
tra	entre
era	était
dopo	après
parte	partie
stato	etat
stato	état
altri	autres
bar	bars
bar	bar
anni	années
anni	ans
italiano	italien
essere	etre
essere	être
questo	ce
esterni	externes
collegamenti	liens
nell	nell
serie	série
serie	séries
questa	cette
film	films
film	film
città	ville
città	villes
solo	seul
solo	uniquement
solo	seulement
uno	un
loro	leur
loro	eux
primo	premier
nome	nom
alle	aux
poi	puis
secondo	deuxième
msg	msg
voce	voix
progetti	projets
dove	où
quando	lorsque
quando	quand
anno	année
durante	pendant
italia	italie
tre	trois
molto	beaucoup
from	from
può	peut
hanno	ont
comune	commune
comune	fréquent
tutti	tous
stagione	saison
gruppo	groupe
stati	états
contro	contre
calciatore	footballeur
roma	rome
così	ainsi
tempo	temps
abitanti	habitants
till	till
chiesa	église
chiesa	eglise
grande	grande
grande	grand
quindi	donc
secolo	siècle
guerra	guerre
sempre	toujours
fatto	fait
fontsize	fontsize
erano	étaient
storia	histoire
fine	fin
aveva	avait
album	album
album	albums
già	déjà
alcuni	certains
ancora	encore
senza	sans
francese	francais
francese	française
francese	français
seconda	deuxième
finale	finale
finale	final
vita	vie
titolo	titre
shift	shift
shift	maj
campionato	championnat
ogni	chaque
mondo	monde
furono	furent
tutto	tout
settembre	septembre
nazionale	national
nazionale	nationale
italiana	italienne
circa	environ
quanto	combien
altro	autre
sotto	dessous
sotto	sous
wikipedia	wikipédia
wikipedia	wikipedia
calcio	football
famiglia	famille
numero	nombre
numero	numéro
milano	milan
ottobre	octobre
maggio	mai
ruolo	rôle
gennaio	janvier
nuovo	nouveau
perché	pourquoi
generale	générale
generale	général
squadra	équipe
squadra	equipe
dicembre	décembre
caso	cas
sue	sue
giugno	juin
questi	ces
agosto	aout
agosto	août
luglio	juillet
politico	politicien
opera	opera
opera	opéra
fra	entre
verso	vers
aprile	avril
pagina	page
periodo	période
novembre	novembre
giovanni	jean
grazie	merci
insieme	ensemble
lui	lui
morte	mort
nuova	nouvelle
febbraio	février
john	john
new	new
centro	centre
inglese	anglais
quattro	quatre
interno	intérieur
interno	interne
attività	activité
attività	activités
alcune	certaines
tutte	toutes
causa	cause
edizione	edition
edizione	édition
qui	ici
nord	nord
diretto	directe
diretto	direct
esempio	exemple
ultimo	dernier
ultimo	dernière
versione	version
provincia	province
provincia	wilaya
attore	acteur
coppa	coupe
forma	forme
codice	code
base	base
trova	trouver
trova	trouve
trova	trouvez
poco	peu
punto	point
tuttavia	cependant
figlio	fils
allenatore	coach
allenatore	entraîneur
allenatore	entraineur
molti	nombreux
particolare	particulier
sistema	système
società	société
tipo	genre
tipo	type
maggiore	major
club	club
club	clubs
regione	région
sud	sud
discussione	discussion
padre	père
linea	ligne
santa	sainte
pubblicato	publiée
pubblicato	édité
pubblicato	publié
carlo	carlo
progetto	projet
primi	premiers
possono	peuvent
mai	jamais
sito	site
uso	utilisation
value	value
tedesco	allemand
grado	grade
grado	degré
uniti	unis
lavoro	travail
isbn	isbn
fare	faire
giorno	jour
principale	principale
principale	principal
termine	terme
spesso	souvent
regno	royaume
ben	ben
specie	espèces
specie	espèce
persone	gens
persone	personnes
pagine	pages
volte	fois
set	set
inizio	début
jpg	jpg
sarebbe	serait
episodio	épisode
episodio	episode
rispetto	respect
francesco	françois
francesco	francesco
posizione	emplacement
posizione	position
presidente	président
cosa	quoi
militare	militaire
uomo	homme
meno	moins
campo	champ
giorni	jours
carriera	carrière
mar	mar
scritto	ecrit
scritto	rédigé
scritto	écrit
ora	maintenant
territorio	territoire
gen	gen
gran	gran
antonio	antonio
giuseppe	joseph
diversi	différents
quasi	presque
data	date
terra	terre
presente	présent
presente	présente
soprattutto	surtout
allora	alors
successo	succès
successo	réussite
opere	œuvres
ordine	ordre
categoria	catégorie
epoca	époque
produzione	production
strada	route
corpo	corps
quest	quest
scrittore	ecrivain
scrittore	écrivain
lug	lug
file	fichier
file	fichiers
ultima	dernière
cura	soin
francia	france
lingua	langue
zona	zone
livello	niveau
battaglia	bataille
attrice	actrice
ott	ott
ott	oct
disciplina	discipline
momento	moment
mag	mag
oro	or
singolo	single
paese	pays
width	width
cantante	chanteur
cantante	chanteuse
arte	art
età	age
età	âge
storico	historien
vescovo	evêque
vescovo	évêque
york	york
squadre	équipes
squadre	equipes
precedente	précédente
precedente	précédent
episodi	episodes
episodi	épisodes
paolo	paul
possibile	possible
avere	avoir
servizio	service
regista	cinéaste
regista	réalisateur
punti	points
repubblica	république
governo	gouvernement
dato	donnée
originale	originale
originale	original
apr	apr
grandi	grands
grandi	grandes
palazzo	palais
giocatore	joueur
università	universités
università	université
isola	île
capo	chef
capo	patron
musica	musique
divisione	division
luogo	lieu
ago	aiguille
dic	déc
iii	iii
napoli	naples
ebbe	eut
parigi	paris
david	david
gioco	jeu
terzo	troisième
terzo	troisièmement
ufficiale	officielle
ufficiale	officiel
luigi	louis
vittoria	victoire
internazionale	international
internazionale	internationale
divenne	devint
porta	porte
sei	six
presenti	présentes
presenti	présents
popolazione	population
piano	plan
origine	origine
prodotto	produit
presenza	présence
presenza	presence
libro	livre
scuola	école
immagine	image
esercito	armée
linear	linear
deve	doit
autore	auteur
classifica	classement
personaggio	personnage
importante	importante
importante	important
torneo	tournoi
situato	situé
firenze	florence
comunità	communauté
giovane	jeune
madre	mère
avrebbe	aurait
vari	divers
pietro	pierre
studi	etudes
studi	études
acqua	eau
torino	turin
cinque	cinq
partito	parti
unità	unités
unità	unité
fonti	sources
marcatori	marqueurs
politica	politique
lei	elle
metà	moitié
metri	mètres
alto	haut
alto	élevé
top	top
vennero	vinrent
testo	texte
align	align
usa	usa
tour	tournée
dati	données
tutta	toute
teatro	théâtre
procedura	procédure
cardinale	cardinale
cardinale	cardinal
unico	unique
papa	pape
uomini	hommes
visto	visa
visto	vu
ricerca	recherche
principali	principales
principali	principaux
massimo	maximum
stile	style
left	left
germania	allemagne
donna	femme
superficie	superficie
superficie	surface
alta	haute
alta	alta
castello	château
distretto	daïra
distretto	powiat
distretto	district
nota	note
successivo	suivant
ritorno	retour
costruzione	construction
totale	totale
totale	total
canzone	chanson
vista	vista
vista	vue
detto	dit
attuale	actuel
attuale	actuelle
note	notes
varie	divers
varie	diverses
altezza	hauteur
chitarra	guitare
robert	robert
est	est
fiume	fleuve
fiume	rivière
realtà	réalité
realtà	réalités
fuori	dehors
for	for
monte	mont
contea	comté
museo	musée
protagonista	protagoniste
legge	loi
mario	mario
stadio	stade
fase	phase
classe	classe
amore	amour
michael	michael
fratello	frère
color	color
sviluppo	développement
prime	prime
pittore	peintre
sarà	sera
comuni	communes
pubblico	public
venezia	venise
media	moyenne
struttura	structure
gray	gray
personaggi	personnages
londra	londres
sopra	dessus
formazione	formation
marco	marco
marco	marc
world	world
you	you
probabilmente	probablement
sant	sant
bene	bien
britannico	britannique
romano	romain
romano	romano
utente	utilisateur
italiani	italiens
locale	locale
locale	local
james	james
video	vidéo
video	vidéos
giochi	jeux
disco	disque
conte	conte
conte	comte
giapponese	japonais
giapponese	japonaise
direttore	directeur
peso	poids
meglio	mieux
piccolo	petit
campionati	championnats
importanti	importantes
importanti	importants
von	von
occasione	occasion
programma	programme
barra	barre
nominato	nommé
nominato	nominé
testa	tête
romanzo	roman
forte	forte
forte	fort
forze	forces
william	william
impero	empire
diritto	droit
start	start
nazionali	nationaux
mare	mer
unione	union
star	star
piazza	place
potere	pouvoir
rgb	rvb
rgb	rgb
presenze	présences
senso	sens
rete	réseau
lato	côté
forza	force
superiore	supérieure
superiore	supérieur
breve	courte
breve	bref
breve	court
breve	brève
lavori	travaux
spagnolo	espagnol
van	van
fronte	front
ovest	ouest
andrea	andrea
andrea	andréa
nato	né
nato	otan
dipartimento	département
controllo	contrôle
winner	winner
don	don
passato	passé
caratteristiche	caractéristiques
edizioni	editions
edizioni	éditions
dire	dire
guida	guide
diocesi	diocèse
gridcolor	gridcolor
consiglio	conseil
villa	villa
lightgrey	lightgrey
mappa	cartes
mappa	plan
mappa	carte
membri	membres
pari	pair
pari	pairs
giorgio	georges
giorgio	george
problemi	problèmes
antica	antique
antica	ancienne
darkgrey	darkgrey
problema	problème
milioni	millions
mano	main
chiamato	appelé
migliore	meilleure
migliore	meilleur
parti	parties
giornalista	journaliste
mio	mon
esso	il
festival	festival
festival	festivals
civile	civil
civile	civile
evoluzione	évolution
valle	vallon
valle	vallée
luce	lumière
compositore	compositeur
sezione	section
ultimi	derniers
attualmente	actuellement
ore	heures
peter	peter
partite	matchs
partite	matches
dio	dieu
inizia	commence
sinistra	gauche
modello	modèle
istituto	institut
aeroporto	aéroport
velocità	vitesse
imperatore	empereur
movimento	mouvement
motore	moteur
femminile	féminin
vero	vrai
piccola	petite
nuovi	nouveaux
valore	valeur
gruppi	groupes
bologna	bologne
inizialmente	initialement
love	love
cultura	culture
spazio	espace
troppo	trop
alessandro	cédric
alessandro	alexandre
amico	ami
membro	membre
rock	rock
formato	format
vinto	remporté
vinto	gagné
lunghezza	longueur
situata	située
processo	processus
attacco	attaque
proprietà	propriété
proprietà	propriétés
partita	match
interpretato	interprété
interpretato	interprétée
spagna	espagne
morì	mourut
titoli	titres
http	http
colore	couleur
vicino	près
orientale	oriental
antico	antique
antico	ancien
località	localités
località	localité
man	man
principe	prince
notte	nuit
mese	mois
cancellazione	effacement
batteria	batterie
immagini	images
argento	argent
poeta	poète
charles	charles
rosso	rouge
russo	russe
occidentale	occidental
occidentale	occidentale
comando	commandement
comando	commande
bianco	blanc
licenza	licence
template	template
reti	réseaux
funzione	fonction
scena	scène
cinema	cinémas
cinema	cinéma
associazione	association
mia	mia
mia	ma
riferimento	référence
simile	similaire
simile	semblable
ragazza	fille
utenti	utilisateurs
elementi	éléments
elementi	eléments
franco	franc
franco	franco
arcivescovo	archevêque
enrico	henri
torre	tour
reale	réel
reale	réelle
oppure	ou
compagnia	compagnie
der	der
produttore	producteur
produttore	fabricant
azione	action
risultati	résultats
interesse	intérêt
campione	échantillon
campione	champion
live	live
donne	femmes
decide	décide
parla	parle
successiva	suivante
truppe	troupes
possibilità	possibilités
possibilità	possibilité
lunga	longue
nero	noir
roberto	roberto
destra	droite
city	city
difesa	défense
americano	américain
accordo	accord
personale	personnel
personale	personnelle
dimensioni	dimensions
completamente	complètement
radio	radio
records	records
sette	sept
capitale	capitale
capitale	capital
martin	martin
situazione	situation
parole	mots
los	los
aiuto	aide
genova	gênes
effetti	effets
greco	grecque
greco	grec
considerato	considéré
prese	prises
idea	idée
madonna	madone
madonna	madonna
rivista	magazine
intorno	autour
parco	parc
abbia	ayez
romana	romaine
romana	romana
incontro	rencontre
otto	huit
direzione	direction
marina	marina
richiesta	demande
alberto	alberto
editore	éditeur
editore	editeur
risultato	résultat
usato	utilisé
inghilterra	angleterre
duca	duc
carica	charger
carica	charge
votazione	vote
sociale	sociale
sociale	social
maschile	masculin
cose	choses
prova	preuve
prova	essai
qualità	qualité
wiki	wiki
wiki	wikis
rapporto	rapport
black	black
minuti	minutes
stella	étoile
stella	stella
porto	porto
porto	port
angelo	angelo
angelo	ange
tecnica	technique
lega	alliage
lega	ligue
speciale	spécial
speciale	spéciale
azienda	entreprise
artista	artiste
anna	anne
anna	anna
record	record
record	records
diventa	devenez
diventa	devient
mercato	marché
versioni	versions
giocatori	joueurs
chiamata	appel
stagioni	saisons
sale	sel
libri	livres
border	border
stefano	stéphane
stefano	stefano
stefano	étienne
natura	nature
tennis	tennis
capacità	capacité
capacità	capacités
buona	bonne
frazione	fraction
nave	navire
estate	ete
estate	eté
estate	été
pubblica	publique
giappone	japon
volume	volume
fuoco	feu
vuole	veut
differenza	différence
gol	buts
gol	gol
gol	but
composto	composé
campagna	campagne
accesso	accès
organizzazione	organisation
link	lien
lago	lac
canale	canal
canale	chaîne
popolare	peupler
popolare	populaires
popolare	populaire
deceduto	décédé
fanno	font
ufficiali	officiers
ufficiali	officiels
viaggio	voyage
quarto	quatrième
quarto	quatrièmement
tappa	étape
inferiore	inférieur
inferiore	inférieure
ponte	pont
materiale	matériau
pallacanestro	basket
comprende	comprend
bruno	bruno
fisica	physique
pilota	pilote
contiene	contient
armi	armes
relazione	rapport
oggetto	objet
eventi	evénements
eventi	événements
medico	médecin
medico	médical
conto	compte
semplice	simple
ministro	ministre
motivo	motif
sole	soleil
prodotti	produits
sport	sport
sport	sports
direttamente	directement
grafica	graphiques
grafica	graphismes
grafica	graphisme
ottenere	obtenir
creare	créer
divisioni	divisions
isole	îles
colonna	colonne
medaglia	médaille
testi	paroles
testi	textes
creato	créé
sola	seule
quarti	quarts
vecchio	vieux
bassa	basse
bassa	faible
matrimonio	mariage
minore	mineure
minore	mineur
meridionale	méridional
onda	vague
onda	onde
aspetto	apparence
architetto	architecte
precedenti	précédentes
precedenti	précédents
dovuto	dû
contratto	contrat
filippo	philippe
filippo	filippo
battuto	battu
raccolta	collecte
comunale	communal
nascita	naissance
mark	mark
naturale	naturel
naturale	naturelle
scritta	écrite
coppia	couple
coppia	paire
presto	bientôt
scelta	choix
vedere	voir
federico	frédéric
realizzato	réalisé
promozione	promotion
articolo	article
condizioni	conditions
complesso	complexe
linee	lignes
locali	locales
locali	locaux
futuro	futur
futuro	avenir
orchestra	orchestre
right	right
settore	secteur
principalmente	principalement
camera	chambre
decise	décidées
chiusa	fermée
comandante	commandant
settimana	semaine
potenza	puissance
giocato	joué
esiste	existe
atto	acte
com	com
collaborazione	collaboration
russia	russie
cappella	chapelle
group	group
figura	figure
ecc	etc
rai	rai
italiane	italiennes
giovani	jeunes
croce	croix
posta	courrier
michele	michele
conosciuto	connu
regina	reine
regina	regina
tradizione	tradition
polizia	police
migliori	améliorez
migliori	meilleurs
migliori	meilleures
sconfitta	défaite
pace	paix
palermo	palermo
palermo	palerme
massa	masse
massa	massa
energia	énergie
energia	energie
rosa	rose
rosa	rosa
aria	air
militari	militaires
storici	historiens
storici	historiques
fondata	fondée
tracce	traces
nessuno	personne
diretta	directe
capitano	capitaine
piccoli	petits
elezioni	élections
elezioni	elections
elezioni	élection
artisti	artistes
teoria	théorie
distribuzione	distribution
sportivo	sportif
dieci	dix
evento	évènement
evento	événement
raggiungere	atteindre
internazionali	internationaux
internazionali	internationales
tom	tom
enciclopedia	encyclopédie
canzoni	chansons
popolo	peuple
mondiali	mondiaux
uscita	sortie
distanza	distance
portato	apporté
pro	pro
max	max
africa	afrique
lingue	langues
memoria	mémoire
amici	amis
maestro	maestro
maestro	maître
bambino	enfant
libero	gratuit
libero	gratuitement
libero	libre
giacomo	jacques
fratelli	frères
vera	vera
vera	véra
vera	vraie
standard	standards
standard	standard
forme	formes
jack	jack
svg	svg
smith	smith
scoperto	découvert
fondazione	fondation
sposò	épousa
nomi	noms
importanza	importance
distribuito	distribué
distribuito	distribuée
particolarmente	particulièrement
festa	fête
cattolica	cattolica
cattolica	catholique
cuore	cœur
cuore	coeur
villaggio	village
cerca	chercher
cerca	rechercher
scrivere	écrire
scrivere	ecrire
partecipanti	participants
dietro	derrière
apertura	ouverture
louis	louis
vittorie	victoires
chiese	églises
chiese	eglises
ottenne	obtint
galleria	galerie
parola	parole
parola	mot
verde	verte
verde	vert
vince	vince
vince	gagne
sceneggiatore	scénariste
contributi	contributions
contributi	cotisations
preso	pris
bambini	enfants
santi	saints
santi	santi
fatti	faits
luca	luca
accademia	académie
passa	passe
facendo	faisant
servizi	services
navi	navires
dedicato	dédié
partecipato	participé
elenco	liste
formula	formule
arrivo	arrivée
titolare	titulaire
titolare	titrer
latino	latin
latino	latino
sicilia	sicile
open	open
lorenzo	lorenzo
letteratura	littérature
libertà	libertés
libertà	liberté
bronzo	bronze
tecniche	techniques
continua	continue
ambiente	environnement
andare	aller
missione	mission
regionale	régional
evitare	éviter
evitare	eviter
frank	frank
dovrebbe	devrait
composta	composée
henry	henry
costruito	construit
intervento	intervention
pietra	pierres
show	show
bandiera	drapeau
bandiera	bannière
critica	critique
tecnico	technicien
vittorio	vittorio
foto	photos
foto	photo
incontri	rencontres
arbitro	arbitre
blocca	verrouiller
blocca	bloque
percorso	chemin
percorso	parcours
one	one
quartiere	quartier
cinese	chinois
cinese	chinoise
svizzera	suisse
luoghi	lieux
tardi	tard
blu	bleu
blu	bleue
nobile	noble
trattato	traité
american	american
diritti	droits
nacque	naquit
eletto	élu
soldati	soldats
king	king
federazione	fédération
passaggio	passage
off	off
davanti	devant
ragazzo	garçon
ottenuto	obtenu
confronti	comparaisons
rossi	rossi
dedicata	dédiée
carattere	caractère
bottom	bottom
monaco	moine
monaco	munich
monaco	monaco
soggetto	sujet
rappresenta	représente
nomination	nominés
operazione	opération
ucciso	tué
sorella	sœur
sorella	soeur
vinse	gagna
vincitore	vainqueur
vincitore	gagnant
lee	lee
raccoglie	recueille
permette	permet
sicurezza	sécurité
giornata	journée
giornata	journee
xvi	xvi
biblioteca	bibliothèque
brasile	brésil
sistemi	systèmes
volo	vol
web	web
significa	signifie
architettura	architecture
simili	similaires
simili	semblables
necessario	nécessaire
difficoltà	difficulté
difficoltà	difficultés
under	under
punteggio	score
punteggio	scores
tema	thème
animali	animaux
piccole	petites
val	val
olandese	néerlandais
olandese	hollandais
musicista	musicien
deriva	dérive
caccia	chasse
creazione	création
nasce	naît
poteva	pouvait
utilizzo	utilisation
noi	nous
cesare	cesare
cesare	césar
colori	couleurs
diff	diff
cattedrale	cathédrale
stampa	impression
stampa	imprimer
stampa	presse
messo	mis
arti	arts
mosca	moscou
mosca	mouche
diventare	devenir
lettera	lettre
messa	messe
esistono	existent
austria	autriche
singolare	singulière
singolare	singulier
pos	pos
esemplari	exemplaires
esemplari	spécimens
daniel	daniel
insee	insee
height	height
motivi	raisons
motivi	motifs
giulio	giulio
pubblicazione	publication
berlino	berlin
onore	honneur
conoscenza	connaissance
conoscenza	connaissances
mettere	mettre
aperto	ouverte
aperto	ouvert
semplicemente	simplement
blocco	bloquer
blocco	bloc
blocco	blocage
maglia	maillot
maglia	maille
maglia	tricot
corsa	course
pratica	pratique
commissione	commission
generalmente	généralement
attenzione	attention
play	play
caratterizzata	caractérisée
passò	passa
arco	arc
arco	arco
autorità	autorités
autorità	autorité
campi	champs
oggetti	objets
domenico	domenico
autori	auteurs
origini	origines
abbastanza	assez
bob	bob
bob	bobsleigh
tedeschi	allemands
lettere	lettres
effetto	effet
resistenza	résistance
resistenza	endurance
tentativo	tentative
intera	entière
josé	josé
xix	xix
west	west
gestione	gestion
canvas	canvas
scala	homothétie
scala	escalier
scala	échelle
scala	echelle
censimento	recensement
chris	chris
die	die
partecipazione	participation
mike	mike
costituito	constitué
vincenzo	vincenzo
prendere	prendre
modifiche	modifications
omonimo	homonyme
canadese	canadienne
canadese	canadien
canadese	canadiens
scalemajor	scalemajor
passare	passer
passare	basculer
timeaxis	timeaxis
imagesize	imagesize
famiglie	ménages
famiglie	familles
plotarea	plotarea
svedese	suédoise
svedese	suédois
australia	australie
best	best
secoli	siècles
press	press
ottiene	obtient
esterno	externe
esterno	extérieur
esterno	exterieur
sangue	sang
dateformat	dateformat
sergio	sergio
traduzione	traduction
piani	plans
padova	padoue
ricevuto	reçu
intero	entier
ghiaccio	glaçons
ghiaccio	glace
chiaro	clair
trovato	trouvé
cina	chine
justify	justify
alignbars	alignbars
backgroundcolors	backgroundcolors
alpi	alpes
scaleminor	scaleminor
supporto	support
nicola	nicola
difficile	difficile
lotta	lutte
india	inde
misura	mesure
pianta	plante
termini	termes
occhi	yeux
bianca	blanche
bianca	bianca
regioni	régions
spacewatch	spacewatch
california	californie
costruita	construite
marcatore	marqueur
spettatori	téléspectateurs
spettatori	spectateurs
premi	primes
risposta	réponse
inserito	inséré
nessun	aucun
medio	moyen
commenta	commente
atleta	athlète
soli	seuls
soli	soleils
culturale	culturelle
culturale	culturel
realizzazione	réalisation
secondi	secondes
modelli	modèles
auto	auto
politiche	politiques
sesso	sexe
portò	apporta
ragione	raison
strumenti	instruments
strumenti	outils
steve	steve
steve	steeve
contenuto	contenu
famoso	célèbre
juan	juan
terreno	terrain
piedi	pieds
cielo	ciel
notevole	remarquable
rossa	rousse
xiii	xiii
xiii	xiiie
durata	durée
componenti	composants
analisi	analyses
analisi	analyse
teatrale	théâtrale
teatrale	théâtral
maggioranza	majorité
usare	utiliser
tempio	temple
gesù	jésus
quantità	quantités
quantità	quantité
joe	joe
dirigente	dirigeant
concerto	concert
mani	mains
jones	jones
minori	mineurs
vive	vit
austriaco	autrichien
williams	williams
filosofia	philosophie
natale	noël
natale	noel
discussioni	discussions
discussioni	débats
aggiunta	ajout
disponibile	disponible
vienna	vienne
guardia	garde
competizione	compétition
attivo	actif
conflitto	conflit
partecipa	participe
partecipa	participez
confine	frontière
stelle	etoiles
stelle	étoiles
crisi	crise
avvocato	avocat
claudio	claudio
facciata	façade
descrizione	description
nata	née
raggiunto	atteint
avendo	ayant
fondato	fondé
conquista	conquête
conquista	conquérir
esistenza	existence
entrò	entra
francisco	francisco
canada	canada
aereo	avion
anime	âmes
anime	anime
economia	économie
economia	economie
devono	doivent
regole	règles
detta	dite
trasmissione	transmission
criteri	critères
pianeta	planete
pianeta	planète
segno	signe
romani	romains
edifici	bâtiments
pianoforte	piano
maschi	mâles
argomento	argument
sapere	savoir
doveva	devait
time	time
nessuna	aucune
scott	scott
guglielmo	guillaume
legno	bois
altare	autel
amministrazione	administration
guest	guest
storie	histoires
ospedale	hopital
ospedale	hôpital
bordo	bord
funzioni	fonctions
funzioni	fonctionnalités
metodo	méthode
strutture	structures
operazioni	opérations
trono	trône
nazioni	nations
simon	simon
rispettivamente	respectivement
red	red
religione	religion
vecchia	vieille
commerciale	commercial
uscì	sortit
arma	arme
indica	indique
indica	indica
house	house
conseguenza	conséquence
ufficialmente	officiellement
trasporto	transport
scene	scènes
teste	têtes
utile	utile
life	life
royal	royal
vii	vii
mary	mary
aiutare	aider
list	list
signore	monsieur
imperiale	impérial
imperiale	impériale
cristo	christ
monastero	monastère
contatto	contact
diffusione	diffusion
lascia	laisse
white	white
big	big
tipi	types
dollari	dollars
territori	territoires
lavorare	travailler
gioca	joue
gioca	jouez
amministratore	administrateur
orbita	orbite
walter	walter
madrid	madrid
letto	lit
disposizione	disposition
leone	lion
ala	ala
ala	aile
genitori	parents
xii	xii
simbolo	symbole
quinto	cinquième
quinto	quintus
xviii	xviiie
xviii	xviiième
xviii	xviii
ingegnere	ingénieur
costretto	forcé
costretto	contraint
bgcolor	bgcolor
luna	luna
luna	lune
argentina	argentine
stemma	armoiries
stemma	blason
leggi	lire
leggi	lois
religioso	religieux
spirito	esprit
soluzione	solution
statistiche	statistiques
iniziata	initiée
iniziata	commencée
ministero	ministère
niente	rien
computer	ordinateur
computer	ordinateurs
merito	mérite
scheda	fiche
scheda	onglet
morti	morts
settimane	semaines
series	series
protezione	protection
bari	bari
ufficio	bureau
filosofo	philosophe
ultime	dernières
harry	harry
danni	dommages
danni	dégâts
atti	actes
chitarrista	guitariste
azioni	actions
utilizzare	utiliser
xvii	xviie
xvii	xvii
und	und
numeri	numéros
ferro	fer
messico	mexique
normale	normale
normale	normal
traccia	trace
washington	washington
rio	rio
messaggio	message
entrare	entrer
borgo	bourg
borgo	borgo
out	out
categorie	catégories
scrisse	écrivit
parma	parme
parma	parma
united	united
iniziato	commencé
geografia	géographie
latitudine	latitude
sonora	sonora
strumento	instrument
strumento	outil
brasiliano	brésilien
colpo	coup
brian	brian
definitivamente	définitivement
leggere	lire
uscito	sorti
ipotesi	hypothèses
ipotesi	hypothèse
influenza	influence
influenza	grippe
vivo	vivant
modalità	mode
organo	orgue
organo	organe
giallo	jaune
metropolitana	métro
grecia	grèce
leader	leader
mura	remparts
mura	murs
scienze	sciences
comitato	comité
etichetta	etiquette
etichetta	étiquette
etichetta	label
#aaa	#aaa
scritti	écrits
coda	queue
park	park
incidente	incident
incidente	accident
xiv	xiv
sostituito	remplacé
jim	jim
metal	metal
verona	verone
verona	verona
verona	vérone
basilica	basilique
composizione	composition
guido	guido
significato	signification
responsabile	mainteneur
responsabile	responsable
solid	solid
championship	championship
femmine	femelles
valign	valign
fede	foi
prove	essais
prove	preuves
nemico	ennemie
nemico	ennemi
documenti	documents
specialità	spécialité
specialità	spécialités
poteri	pouvoirs
young	young
segretario	secrétaire
istituzione	institution
decreto	décret
iniziale	initiale
iniziale	initial
concetto	concept
edit	edit
sesto	sixième
gradi	grades
gradi	degrés
lasciare	laisser
rivoluzione	révolution
bill	bill
motori	moteurs
tiro	tir
campioni	champions
campioni	échantillons
abitato	habité
piante	plantes
temperatura	température
imprenditore	entrepreneur
vivere	vivre
perso	perdu
brescia	brescia
americana	américaine
awards	awards
asteroide	astéroïde
rende	rend
longitudine	longitude
benedetto	benoît
benedetto	béni
carlos	carlos
scoperta	découverte
scoperta	decouverte
culto	culte
guerre	guerres
fuga	fuite
fuga	fugue
fuga	évasion
tony	tony
post	post
usata	utilisée
ungherese	hongroise
ungherese	hongrois
macchina	machine
macchina	voiture
cavallo	cheval
decisione	décision
obiettivo	objectif
obiettivo	cible
euro	euros
euro	euro
chicago	chicago
oscar	oscar
oscar	oscars
tradizionale	traditionnel
tradizionale	traditionnelle
tradizionale	traditionnels
enciclopedica	encyclopédique
ciclo	cycle
vice	adjoint
viii	viii
internet	internet
presentato	présenté
sovietica	soviétique
edward	edward
scuole	ecoles
scuole	écoles
reggimento	régiment
difensore	défenseur
sconfitto	défait
sconfitto	vaincu
olio	huile
costituita	constituée
conosciuta	connue
talk	talk
immediatamente	immédiatement
registrato	enregistrée
registrato	enregistré
dubbio	doute
dubbio	douteux
pensiero	pensée
ebbero	eurent
commedia	comédie
terre	terres
realizzata	réalisée
introduzione	introduction
dotato	doté
principio	principe
amm	msa
punta	pointe
deciso	décidé
alexander	alexander
test	test
test	tests
caps	caps
egitto	égypte
egitto	egypte
valori	valeurs
portiere	concierge
portiere	portier
uefa	uefa
dominio	domaine
mantenere	maintenir
mantenere	garder
brown	brown
conti	comptes
parlare	parler
elemento	élément
your	your
zero	zero
zero	zéro
diversa	différente
giocare	jouer
cittadini	citoyens
compare	apparaît
day	day
corrente	courant
hall	hall
scultore	sculpteur
jan	jan
articoli	articles
nipote	nièce
nipote	neveu
title	title
php	php
dischi	disques
polacco	polonaise
polacco	polonais
riforma	réforme
statua	statue
clubnat	clubnat
software	logiciel
software	logiciels
speciali	spéciaux
necessità	nécessité
antichi	anciens
attacchi	attaques
principessa	princesse
debutto	débuts
montagna	montagne
montagna	montagnes
malattia	maladie
livelli	niveaux
professore	professeur
felice	heureux
felice	heureuse
verità	vérité
verità	vérités
denominazione	dénomination
flotta	flotte
sin	sin
argentino	argentin
salvatore	sauveur
salvatore	salvatore
comportamento	comportement
corona	couronne
costituzione	constitution
combattimento	combat
bisogno	besoin
copyright	copyrights
copyright	copyright
certa	certaine
parlamento	parlement
caduta	chute
visione	vision
sviluppato	développé
rivolta	révolte
talvolta	parfois
capitolo	chapitre
sovrano	souveraine
sovrano	souverain
dvd	dvd
dvd	dvds
prodotta	produite
consenso	consensus
consenso	consentement
tornò	revint
pisa	pise
pisa	pisa
notizie	nouvelles
notizie	actualités
rilievo	relief
pio	piou
pio	pio
concorso	concours
utilizzati	utilisés
partenza	départ
sam	sam
figure	figures
rischio	risque
monti	monts
monti	monti
nazione	nation
primavera	printemps
london	london
agente	agent
nazionalità	nationalité
nazionalità	nationalités
aperta	ouverte
umano	humain
sardegna	sardaigne
indipendenza	indépendance
ricevette	reçut
materiali	matériaux
eccentricità	excentricité
png	pnj
png	png
bianchi	bianchi
bianchi	blancs
nove	neuf
diego	diego
ali	ali
ali	ailes
can	can
riserva	réserve
televisione	télévision
sceneggiatura	scénario
laura	laura
basato	basé
riccardo	richard
fiori	fleurs
vergine	vierge
spettacolo	spectacle
byte	bytes
byte	octet
byte	octets
posizioni	positions
polonia	pologne
toscana	toscane
entrata	entrée
fanteria	infanterie
piero	piero
admin	admin
lasciato	laissé
costruire	construire
canto	chant
mancanza	manque
alex	alex
modifica	modification
modifica	modifier
modifica	éditer
marino	marino
coro	chœur
coro	chorale
coro	choeur
frase	phrase
industria	industrie
solitamente	habituellement
uccidere	tuer
leggera	légère
asia	asie
atp	atp
comunicazione	communication
chiuse	fermées
hockey	hockey
rugby	rugby
scrittrice	romancière
scrittrice	écrivaine
norvegese	norvégiens
norvegese	norvégien
johnson	johnson
politici	politiciens
umani	humains
bretagna	bretagne
vescovi	évêques
potente	puissant
potente	puissante
esclusivamente	exclusivement
elezione	élection
elezione	election
tribù	tribu
tribù	tribus
personalità	personnalité
personalità	personnalités
finalista	finaliste
indicare	indiquer
interpretazione	interprétation
interpretazione	interpretation
christian	christian
definizione	définition
partecipare	participer
convento	couvent
interpretata	interprétée
portale	portail
province	provinces
legato	légat
protagonisti	protagonistes
assegnato	attribué
assegnato	affecté
nemici	ennemies
nemici	ennemis
errore	erreur
mondadori	mondadori
recente	récent
recente	récente
semi	semi
semi	graines
leonardo	léonard
leonardo	leonardo
universo	univers
domenica	dimanche
pressione	pression
arthur	arthur
limite	limite
presa	prise
first	first
collega	collègue
chilometri	kilomètres
volontà	volonté
sicuramente	certainement
assenza	absence
filmografia	filmographie
porte	portes
orario	horaire
indipendente	indépendant
indipendente	indépendante
caratteristica	caractéristique
abilità	agilité
abilità	compétences
governatore	gouverneur
giusto	juste
catastale	cadastral
catastale	cadastrale
blue	blue
umana	humaine
monumento	monument
materia	matière
creata	créée
patria	patrie
dipinto	peint
date	dates
fenomeno	phénomène
roger	roger
interamente	entièrement
alleanza	alliance
forti	fortes
forti	forts
sigla	paraphe
tal	tal
copie	exemplaires
copie	copies
gianni	gianni
esce	sort
condizione	condition
lancio	lancement
industriale	industriel
pista	piste
rivela	révèle
tenere	tenir
linguaggio	langage
facilmente	facilement
espressione	expression
iso	oin
iso	iso
neat	neat
diventato	devenu
solista	soliste
appartiene	appartient
manifestazione	manifestation
pieno	plein
belga	belge
giustizia	justice
venti	vents
venti	vingt
collezione	collection
ritiro	retrait
firma	signature
poesia	poème
poesia	poésie
occhio	oeil
occhio	œil
cavaliere	chevalier
cavaliere	cavalier
inizi	commencez
segreto	secret
racconta	raconte
santuario	sanctuaire
taylor	taylor
racconti	contes
racconti	récits
gas	gaz
lady	lady
relativa	relative
latina	latine
latina	latina
manga	manga
manga	mangas
trovava	trouvait
superiori	supérieurs
prestito	prêt
baviera	bavière
ciclista	cycliste
aerei	avions
signora	madame
fondatore	fondatrice
fondatore	fondateur
sindaco	maire
visita	visite
visita	visitez
dinastia	dynastie
identità	identités
identità	identité
dimensione	taille
martino	martino
finalmente	enfin
sacro	sacré
emilia	émilie
emilia	emilia
portata	portée
dovette	dut
mezzi	moyens
salute	santé
chiara	claire
cori	chœurs
cori	cori
veneto	vénétie
veneto	veneto
maurizio	maurizio
maurizio	maurice
oriente	orient
war	war
proprietario	propriétaire
principi	principes
principi	princes
animale	animal
volumi	volumes
noti	connus
marie	marie
programmi	programmes
finali	finales
grave	grave
informazione	informations
informazione	information
siena	sienne
siena	siena
davis	davis
ricordo	souvenir
real	real
real	réal
chiusura	fermeture
cominciò	commença
economico	économique
archivio	archives
archivio	archive
contesto	contexte
matteo	mathieu
matteo	matthieu
jackson	jackson
albert	albert
https	https
definito	défini
elena	hélène
elena	elena
rimasto	resté
vale	vale
ray	ray
domanda	question
danno	danno
svezia	suède
studenti	étudiants
studenti	etudiants
habitat	habitats
habitat	habitat
classico	classique
pop	pop
catania	catane
cristiana	chrétienne
permesso	permission
challenger	challenger
viola	violette
viola	viola
viola	violet
varietà	variété
varietà	variétés
km²	km²
circuito	circuit
disegno	dessin
discorso	discours
attaccante	attaquant
saranno	seront
reazione	réaction
spedizione	expédition
medicina	médecine
eric	éric
eric	eric
abbazia	abbaye
muto	muet
piloti	pilotes
eccezione	exception
sessanta	soixante
vincere	gagner
rendere	rendre
compreso	compris
posteriore	arrière
posteriore	postérieur
riceve	reçoit
ferrari	ferrari
calabria	calabria
calabria	calabre
continuò	poursuivit
continuò	continua
dizionario	dictionnaire
provinciale	provincial
modella	mannequin
registrazione	enregistrement
religiosa	religieuse
girl	girl
medievale	médiévale
medievale	médiéval
incontra	rencontrez
ungheria	hongrie
possesso	possession
monumenti	monuments
portoghese	portugaise
portoghese	portugais
sezioni	sections
contemporanea	contemporaine
fuso	fuseau
colonne	colonnes
barbara	barbara
giardino	jardin
foglie	feuilles
street	street
kevin	kévin
kevin	kevin
green	green
savoia	savoie
interventi	interventions
compagni	camarades
compagni	compagnons
idee	idées
indicato	indiqué
matematico	mathématicien
confini	frontières
www	www
spada	épée
spada	epée
regolare	régulière
regolare	régulier
regolare	ajuster
civili	civils
naturali	naturelles
naturali	naturels
aumento	augmentation
lavora	travaille
chiave	clef
chiave	clé
seguire	suivre
compagno	camarade
compagno	compagnon
scozzese	écossais
affari	affaires
irlandese	irlandaise
irlandese	irlandais
background	background
vetrina	vitrine
museum	museum
albero	arbre
albero	arborescence
augusto	augusto
augusto	auguste
esecuzione	exécution
raggiunse	atteignit
imho	imho
parziale	partiel
parziale	partielle
vincendo	remportant
arrivò	arriva
successi	réussites
reggio	reggio
hill	hill
esempi	exemples
documento	document
caratterizzato	caractérisé
nucleo	noyau
insegnante	enseignant
hans	hans
ebrei	juifs
congresso	congrès
patrick	patrick
artiglieria	artillerie
gentile	gentil
gentile	aimable
jazz	jazz
farsi	farsi
davvero	vraiment
banca	banque
concerti	concerts
gigante	géant
gigante	géante
cima	cima
trieste	trieste
arcidiocesi	archidiocèse
arcidiocesi	archevêché
lasciando	laissant
barcellona	barcelone
karl	karl
salvare	sauver
minimo	minimum
ottenendo	obtenant
ordini	ordres
giudizio	jugement
autonoma	autonome
tesi	thèses
tesi	thèse
opinione	opinion
anteriore	antérieure
anteriore	antérieur
anteriore	avant
mediterraneo	méditerranéen
mediterraneo	méditerranée
moto	moto
vittime	victimes
colonia	cologne
facoltà	facultés
facoltà	faculté
somma	somme
crescita	croissance
giudice	juge
lati	côtés
andrew	andrew
messina	messine
messina	messina
recenti	récents
recenti	récentes
cambiare	changer
portogallo	portugal
renato	renato
americani	américains
tokyo	tôkyô
tokyo	tokyo
alleati	alliés
quota	quota
lontano	loin
lontano	lointain
variante	variante
dichiarato	déclaré
estremamente	extrêmement
leggenda	légende
disponibili	disponibles
costante	constante
costante	constant
luis	luis
precedentemente	précédemment
generazione	génération
generazione	générations
piattaforma	plateforme
belgio	belgique
modena	modena
modena	modène
biografia	biographie
digitale	numérique
omicidio	meurtre
fotografia	photographie
umberto	umberto
caterina	caterina
caterina	catherine
nostro	notre
abate	abbé
mauro	mauro
tommaso	thomas
tommaso	tommaso
svolta	tournant
quinta	quinta
aldo	aldo
high	high
dotata	dotée
comunista	communiste
kim	kim
alfonso	alfonso
pubblicati	publiés
dentro	dedans
vantaggio	avantage
riconoscimento	reconnaissance
mandato	mandat
interpreti	interprètes
ampio	large
zio	tonton
zio	oncle
pensare	penser
rose	rosiers
muore	meurt
colonnello	colonel
visibile	visible
visibile	visibles
ritratto	portrait
scienza	science
reso	rendu
affreschi	fresques
luciano	luciano
termina	termine
vendita	vente
perdita	perte
brigata	brigade
combattere	combattre
carl	carl
generi	genres
tecnologia	technologie
scrittura	ecriture
scrittura	écriture
irlanda	irlande
virginia	virginie
virginia	virginia
suono	son
generali	généraux
attiva	active
matematica	maths
matematica	mathématique
matematica	mathématiques
condotto	conduit
condotto	mené
completo	complet
tipico	typique
ceco	tchèque
passione	passion
ruoli	roles
ruoli	rôles
artistico	artistique
largo	largo
andré	andré
flag	flag
moderno	moderne
interni	internes
interni	intérieur
interni	intérieurs
concessione	concession
anderson	anderson
amministrativo	administratif
tim	tim
votare	voter
trattamento	traitement
contributo	contribution
assoluto	absolu
assoluto	absolue
cimitero	cimetière
salvo	salvo
salvo	sauf
trofeo	trophée
espansione	expansion
estero	etranger
amicizia	amitié
senato	sénat
verdi	verdi
verdi	vertes
verdi	verts
realizzare	réaliser
fumetti	bd
originario	originaire
temi	thèmes
invasione	invasion
belle	belles
altrimenti	sinon
lewis	lewis
neri	noirs
chiedere	demander
mille	mille
inverno	hiver
componente	composante
componente	composant
avviso	avis
divisa	divisée
atene	athènes
alan	alan
emanuele	emanuele
emanuele	emmanuel
collegio	collège
collegio	pensionnat
marchese	marquis
praticamente	pratiquement
victor	victor
previsto	prévu
pokémon	pokémon
girato	tourné
cavalieri	chevaliers
cavalieri	cavaliers
nick	nick
ivan	ivan
billy	billy
pezzo	morceau
sovietico	soviétique
novecento	novecento
contenente	contenant
rappresentato	représenté
automatico	automatique
napoleone	napoléon
resa	reddition
resa	rendue
resa	rendement
promosso	promue
promosso	promu
inclinata	inclinée
corsi	cours
cronologia	chronologie
lazio	lazio
lazio	latium
anima	ame
anima	âme
song	song
wilson	wilson
sufficiente	suffisant
sufficiente	suffisante
stretto	détroit
stretto	serré
stretto	étroit
dialetto	dialecte
lavorato	usiné
lavorato	travaillé
dodici	douze
dodici	dodici
texas	texas
immediata	immédiate
fabio	fabio
emilio	emilio
regola	règle
clima	climat
pil	pib
cittadino	citoyen
pittura	peinture
enorme	énorme
simone	simone
google	google
men	men
atletica	athlétisme
tenente	lieutenant
vento	vent
howard	howard
gaetano	gaetano
cristiano	chrétien
laterali	latéraux
laterali	latérales
braccio	bras
angolo	coin
angolo	angle
attori	acteurs
formata	formée
solare	solaire
specifico	spécifique
danese	danois
danese	danoise
angeli	anges
eclittica	écliptique
movimenti	mouvements
chiama	appelle
spalle	épaules
adam	adam
sfida	défi
will	will
avversario	adversaire
documentario	documentaire
lunghi	longs
equipaggio	équipage
equipaggio	equipage
equipaggio	équipages
facile	facile
parrocchia	paroisse
lombardia	lombardia
lombardia	lombardie
windows	windows
relativamente	relativement
leggermente	légèrement
fortuna	chance
fortuna	fortune
traffico	trafic
prestazioni	performance
prestazioni	performances
prestazioni	prestations
pubblicò	publia
jimmy	jimmy
trenta	trenta
segnali	signaux
basata	basée
ampia	large
esposizione	exposition
ford	ford
alessandria	alessandria
alessandria	alexandrie
foresta	forêt
dante	dante
apre	ouvre
musicisti	musiciens
ispirato	inspiré
piena	pleine
penisola	péninsule
potevano	pouvaient
cinquanta	cinquante
agostino	agostino
doppiatore	doubleur
slalom	slalom
paura	peur
history	history
motivazione	motivation
anti	anti
sostegno	soutien
candidato	candidat
infanzia	enfance
inviato	signalé
inviato	envoyé
inviato	posté
religiose	religieuses
capace	capable
lettura	lecture
originali	originales
originali	originaux
occupazione	emploi
popolazioni	populations
fasi	phases
fasi	étapes
controllare	contrôler
rappresentazione	représentation
capelli	cheveux
possibili	possibles
detentore	détenteur
colle	colles
colle	col
tastiere	claviers
estratto	extrait
costo	coût
aquila	aigle
parrocchiale	paroissiale
romanzi	romans
fusione	fusion
marchio	marque
saga	saga
francis	francis
assolutamente	absolument
autonomia	autonomie
semplificata	simplifiée
goals	goals
vino	vin
assistente	assistant
assistente	assistante
remix	remix
vincitori	vainqueurs
vincitori	gagnants
vincitori	lauréats
ricostruzione	reconstruction
vicenza	vicence
vicenza	vicenza
operativo	opérationnel
boy	boy
johann	johann
alice	alice
individuale	individuelle
individuale	individuel
perde	perd
pericolo	danger
duomo	duomo
duomo	dôme
suolo	sol
cast	cast
iniziativa	initiative
tabella	tableau
organizzato	organisé
fontana	fontana
fontana	fontaine
johnny	johnny
applicazione	application
sogno	rêve
patrimonio	patrimoine
ragazze	filles
sposato	marié
ferrara	ferrare
ferrara	ferrara
legata	ligotée
attesa	attente
compresa	comprise
risorse	ressources
commissario	commissaire
occidentali	occidentaux
ugo	hugues
ugo	ugo
enzo	enzo
jeff	jeff
asse	essieu
asse	axe
intervista	interview
intervista	entrevue
north	north
vota	votez
successione	succession
lucio	lucio
lucio	lucius
famosi	célèbres
australiano	australien
chiuso	fermé
tomba	tombe
tomba	tombeau
segnalazione	signalement
votazioni	votations
votazioni	votes
estensione	prolongation
estensione	extension
amica	amie
stephen	stephen
potrebbero	pourraient
dolce	doux
dolce	sucré
dolce	douce
margherita	margherita
margherita	marguerite
pellicola	pellicule
vinta	gagnée
diametro	diamètre
sir	sir
bergamo	bergamo
bergamo	bergame
dan	dan
anthony	anthony
distruzione	destruction
mantova	mantoue
trasferimento	transfert
perdere	perdre
chimica	chimie
chimica	chimique
long	long
livorno	livourne
livorno	livorno
usati	utilisés
quotidiano	quotidien
romania	roumanie
ceca	ceca
anello	bague
anello	anneau
passeggeri	passagers
bruce	bruce
golden	golden
michel	michel
console	consul
console	console
console	consoles
not	not
pallavolo	volleyball
marcello	marcellus
marcello	marcello
conoscere	connaître
vendite	ventes
residenza	résidence
ducato	duché
trasporti	transports
liberazione	libération
ricco	riche
profondità	profondeur
profondità	profondeurs
edoardo	edouard
edoardo	edward
edoardo	édouard
alba	alba
alba	aube
ripresa	reprise
alfred	alfred
nobili	nobles
bacino	bassin
rocca	rocca
story	story
carcere	prison
aggiunto	ajouté
aggiunto	ajoutée
rifugio	refuge
andy	andy
fortezza	forteresse
rapidamente	rapidement
annunciato	annoncé
annunciato	annoncée
personalmente	personnellement
bosco	bosco
pelle	peau
elevata	élevée
classificazione	classification
tranne	excepté
cambridge	cambridge
profilo	profil
colpi	coups
barone	baron
catalogo	catalogue
corretto	corrigé
corretto	correcte
corretto	correct
migliorare	améliorer
federale	fédéral
federale	fédérale
giulia	giulia
indiano	indien
pubblicazioni	publications
ammiraglio	amiral
istruzione	éducation
saggio	sage
ambienti	environnements
socialista	socialiste
cagliari	cagliari
produrre	produire
caratteri	caractères
caratteri	polices
apparizione	apparition
conservato	conservé
bibliografia	bibliographie
interessante	intéressante
interessante	intéressant
riuscito	réussi
design	design
doppia	double
orientali	orientaux
are	are
purtroppo	malheureusement
rimanere	rester
olimpiadi	olympiades
olimpiadi	olympiade
avventura	aventure
assunto	embauché
impegno	engagement
disegni	dessins
urbano	urbain
perdite	pertes
las	las
collana	collier
town	town
cane	chien
blues	blues
death	death
selezione	sélection
allen	allen
mobile	mobile
hollywood	hollywood
interrotta	interrompue
educazione	éducation
fabbrica	usine
consente	permet
inserita	insérée
reali	réels
norma	norma
norma	norme
douglas	douglas
liceo	lycée
continuare	continuer
vito	vito
teresa	thérèse
teresa	teresa
aeronautica	aéronautique
what	what
relativi	relatifs
muro	mur
disney	disney
capito	compris
colpito	frappé
consigliere	conseiller
miller	miller
fecero	firent
down	down
segna	marquer
scomparsa	disparue
scomparsa	disparition
giuliano	giuliano
giuliano	julien
fred	fred
pesante	lourde
pesante	lourds
pesante	lourd
errori	erreurs
piede	pied
impiegato	employé
riconosciuto	reconnu
civica	civique
destro	droitier
destro	destro
uguale	égale
uguale	égal
diplomatico	diplomate
diplomatico	diplomatique
normalmente	normalement
ramo	branche
nomina	nomination
sicuro	sécurisé
sicuro	sûr
fox	fox
gordon	gordon
veloce	rapide
manager	manager
danimarca	danemark
scozia	écosse
scozia	ecosse
bocca	bouche
arena	arena
arena	arène
arena	arènes
end	end
lunghe	longues
criminale	criminelle
criminale	criminel
trasmesso	transmis
acido	acide
francesca	françoise
francesca	francesca
ludovico	ludovico
elisabetta	élizabeth
elisabetta	élisabeth
elisabetta	elizabeth
robin	robin
who	who
leo	léo
leo	leo
ciascuno	chacun
percussioni	percussions
charlie	charlie
fiducia	confiance
realizzati	réalisés
org	org
battaglione	bataillon
fiat	fiat
semplici	simples
salto	saut
aziende	entreprises
fabrizio	fabrizio
raggio	rayon
frequenza	fréquence
atleti	athlètes
tornei	tournois
alti	hauts
erede	héritier
erede	légataire
erede	héritière
desiderio	désir
desiderio	souhait
sacra	sacrée
sacra	sacré
matt	matt
lancia	lance
ken	ken
chiamati	appelés
inserimento	insertion
lucia	lucia
popolari	populaires
pena	peine
pena	pena
infinito	infinité
infinito	infini
trasferito	muté
trasferito	transféré
richieste	demandes
minaccia	menace
jane	jane
marc	marc
girolamo	girolamo
oceano	océan
pensa	pense
scritte	écrites
recentemente	récemment
sequenza	séquence
amante	amant
ritirato	retiré
argomenti	arguments
argomenti	sujets
alfredo	alfredo
uscire	sortir
voleva	voulait
missioni	missions
missioni	quêtes
aprire	ouvrez
vittima	victime
riva	riva
tribunale	tribunal
metodi	méthodes
prezzo	prix
limiti	limites
oxford	oxford
autunno	automne
meccanica	mécanique
cavalleria	cavalerie
cavalleria	chevalerie
basi	bases
descritto	décrit
descritto	décrite
archi	arches
archi	arcs
definita	définie
boston	boston
sanremo	sanremo
comunemente	couramment
trento	trente
trento	trento
trasferita	transférée
trad	trad
perugia	perugia
perugia	pérouse
avventure	aventures
rocco	rocco
congregazione	congrégation
finlandese	finlandais
finlandese	finnois
gamma	gamme
gamma	gamma
heart	heart
eva	eva
eva	ève
civiltà	civilité
civiltà	civilisation
civiltà	civilisations
panorama	panorama
land	land
pedro	pedro
dipinti	peintures
golfo	golfe
gabriele	gabriele
veramente	vraiment
favorevole	favorable
trasformazione	transformation
attuali	actuels
attuali	actuelles
pre	pré
aumentare	augmenter
wild	wild
prigionieri	prisonniers
agricoltura	agriculture
israele	israël
accusa	accusation
carri	wagons
carri	chars
responsabilità	responsabilités
responsabilità	responsabilité
road	road
franz	franz
gregorio	gregorio
gregorio	grégoire
dark	dark
fame	faim
treno	train
davide	davide
last	last
fan	fan
ciascuna	chacune
pdf	pdf
copia	copiez
copia	copier
copia	copie
privato	privée
privato	privé
morale	morale
morale	moral
eroe	héro
eroe	héros
alpino	alpin
navata	nef
adriano	hadrien
adriano	adriano
tipologia	typologie
segni	signes
incluso	inclus
acquistato	acheté
greci	grecques
greci	grecs
professionista	professionnel
avanzata	avancée
pasquale	pasquale
pontificio	pontifical
proposto	proposé
espresso	espresso
espresso	exprimé
espresso	expresso
introdotto	introduit
sassonia	saxe
fiumi	fleuves
fiumi	rivières
friedrich	friedrich
uccelli	oiseaux
status	status
cavalli	chevaux
organizzata	organisée
variabile	variable
mix	mix
pianista	pianiste
cibo	nourriture
annuale	annuelle
annuale	annuel
cristiani	chrétiens
lavorò	travailla
migliaia	milliers
moore	moore
indoor	indoor
ognuno	chacun
divinità	dieux
divinità	divinité
divinità	divinités
acciaio	acier
campagne	campagnes
corrispondenza	correspondance
violino	violon
bonus	bonus
campanile	campanile
campanile	beffroi
campanile	clocher
settimo	septième
tradizionali	traditionnelles
differenze	différences
razza	race
laboratorio	laboratoire
destino	destinée
destino	destin
abbandonato	abandonné
corrispondente	correspondante
corrispondente	correspondant
baseball	baseball
sostituzione	remplacement
sostituzione	substitution
oliver	oliver
brevi	brèves
limitata	limitée
costi	coûts
occasioni	occasions
probabile	probable
ryan	ryan
prefettura	préfecture
interessi	intérêts
hot	hot
fornire	fournir
opposizione	opposition
istituzioni	institutions
poesie	poésies
poesie	poèmes
dura	dure
elettronica	electronique
elettronica	électronique
eliminazione	élimination
monete	pièces
stone	stone
decisamente	décidément
convinto	convaincu
spaziale	spatiale
arabo	arabe
dave	dave
torrente	torrent
sinistro	sinistre
menzionato	mentionné
marmo	marbre
sky	sky
cambia	change
indiana	indiana
indiana	indienne
russell	russel
russell	russell
way	way
periodi	périodes
commento	commentaire
composti	composés
nostri	nos
terrestre	terrien
terrestre	terrestre
gloria	gloire
gloria	gloria
riescono	réussissent
jonathan	jonathan
western	westerns
western	western
andato	allé
turchia	turquie
localizzazione	localisation
sun	sun
vincitrice	lauréate
classi	classes
alternativa	alternative
realizza	réalise
speranza	espérance
speranza	espoir
esattamente	exactement
feat	feat
italo	italo
schermo	ecran
schermo	écran
norvegia	norvège
power	power
women	women
riduzione	réduction
distretti	districts
manuale	manuel
manuale	manuelle
conferenza	conférence
like	like
venduto	vendu
dick	dick
varianti	variantes
comics	comics
pesce	poissons
pesce	poisson
macchine	machines
gerusalemme	jerusalem
gerusalemme	jérusalem
alberi	arbres
two	two
batterista	batteur
conclude	conclut
decenni	décennies
punk	punk
punk	punks
salerno	salerne
salerno	salerno
musiche	musiques
riviste	magazines
good	good
violenza	violences
violenza	violence
jason	jason
ridotto	réduit
considerazione	considération
confronto	comparaison
valutazione	évaluation
valutazione	evaluation
chiaramente	clairement
canali	canaux
estremità	extrémité
estremità	extrémités
regio	regio
universale	universelle
universale	universel
dance	dance
inutile	inutile
successore	successeur
claude	claude
fascista	fasciste
fascista	facho
conservazione	conservation
como	como
como	côme
offerta	offre
roy	roy
bartolomeo	bartolomeo
senatore	sénateur
arrestato	arrêté
colspan	colspan
eliminare	éliminer
propone	propose
bernard	bernard
democratico	démocratique
democratico	démocrate
nozze	noces
include	inclut
misure	mesures
stub	stub
risolvere	résoudre
ombra	ombre
giunta	junte
year	year
concilio	concile
paola	paola
logo	logo
deputato	député
virtù	vertu
virtù	vertus
agenzia	agence
master	master
partiti	partis
altitudine	altitude
cerimonia	cérémonie
distrutto	détruit
boss	boss
oratorio	oratoire
riconoscimenti	récompenses
superare	surmonter
superare	surpasser
superare	dépasser
sostanza	substance
spiega	explique
bad	bad
ancona	ancône
ancona	ancona
organi	organes
sofia	sofia
medaglie	médailles
tag	tags
tag	tag
tag	balises
tag	balise
jordan	jordan
paragrafo	paragraphe
rimasta	restée
confederazione	confédération
special	special
navigazione	navigation
box	box
bernardo	bernardo
raffaele	raffaele
raffaele	raphael
cambiato	changé
venire	venir
eugenio	eugenio
comprendeva	comprenait
osservazione	observation
classifiche	classements
corea	corée
html	html
copertura	couverture
costantinopoli	constantinople
entrato	entré
larghezza	largeur
dettagli	détails
ebraica	juive
vendetta	vengeance
garibaldi	garibaldi
gian	gian
clemente	clemente
martire	martyr
martire	martyre
visse	vécut
spazi	espaces
yard	yard
yard	yards
preparazione	préparation
carolina	carolina
condannato	condamné
esperto	expert
voi	vous
cucina	cuisine
einaudi	einaudi
affidata	confiée
sepolto	enfoui
sepolto	enterré
specifica	spécifique
specifica	spécifie
costellazione	constellation
eccellenza	excellence
pieve	pieve
ideale	idéale
ideale	idéal
unite	unies
firmato	signé
sconfitte	défaites
prevedeva	prévoyait
crea	crée
castel	castel
ricordi	souvenirs
system	system
nicolas	nicolas
umanità	humanité
montana	montana
baby	baby
discesa	descente
cristina	cristina
terremoto	séisme
cemento	ciment
space	space
legale	juridique
legale	légal
ucraina	ukraine
tasso	blaireau
tasso	taux
esistente	existante
esistente	existant
kelly	kelly
sabato	samedi
occidente	occident
qualificazione	qualification
arrivato	arrivé
cause	causes
serata	soirée
agenti	agents
tastiera	clavier
conduce	mène
veicoli	véhicules
accetta	accepte
clan	clan
clan	clans
impatto	impact
gary	gary
programmazione	programmation
vicini	voisins
fattori	facteurs
bambina	bébé
diviso	divisé
dead	dead
sessuale	sexuel
sessuale	sexuelle
praga	prague
turco	turque
turco	turc
steven	steven
statue	statues
centinaia	centaines
pavia	pavie
great	great
rappresentante	représentant
tradotto	traduit
min	min
old	old
dolore	douleur
dolore	douleurs
studiare	étudier
impossibile	impossible
vissuto	vécu
wayne	wayne
accademico	universitaire
accademico	académique
gino	gino
segnale	signal
chiesto	demandé
abbandonare	abandonner
manifestazioni	manifestations
entità	entités
entità	entité
portarono	amenèrent
tensione	tension
toni	toni
toni	tons
milanese	milanaise
milanese	milanese
hamilton	hamilton
progettato	conçu
considerare	considérer
conferma	confirmez
conferma	confirmation
conferma	confirme
tradizioni	traditions
eventuale	éventuelle
danza	danse
tentativi	tentatives
sostiene	soutient
turismo	tourisme
popoli	peuples
inter	inter
chimico	chimiste
sydney	sydney
seguì	suivit
segreti	secrets
pietroburgo	pétersbourg
pietroburgo	petersbourg
vivono	vivent
magia	magie
christopher	christopher
stranieri	étrangers
stranieri	etrangers
associazioni	associations
eseguito	exécuté
patto	pacte
candidatura	candidature
finire	finir
sánchez	sánchez
river	river
drago	dragon
prato	pelouse
prato	prato
ligure	ligure
fedeli	loyaux
fedeli	fidèles
bryan	bryan
iscrizione	inscription
dubbi	doutes
conclusione	conclusion
puntate	mises
britannici	britanniques
utc	utc
utc	tuc
tecnici	techniciens
dimostrato	démontré
dimostrato	prouvé
loneos	loneos
giancarlo	giancarlo
collina	collines
collina	colline
kong	kong
contrasto	contraste
animazione	animation
recupero	récupération
recupero	recouvrement
corporation	corporation
eliminato	supprimé
eliminato	éliminé
conserva	conserve
scambio	échange
scambio	echange
gatto	chat
elettrico	électrique
elettrico	electrique
procedure	procédures
requisiti	exigences
cilindri	cylindres
ross	ross
rito	rite
densità	densité
decennio	décennie
esemplare	exemplaire
esemplare	spécimen
araldica	héraldique
miei	mes
battaglie	batailles
romeo	roméo
romeo	romeo
gold	gold
giurista	juriste
proposte	propositions
schema	schéma
his	his
corrado	corrado
vasto	vaste
iata	iata
nba	nba
clark	clark
rapper	rapper
rapper	rappeur
rapper	rappeurs
romagna	romagne
silvio	silvio
ernesto	ernesto
pacifico	pacifique
parzialmente	partiellement
adams	adams
gabriel	gabriel
amsterdam	amsterdam
treviso	treviso
treviso	trévise
esperienze	expériences
fantasy	fantasy
vocale	voyelle
polo	polo
polo	pôle
indice	index
castelli	châteaux
tetto	toit
tetto	toiture
here	here
pier	pier
teologo	théologien
recuperare	rattraper
recuperare	récupérer
moderni	modernes
florida	floride
utili	utiles
tenne	tint
playoff	playoffs
playoff	éliminatoires
vuoto	vide
gilbert	gilbert
soccorso	secours
stabile	stable
detective	détective
detective	détectives
rappresentata	représentée
friuli	frioul
bell	bell
ingegneria	ingénierie
vincent	vincent
sound	sound
juventus	juventus
miliardi	milliards
ordinato	triés
ordinato	ordonné
ordinato	commandé
giovanna	giovanna
giovanna	jeanne
cile	chili
diventata	devenue
realizzate	réalisées
individui	individus
killer	killer
eddie	eddie
ettore	ettore
ettore	dictatorial
ceduto	cédé
emisfero	hémisphère
wikimedia	wikimedia
spagnoli	espagnols
morta	morte
progettazione	conception
maschio	mâle
maschio	masculin
rappresentano	représentent
sostituire	remplacez
sostituire	remplacer
nucleare	nucléaire
fumo	fumée
fumo	tabagisme
bellezza	beauté
terme	thermes
indipendenti	indépendants
indipendenti	indépendantes
disegnato	dessiné
confermato	confirmé
confermato	confirmée
lupo	loup
presidenza	présidence
silva	silva
letteralmente	littéralement
bolla	bulle
coinvolto	impliqué
drammaturgo	dramaturge
teorie	théories
aggiunte	ajouts
vigore	vigueur
finlandia	finlande
ferito	blessé
villaggi	villages
modificato	modifié
esistenti	existantes
esistenti	existants
dicendo	disant
law	law
sviluppa	développe
phil	phil
nino	nino
cambiamento	changement
flusso	flux
invito	invitation
columbia	columbia
editoriale	éditorial
editoriale	editorial
notevoli	remarquables
mattina	matin
minuto	minute
miglia	milles
pictures	pictures
grant	grant
situazioni	situations
book	book
dover	dover
dover	douvres
novara	novare
cambiamenti	changements
ritrova	retrouve
minor	minor
guy	guy
olimpico	olympique
democrazia	démocratie
professionale	professionnelle
scoprire	découvrir
miguel	miguel
indagini	enquêtes
indirizzo	adresse
disc	disc
jerry	jerry
moda	mode
richiede	nécessite
richiede	requiert
ridurre	réduire
raymond	raymond
vite	vies
fenomeni	phénomènes
prototipo	prototype
allievo	élève
hard	hard
rosario	chapelet
rosario	rosario
rosario	rosaire
presentazione	présentation
presentazione	diaporama
assalto	assaut
professione	profession
virus	virus
conquistare	conquérir
audio	audio
samuel	samuel
applicazioni	applications
carter	carter
junior	junior
server	serveurs
server	serveur
bassista	bassiste
carne	viande
cantata	chantée
pesci	poissons
corrisponde	correspond
esilio	bannissement
esilio	exil
lisa	lisa
criterio	critère
sconosciuto	inconnu
rick	rick
robot	robot
robot	robots
bobby	bobby
momenti	moments
stewart	stewart
saggista	essayiste
aragona	aragon
fiore	fleur
sorpresa	surprise
costantino	constantin
promozionale	promotionnelle
guidato	guidé
definire	définir
merci	marchandises
decorazioni	décorations
determinato	déterminé
soldato	soldat
sintesi	synthèse
ispirazione	inspiration
conseguenze	conséquences
botanico	botaniste
sostenere	soutenir
bay	bay
ridotta	réduite
astronomo	astronome
testimonianza	témoignage
celeste	celeste
celeste	céleste
stabilito	établi
acquisto	achat
woman	woman
assunta	assunta
assunta	embauchée
was	was
lucas	lucas
effettuato	effectué
sarah	sarah
affresco	fresque
calendario	calendrier
barry	barry
ball	ball
potenti	puissants
potenti	puissantes
laterale	latéral
dedicò	dédia
bit	bit
bit	bits
adattamento	adaptation
mitologia	mythologie
herbert	herbert
riga	riga
piacenza	piacenza
grigio	gris
grigio	grise
classici	classiques
corto	court
botswana	botswana
bello	beau
bloccato	verrouillé
bloccato	coincé
bloccato	bloqué
pistola	flingue
pistola	pistolet
nonno	papy
binari	binaires
queen	queen
norman	norman
colpa	culpabilité
colpa	blâme
perù	pérou
fallimento	faillite
fallimento	échec
fallimento	echec
specifiche	spécifiques
specifiche	spécifications
specifiche	specs
tenore	ténor
tenore	teneur
fedele	fidèle
taranto	tarente
juniores	juniors
pianura	plaine
fornisce	fournit
nelson	nelson
misto	mixte
atteggiamento	attitude
obiettivi	objectifs
donato	donato
donato	donné
dichiarò	déclara
vapore	vapeur
diventò	devint
parker	parker
assistenza	assistance
filo	fil
proteggere	protéger
conquistato	conquis
ian	ian
cugino	cousin
tesoro	chéri
tesoro	chérie
tesoro	trésor
armati	armés
mba	mba
sponsor	sponsors
sponsor	sponsor
scegliere	choisir
profondo	profond
profondo	profonde
may	may
morgan	morgan
limitato	limité
assumere	embaucher
coppie	couples
coppie	paires
ita	ita
paradiso	paradis
margine	marge
spettacoli	spectacles
cronaca	chronique
light	light
citazione	citation
deserto	désert
raggiungendo	atteignant
comico	comédien
comico	comique
bizantino	byzantin
spese	dépenses
accettare	accepter
lavorazione	usinage
malattie	maladies
eseguita	exécutée
atmosfera	atmosphère
cat	cat
catturato	capturé
gene	gène
gene	gene
lucca	lucques
lucca	lucca
formano	forment
corriere	coursier
differente	différente
differente	différent
incendio	incendie
udine	udine
over	over
prossimità	proximité
pov	pov
terry	terry
probabilità	probabilités
probabilità	probabilité
riprende	reprend
girls	girls
colombo	colomb
colombo	colombo
colombo	columbo
playstation	playstation
simboli	symboles
raramente	rarement
bowl	bowl
bowl	bowls
abbandono	abandon
parlato	parlé
sostanze	substances
dovevano	devaient
positivo	positive
positivo	positif
decorazione	décoration
fiorentina	florentine
dovrebbero	devraient
scrittori	écrivains
cattolici	catholiques
prendendo	prenant
circolare	circuler
circolare	circulaire
pag	pag
hitler	hitler
arresto	arrestation
austriaca	autrichienne
decidono	décident
costruiti	construits
organizzazioni	organisations
cross	cross
sorelle	soeurs
sorelle	sœurs
studiato	étudié
studiato	étudiée
completato	accompli
completato	terminé
completato	achevé
completato	complété
neve	neige
ruote	roues
asti	asti
ravenna	ravenne
ravenna	ravenna
vaticano	vaticano
vaticano	vatican
calibro	calibre
rango	rango
rango	rang
approccio	approche
stima	estimation
scienziato	scientifique
fire	fire
pazienti	patients
armato	armé
messaggi	messages
distruggere	détruire
passati	passés
marshall	marshall
uffici	bureaux
righe	lignes
scultura	sculpture
varese	varèse
varese	varese
parlando	parlant
inferno	enfer
risoluzione	résolution
commenti	commentaires
saggi	sages
freddo	froid
stanley	stanley
pino	pino
onde	vagues
das	das
dea	dea
dea	déesse
dario	dario
avversari	adversaires
dipende	dépend
femmina	femelle
lloyd	lloyd
bruxelles	bruxelles
moon	moon
budapest	budapest
aviazione	aviation
necessari	nécessaires
larry	larry
puglia	puglia
puglia	pouilles
puglia	pouille
philip	philip
adottato	adopté
finito	fini
inaugurato	inauguré
motivazioni	motivations
pubblicità	publicité
impegnato	engagé
demo	demo
demo	démo
demo	démos
more	more
occupato	occupé
occupato	occupée
mito	mythe
testimonianze	témoignages
marine	marine
radici	racines
ella	ella
bolzano	bolzano
creando	créant
jay	jay
vietnam	vietnam
diavolo	diable
tommy	tommy
seguita	suivie
round	round
colombia	colombie
dichiarazione	déclaration
georgia	géorgie
rowspan	rowspan
esperti	experts
lombardo	lombardo
ann	ann
signori	messieurs
ginevra	geneve
ginevra	genève
serbo	serbe
difendere	défendre
god	god
games	games
architetture	architectures
denti	dents
equilibrio	équilibre
equilibrio	equilibre
continente	continent
tipicamente	typiquement
attribuito	attribué
attribuito	attribuée
side	side
iniziare	commencer
archeologico	archéologique
luisa	luisa
veicolo	véhicule
insetti	insectes
isabella	isabella
sviluppare	développer
scudetto	scudetto
medie	moyennes
duo	duo
lawrence	lawrence
cristianesimo	christianisme
costumi	costumes
calciatori	footballeurs
times	times
pablo	pablo
patriota	patriote
venerdì	vendredi
sviluppata	développée
episcopale	épiscopale
episcopale	épiscopal
gallo	coq
gallo	gaulois
gallo	gallo
accompagnato	accompagné
cacciatorpediniere	destroyers
cacciatorpediniere	destroyer
messicano	mexicain
messicano	mexicaine
richiesto	exigé
richiesto	demandé
richiesto	requis
mail	mail
stuart	stuart
familiare	familier
scudo	bouclier
precisione	précision
vedova	veuve
curva	courbe
angel	angel
scaduto	périmé
scaduto	expiré
manchester	manchester
marche	marches
get	get
memorie	mémoires
russi	russes
mariano	mariano
gonzaga	gonzaga
visconti	visconti
when	when
meccanismo	mécanisme
esteri	esters
pagamento	paiement
arrivati	arrivés
todd	todd
profonda	profonde
lost	lost
testamento	testament
ricevere	recevoir
paesaggio	paysage
gonzález	gonzález
tracciato	tracé
tracciato	tracer
produzioni	productions
potenziale	potentielle
potenziale	potentiel
ibn	ibn
anton	anton
soluzioni	solutions
cena	dîner
cena	diner
sebastiano	sébastien
sebastiano	sebastiano
rurale	rural
rurale	rurale
viaggi	voyages
ospiti	invités
giornate	journées
distrutta	détruite
victoria	victoria
volley	volley
entertainment	entertainment
ebraico	hébreu
ebraico	hébreux
musei	musées
lire	lires
wilhelm	wilhelm
coscienza	conscience
alfa	alpha
alfa	alfa
siracusa	syracuse
tipici	typiques
baia	baie
blocchi	blocs
produttori	producteurs
aosta	aoste
aosta	aosta
interessato	interessé
interessato	intéressé
country	country
tito	titus
tito	tito
nfl	nfl
attaccare	attaquer
frammenti	fragments
spirituale	spirituelle
spirituale	spirituel
monaci	moines
superato	dépassé
erba	herbe
convocato	convoqué
apparentemente	apparemment
frazioni	fractions
frazioni	hameaux
metallo	métal
raggi	rayons
tende	tentes
tende	rideaux
lecce	lecce
dottrina	doctrine
microsoft	microsoft
ritirò	retira
denis	denis
lópez	lópez
retrocessione	rétrocession
retrocessione	rétrogradation
dream	dream
offensiva	offensive
conference	conference
benjamin	benjamin
finestre	fenêtres
fattore	facteur
permettono	permettent
barocco	baroque
temporale	orage
temporale	temporelle
marvel	marvel
adulti	adultes
adulti	adulte
decidere	décider
anonimo	anonyme
danny	danny
foreste	forêts
grazia	grâce
grazia	grazia
gay	gays
gay	gay
armando	armando
roccia	roche
roccia	rocher
finestra	fenêtre
finestra	vitre
undici	onze
editori	editeurs
editori	éditeurs
eredità	legs
eredità	hérédité
eredità	héritage
funzionamento	fonctionnement
paziente	patiente
paziente	patient
dramma	drame
ron	ron
fotografo	photographe
permanente	permanente
permanente	permanent
corretta	correcte
broadway	broadway
sostenuto	soutenu
cannone	canon
lezioni	leçons
camillo	camillo
serra	serre
residenti	résidents
ministri	ministres
hong	hong
dottore	docteur
ville	villas
passaggi	passages
risalgono	remontent
domande	questions
miami	miami
fossili	fossiles
monza	monza
franchi	francs
opportunità	opportunités
opportunità	opportunité
reno	rhin
reno	reno
uova	œufs
uova	oeufs
dimostrare	prouver
dimostrare	démontrer
sostituita	remplacée
name	name
estremo	extrême
rappresentare	représenter
taglio	découpe
taglio	coupe
permise	permit
fondatori	fondateurs
arabi	arabes
harris	harris
convenzione	convention
emma	emma
jon	jon
track	track
wright	wright
sportivi	sportifs
garcía	garcía
maestri	maîtres
giunti	joints
giunti	accouplements
universal	universal
calore	chaleur
cratere	cratère
cooper	cooper
perfettamente	parfaitement
libretto	livret
wars	wars
collo	nuque
collo	cou
rotazione	rotation
settori	secteurs
soprano	soprano
soprano	sopranos
albanese	albanaise
albanese	albanais
popolarità	popularité
logica	logique
grotta	grotte
segnato	marqué
commons	commons
monica	monica
let	let
murray	murray
dino	dino
draft	draft
viva	viva
viva	vivante
viva	vive
indicata	indiqué
indicata	indiquée
scoppio	éclatement
borbone	bourbons
canton	canton
costruite	construites
teologia	théologie
nate	nate
antichità	antiquités
antichità	antiquité
walker	walker
consumo	consommation
satellite	satellite
valido	valide
valido	valable
farà	fera
rimini	rimini
martina	martine
martina	martina
academy	academy
novità	nouveauté
novità	nouveautés
percentuale	pourcentage
mussolini	mussolini
css	css
opposto	opposé
fantasma	fantôme
greg	greg
assist	assist
stadium	stadium
survey	survey
compiti	tâches
compiti	devoirs
warner	warner
spezia	épice
municipio	mairie
conosciuti	connus
malta	malte
valli	vallées
valli	valli
metro	mètre
volontari	volontaires
volontari	bénévoles
temperature	températures
mtv	mtv
patriarca	patriarche
parentesi	parenthèses
parentesi	parenthèse
scavi	excavation
scavi	fouilles
donald	donald
dialogo	dialogue
pubblicate	publiées
second	second
vladimir	vladimir
esploratore	exploratrice
esploratore	éclaireur
esploratore	explorateur
sex	sex
coalizione	coalition
maschera	masque
classificato	classifié
detti	dits
condanna	condamne
condanna	condamnation
galles	galles
matrice	matrice
maría	maría
inclusa	incluse
dettaglio	détail
legione	légion
dean	dean
mount	mount
calcolo	calcul
mostro	monstre
ribelli	rebelles
dispositivo	dispositif
associato	associé
scuro	foncée
scuro	foncé
gravemente	gravement
austin	austin
liquido	liquide
stefan	stefan
massiccio	massif
romane	romaines
sperimentale	expérimental
sperimentale	expérimentale
wrestler	catcheurs
wrestler	catcheur
campbell	campbell
salita	montée
regolamento	règlement
margaret	margaret
amato	aimé
amato	amato
feudo	fief
rizzoli	rizzoli
assassino	tueur
assassino	assassin
assassino	meurtrier
radicale	radical
radicale	radicale
decine	dizaines
mac	mac
notato	remarqué
capitoli	chapitres
spiaggia	plage
rosse	rousses
rosse	rouges
aka	aka
informatica	informatique
nobiltà	noblesse
divina	divine
omaggio	hommage
municipalità	municipalité
municipalità	municipalités
ruota	roue
castiglia	castille
tessuto	tissu
rifiutò	refusa
nascosto	caché
sentimenti	sentiments
vetro	verre
soul	soul
verificare	vérifier
troviamo	trouvons
fifa	fifa
privati	privés
occupata	occupée
giardini	jardins
dna	adn
affermazione	affirmation
renzo	renzo
appaiono	apparaissent
ring	ring
georg	georg
valerio	valerio
debole	faible
mistero	mystère
maresciallo	maréchal
newton	newtons
newton	newton
revisione	révision
palla	balle
palla	boulet
how	how
sessione	session
messi	messi
tentò	tenta
garantire	garantir
individuo	individu
variazioni	variations
ordinò	ordonna
feriti	blessés
uccisi	tués
democratica	démocratique
studente	étudiant
studente	etudiant
astenuti	abstentions
discipline	disciplines
podio	podium
trazione	traction
carabinieri	carabiniers
family	family
verifica	vérification
divennero	devinrent
litri	litres
quaranta	quaranta
quaranta	quarante
graham	graham
people	people
segnò	marqua
comparsa	figurante
rené	rené
sfera	sphère
sfera	boule
sfera	orbe
profondamente	profondément
sara	sara
milita	milite
nati	nés
valutare	évaluer
impedire	empêcher
raccogliere	recueillir
raccogliere	collecter
single	célibataires
ama	aime
ama	ama
disambigua	homonymie
porzione	portion
diana	diana
bbc	bbc
rivale	rival
rivale	rivale
cupola	coupole
prossimo	prochain
prossimo	prochaine
airlines	airlines
accusato	inculpé
accusato	accusé
principato	principauté
orlando	orlando
ralph	ralph
liberi	libérez
liberi	libres
ambasciatore	ambassadeur
accordi	accords
platino	platine
contribuito	contribué
filippine	philippines
toronto	toronto
pseudonimo	pseudonyme
ppa	ppa
automaticamente	automatiquement
fascismo	fascisme
hugo	hugo
pagare	payer
riuscire	réussir
nuoto	nage
nuoto	natation
angela	angela
angela	angèle
osservazioni	remarques
osservazioni	observations
cattura	capturer
cattura	capture
zampe	pattes
archeologici	archéologiques
neil	neil
attraversa	traverse
billboard	billboard
equivalente	équivalente
equivalente	equivalent
equivalente	équivalent
appartenenza	appartenance
lorena	lorena
ripreso	repris
artificiale	artificiels
artificiale	artificiel
artificiale	artificielle
scorta	escorte
orientamento	orientation
guide	guides
caduti	déchus
sovrani	souverains
dibattito	débat
fiction	fictions
fiction	fiction
esplosione	explosion
jersey	jersey
introdotta	introduite
elio	hélium
elio	elio
economista	économiste
meta	meta
meta	méta
sindrome	syndrome
youtube	youtube
just	just
passata	passée
inciso	piraté
inciso	gravé
inciso	entaillé
dimissioni	démission
dimissioni	démissions
quartieri	quartiers
gianfranco	gianfranco
asburgo	habsbourg
trattati	traités
seminario	séminaire
dichiara	déclare
rami	branches
rami	rami
rifiuta	refuse
fonda	fonda
configurazione	configuration
configurazione	configurer
achille	achille
cita	cite
gioventù	jeunesse
lettore	lecteur
composizioni	compositions
now	now
acustica	acoustique
nazista	nazie
nazista	nazi
coraggio	courage
nova	nova
casale	casale
cattivo	méchant
cattivo	vilain
cattivo	mauvais
chan	chan
lanciato	lancé
mostrato	montré
pozzo	puits
aggiunge	ajoute
diario	journal
crescente	croissant
crescente	croissante
buono	bon
integrale	intégral
integrale	intégrale
legislatura	législature
arnold	arnold
forum	forums
forum	forum
three	three
dennis	dennis
trio	trio
separazione	séparation
seguono	suivent
spiegare	expliquer
considerando	considérant
serbia	serbie
dilettanti	amateurs
dilettanti	amateur
ottenuta	obtenue
gestire	gérer
beato	bienheureux
sandro	sandro
essenzialmente	essentiellement
cade	cade
sentire	sentir
carro	wagon
derby	derby
formati	formats
contessa	contessa
contessa	comtesse
professionisti	professionnels
tonnellate	tonnes
alimentazione	alimentation
ted	ted
mercedes	mercedes
risponde	répond
delta	delta
cancellato	effacé
colonie	colonies
only	only
provare	essayer
provare	essayez
batman	batman
claudia	claudia
neo	neo
neo	néo
creature	créatures
futura	future
arturo	arturo
ernst	ernst
marcel	marcel
cassa	caisse
organizzare	organiser
inaugurata	inaugurée
trasformato	transformé
veri	vrais
eduardo	eduardo
martín	martín
chiamate	appels
anniversario	anniversaire
perry	perry
piacere	plaisir
wwe	wwe
vedono	voient
contatti	contacts
silenzio	silence
bilancio	budget
vicario	vicaire
sceriffo	sheriff
sceriffo	shérif
bobina	bobine
riconosciuta	reconnue
ottavo	huitième
credere	croire
campania	campanie
campania	campania
stretta	étroite
alessio	alessio
arcipelago	archipel
blood	blood
poveri	pauvres
sea	sea
salva	sauve
salva	sauvegarder
salva	enregistrer
maddalena	maddalena
tecnologie	technologies
usano	utilisent
prossima	prochaine
presentò	présenta
rodolfo	rodolfo
rodolfo	rodolphe
croato	croate
busto	torse
busto	buste
nintendo	nintendo
versante	versant
supercoppa	supercoupe
negozio	magasin
colleghi	collègues
verticale	verticalement
verticale	vertical
verticale	verticale
autonomo	autonome
sorgente	source
extra	extras
extra	extra
cremona	crémone
cremona	cremona
jacopo	jacopo
terzi	tiers
spinta	poussée
indagine	enquête
strano	étrange
strano	bizarre
strano	etrange
infrastrutture	infrastructures
terapia	thérapie
pete	pete
janeiro	janeiro
guerrieri	guerriers
insegna	enseigne
registrazioni	enregistrements
luke	luke
schiavi	esclaves
prigioniero	captif
prigioniero	prisonnier
amministratori	administrateurs
harold	harold
curiosità	curiosités
curiosità	curiosité
robinson	robinson
matthew	matthew
radar	radar
complessi	complexes
dedica	dédicace
penale	pénale
guinea	guinée
baker	baker
visti	visas
tragedia	tragédie
alternative	alternatives
registrati	enregistrés
curato	soigné
conobbe	connut
cadere	tomber
ottavi	huitièmes
leggero	léger
rocce	roches
dallas	dallas
mitchell	mitchell
mitchell	mitchel
den	den
monumentale	monumental
monumentale	monumentale
colin	colin
preliminare	préliminaire
heinrich	heinrich
presero	prirent
milione	million
negativo	négatif
rally	rallyes
rally	rallye
perfetto	parfait
laghi	lacs
borsa	sac
borsa	bourse
riserve	réserves
army	army
declino	déclin
rimozione	enlèvement
ispettore	inspecteur
strategia	stratégie
conservata	conservée
normali	normales
normali	normaux
fidanzata	fiancée
bomba	bombe
uccello	oiseau
flavio	flavio
flavio	flavius
intensità	intensité
discografia	discographie
deposito	dépôt
salone	salon
core	core
jugoslavia	yougoslavie
abside	abside
venere	venere
venere	vénus
creò	créa
tempesta	tempête
brillante	brillante
battle	battle
adige	adige
violazione	violation
proseguire	poursuivre
pala	retable
pala	pelle
apparso	apparu
trentino	trentin
trentino	trentino
buone	bonnes
trasferirsi	déménager
never	never
quindici	quinze
pat	pat
pioggia	pluie
caldo	chaud
caldo	chaude
straniero	étranger
stagionale	saisonnier
stagionale	saisonnière
teorema	théorème
zurigo	zürich
zurigo	zurich
panchina	banc
pubblicare	publier
citare	citer
turchi	turques
turchi	turcs
impiegati	employés
days	days
volere	vouloir
croazia	croatie
mari	mers
mari	mari
corti	courts
processione	procession
fiorentino	florentin
fiorentino	fiorentino
determinare	déterminer
anelli	bagues
anelli	anneaux
tendenza	tendance
usi	employez
usi	utilisations
autostrada	autoroute
magistrato	magistrat
bot	bots
bot	bot
ponti	ponts
equazione	équation
rita	rita
canta	chante
causato	causé
divide	divise
massimiliano	massimiliano
massimiliano	maximilien
sebastian	sebastian
apollo	apollo
apollo	apollon
silver	silver
regolarmente	régulièrement
flauto	flûte
bibbia	bible
bibbia	biblique
ludwig	ludwig
forlì	forlì
forlì	forli
thompson	thompson
contadini	paysans
strato	couche
rottura	rupture
binario	binaire
cortile	cour
giordano	giordano
giordano	jourdain
giordano	jordanien
have	have
project	project
griffith	griffith
competenza	compétence
avvento	avent
avvento	avènement
ecclesiastica	ecclésiastique
costume	costume
sentiero	sentier
frasi	phrases
cervello	cerveau
animata	animée
inseguimento	poursuite
necessariamente	nécessairement
spostamento	déplacement
grandezza	grandeur
concesso	accordé
concesso	accordée
abruzzo	abruzzes
abruzzo	abruzzo
combattimenti	combats
attribuita	attribuée
archeologo	archéologue
fila	rangée
peccato	dommage
peccato	péché
descritta	décrite
caratteristico	caractéristique
sconfisse	vainquit
dimesso	démissionné
citazioni	citations
valley	valley
organismo	organisme
dite	dites
esecutivo	exécutif
hunter	hunter
diresse	dirigea
genovese	génoise
genovese	genovese
boris	boris
linguistica	linguistique
nastro	ruban
ritornare	revenir
proprietari	propriétaires
info	info
info	infos
latte	lait
biennale	biennal
biennale	biennale
conoscenze	connaissances
albania	albanie
pechino	pékin
pechino	beijing
compilation	compilations
jorge	jorge
pescara	pescara
iran	iran
messe	messes
delitto	crime
diploma	diplôme
joan	joan
conversione	conversion
immaginario	imaginaire
parlano	parlent
annullata	annulée
augusta	augsbourg
augusta	augusta
serena	sereine
serena	serena
costretti	contraints
segreta	secrète
intervenire	intervenir
dedicati	dédiées
dedicati	dédiés
piana	plate
piana	plane
costituzionale	constitutionnelle
costituzionale	constitutionnel
provato	essayé
ospitato	hébergé
ospitato	accueilli
partner	partenaire
partner	partenaires
fiera	foire
telaio	châssis
verranno	viendront
viaggiatori	voyageurs
apparizioni	apparitions
discendenti	descendants
andreas	andreas
andreas	andréas
abbandonata	abandonnée
ristrutturazione	restructuration
decisero	décidèrent
secret	secret
lama	lama
lama	lame
particelle	particules
regni	royaumes
sviluppò	développa
antoine	antoine
oscuro	obscur
anziano	âgé
field	field
sogni	rêves
apostolica	apostolique
guerriero	guerrière
guerriero	guerrier
indicano	indiquent
siria	syrie
concluso	conclu
sottile	subtil
sottile	mince
collegato	relié
bombardamento	bombardement
contenere	contenir
rigore	penalty
rigore	rigueur
permettendo	permettant
slam	slam
slam	chelem
julie	julie
istruzioni	instructions
alleato	allié
alleato	alliée
mobili	meubles
esprimere	exprimer
hip	hip
contengono	contiennent
she	she
traduttore	traducteur
rivelato	révélé
rivelato	révélée
accuse	accusations
summer	summer
preferito	préféré
preferito	préférée
preferito	favori
preferito	préférés
osservare	observer
mal	mal
touchdown	touchdown
touchdown	touchdowns
detroit	detroit
ritmo	rythme
iniziali	initiales
comunicazioni	communications
collaborare	coopérer
collaborare	collaborer
lugano	lugano
corrispondenti	correspondants
inventore	inventeur
japan	japan
prosa	prose
prendono	prennent
formale	formel
formale	formelle
stoccolma	stockholm
simpson	simpson
invernale	hivernale
kennedy	kennedy
prussia	prusse
appartengono	appartiennent
persa	perdue
leonard	leonard
cruz	cruz
ottenuti	obtenus
dispositivi	dispositifs
statuto	statut
statuto	statuts
miglioramento	amélioration
cadenza	cadence
vuelta	vuelta
rivoluzionario	révolutionnaire
scacchi	échecs
scacchi	echecs
consegna	livraison
formalmente	formellement
amedeo	amédée
amedeo	amedeo
qualificata	qualifiée
missili	missiles
soprannome	surnom
take	take
derivato	dérivé
vitale	vitale
vitale	vital
talento	talentueux
talento	talent
operare	opérer
liguria	ligurie
liguria	liguria
varsavia	varsovie
marocco	maroc
compagna	compagne
preghiera	prière
interprete	interprète
primarie	primaires
conflitti	conflits
autorizzazione	autorisation
iniziative	initiatives
evans	evans
riproduzione	reproduction
completata	complétée
completata	terminée
there	there
nudo	nu
integrazione	intégration
pane	pain
diventano	deviennent
laureato	diplômé
possedeva	possédait
mini	mini
pittori	peintres
kate	kate
parrocchie	paroisses
allenatori	entraîneurs
allenatori	entraineurs
duro	dur
head	head
dos	dos
dos	dhs
esteso	étendu
houston	houston
compone	compose
compone	composent
rob	rob
amichevole	amicale
amichevole	convivial
amichevole	amical
andava	allait
emergenza	urgence
susan	susan
suona	sonne
ottomano	ottoman
amy	amy
distinzione	distinction
jennifer	jennifer
mayer	mayer
potter	potter
nancy	nancy
indicazioni	indications
droga	drogue
iraq	irak
iraq	iraq
liberale	libéral
liberale	libérale
foggia	foggia
piatto	assiette
piatto	plat
doppiaggio	doublage
mostrano	montrent
sapore	saveur
sapore	goût
utilizzano	utilisent
prospettiva	perspective
arrondissement	arrondissement
redazione	rédaction
sean	sean
opinioni	opinions
piemontese	piémontaise
atlantico	atlantique
leopoldo	leopoldo
continentale	continentale
cuba	cuba
correnti	courants
cella	cellule
completare	compléter
risalire	remonter
sol	sol
modificata	modifiée
procedere	procéder
bombe	bombes
qualificato	qualifié
mulino	moulin
michelangelo	michelangelo
religioni	religions
century	century
funziona	fonctionne
mantiene	maintient
pronuncia	prononciation
pronuncia	prononcer
her	her
future	futures
parametro	paramètre
martini	martini
mezza	demie
ricchi	riches
manutenzione	entretien
manutenzione	maintenance
pratiche	pratiques
riconoscere	reconnaître
significativo	significatif
justin	justin
about	about
volle	voulut
concentrazione	concentration
mamma	maman
chuck	chuck
sassofono	saxophone
mira	mira
gioia	joie
locomotive	locomotives
betty	betty
specchio	miroir
utilità	utilitaires
utilità	utilitaire
utilità	utilité
warren	warren
lineare	linéaire
positiva	positive
cittadinanza	citoyenneté
trovavano	trouvaient
tono	tonalité
collins	collins
rame	cuivre
pianeti	planètes
kurt	kurt
accreditato	accrédité
includono	incluent
prolungata	prolongée
bulgaria	bulgarie
fucile	fusil
fucile	carabine
settimanale	hebdomadaire
falso	faux
carmine	carmine
cattedra	chaire
supera	dépasse
supera	surpasse
difese	défenses
riprendere	reprendre
letterato	lettré
registrata	enregistrée
risposte	réponses
dylan	dylan
promessa	promise
promessa	promesse
tentato	tenté
facevano	faisaient
discendente	décroissant
discendente	descendante
discendente	descendant
concetti	concepts
decisioni	décisions
delegazione	délégation
reazioni	réactions
farina	farine
telefono	téléphone
tredici	treize
arezzo	arezzo
racing	racing
rimbalzi	rebonds
trasformata	transformée
lisbona	lisbonne
assente	absent
assente	absente
disegnatore	dessinateur
apple	apple
keith	keith
doc	doc
scoperte	découvertes
segnalato	signalé
segnalato	rapporté
attentato	attentat
port	portages
pugile	boxeur
amburgo	hambourg
convincere	convaincre
coperto	couvert
organizza	organise
confusione	confusion
rivelò	révéla
cantanti	chanteurs
cantanti	chanteuses
candidati	candidats
kansas	kansas
grosseto	grosseto
stars	stars
adozione	adoption
trent	trent
vogliono	veulent
registi	cinéastes
promossa	promue
bagno	bain
scherma	escrime
guardie	gardes
fornito	fourni
dir	dir
incontrano	rencontrent
improvvisamente	soudainement
improvvisamente	soudain
vecchie	vieilles
concorrenti	concurrents
nodi	noeuds
nodi	nœuds
storicamente	historiquement
schede	onglets
download	téléchargements
ricardo	ricardo
beatrice	beatrice
beatrice	béatrice
tradizionalmente	traditionnellement
assegnati	assignés
caffè	cafés
caffè	café
giurisprudenza	jurisprudence
bonaparte	bonaparte
wolf	wolf
potenze	puissances
goal	goal
goal	but
conduttrice	présentatrice
ossigeno	oxygène
variabili	variables
raggiunta	atteinte
nizza	nice
imperiali	impériaux
carbonio	carbone
agire	agir
attaccato	attaqué
edwards	edwards
canna	canne
canna	roseau
alfabeto	alphabet
esposto	exposé
indicazione	indication
lione	lyon
helen	helen
eliminata	éliminée
integrare	intégrer
gamba	jambe
montaggio	montage
continuità	continuité
cifra	chiffre
cifra	chiffrer
islam	islam
inc	inc
attivista	militant
attivista	militante
attivista	activiste
creatura	créature
vestito	robe
blake	blake
pietà	pitié
ercole	hercule
apparire	apparaître
minerale	minerai
minerale	minéral
austro	austro
são	são
approvazione	approbation
cronache	chroniques
austriaci	autrichiens
polvere	poudre
polvere	poussière
model	model
franklin	franklin
nicolò	nicolò
trasforma	transforme
sony	sony
serial	serial
mago	mage
mago	magicien
luci	lumières
galassia	galaxie
cani	chiens
primato	primauté
primato	primat
destinazione	destination
harrison	harrisson
harrison	harrison
guidati	guidés
dialetti	dialectes
unita	unie
combinazione	combinaison
magic	magic
obbligo	obligation
frequentato	fréquenté
gianluca	gianluca
sculture	sculptures
restano	restent
blog	blog
blog	blogs
cronometro	chronomètre
rafael	rafaël
rafael	rafael
proteine	protéines
venezuela	venezuela
pose	poses
charlotte	charlotte
congo	congo
decimo	dixième
ram	ram
prefetto	préfet
domani	demain
trasformazioni	transformations
león	león
studioso	érudit
studioso	studieux
operatore	exploitant
operatore	opérateur
scioglimento	dissolution
roland	roland
farmaci	médicaments
parallelo	parallèle
assassinio	assassinat
supremo	suprême
rinascimento	renaissance
poliziotto	flic
poliziotto	policier
inno	hymne
andrej	andreï
andrej	andréi
giudici	juges
sat	sat
major	majors
major	major
classic	classic
linda	linda
fisso	fixe
giuria	jury
giuria	jurés
eredi	héritiers
roll	roll
olivier	olivier
voli	vols
strega	sorcière
eccetto	excepté
presentare	présenter
normandia	normandie
benevento	bénévent
vere	vraies
tradimento	traîtrise
tradimento	trahison
spiegato	expliqué
aumenta	augmente
maglie	mailles
maglie	maillots
brasiliana	brésilienne
innamorato	amoureux
scomparso	disparu
correttamente	correctement
franca	franca
franca	franche
demone	démon
scale	escaliers
scale	échelles
delegato	délégué
fernández	fernández
earth	earth
pastore	berger
pastore	pasteur
bernardino	bernardino
inediti	inédits
designer	designer
designer	designers
fidanzato	fiancé
turner	turner
farmaco	médicament
cerchio	cercle
cerchio	jante
volante	volant
spencer	spencer
modulo	module
modulo	formulaire
clinica	clinique
cellulare	cellulaire
khan	khan
scandalo	scandale
sintomi	symptômes
dintorni	environs
dintorni	alentours
url	url
url	urls
annata	millésime
tipologie	typologies
flash	flash
express	express
progressivamente	progressivement
decorato	décoré
strage	tuerie
pennsylvania	pennsylvanie
rumeno	roumaine
rumeno	roumain
carmen	carmen
padri	pères
goffredo	godefroy
wood	wood
giurisdizione	juridiction
spider	spider
spiegazione	explication
sbarco	débarquement
caroline	caroline
tromba	trompette
tromba	clairon
trapani	trapani
unici	uniques
riportati	reportés
composte	composées
intelligenza	intelligence
lunedì	lundi
johan	johan
cantiere	chantier
testata	ogive
testata	testée
ricci	bouclés
ricci	ricci
sovietici	soviets
sovietici	soviétiques
bloccare	verrouiller
stan	stan
esperimento	expérience
mostre	expositions
ballerina	danseuse
ballerina	ballerine
siciliana	sicilienne
impegnati	engagés
ordinamento	tri
brad	brad
accettato	accepté
cuneo	cuneo
cuneo	coni
orecchie	oreilles
apparve	apparut
roberts	roberts
preda	proies
preda	proie
grafico	graphique
atlanta	atlanta
radice	racine
giornalisti	journalistes
avvio	démarrage
belgrado	belgrade
sposata	mariée
cominciarono	commencèrent
savona	savone
savona	savona
heavy	heavy
osservatorio	observatoire
misterioso	mystérieux
influenze	affects
influenze	influences
rapido	rapido
notorietà	notoriété
prefazione	préface
salvador	salvador
propaganda	propagande
odio	haine
christmas	christmas
influenzato	influencé
ricchezza	richesse
ricchezza	richesses
rifiuto	refus
contribuì	contribua
hills	hills
deep	deep
domini	domaines
liverpool	liverpool
precisa	précise
gestito	géré
fotografie	photographies
contrada	contrada
panni	chiffons
suoni	sons
venduti	vendus
venduti	vendues
riconosce	reconnaît
iron	iron
musulmani	musulmans
convince	convainc
servita	servie
arcangelo	archange
quadrato	carré
riunione	réunion
shakespeare	shakespeare
mafia	mafia
crocifisso	crucifié
crocifisso	crucifix
sforzi	efforts
netto	net
conservati	conservés
erik	erik
sforzo	effort
mostri	monstres
sufficienti	suffisants
sufficienti	suffisantes
distingue	distingue
scienziati	scientifiques
recensione	examen
nobel	nobel
craig	craig
kid	kid
addio	adieu
eleonora	éléonore
crescere	grandir
crescere	croître
pavel	pavel
vegetazione	végétation
mantenuto	maintenu
lincoln	lincoln
brindisi	toast
brindisi	brindisi
armenia	arménie
incremento	incrémentation
incremento	incrément
brothers	brothers
pistoia	pistoia
primaria	primaire
creati	créés
distinti	distincts
distinti	distingués
act	act
codici	codes
costantemente	constamment
frequentemente	fréquemment
pellegrini	pèlerins
sostenitori	partisans
sostenitori	supporters
poeti	poètes
kent	kent
intenso	intensif
intenso	intense
comandi	commandes
inesistenti	inexistantes
inesistenti	inexistants
ottica	optique
liberamente	librement
baden	baden
baden	bade
propose	proposa
visibilità	visibilité
management	management
salvato	sauvé
contemporanei	contemporains
libreria	librairie
fantasia	fantaisie
pilastri	piliers
peli	pilosité
peli	poils
gotico	gothique
ward	ward
coordinate	coordonnées
risalenti	remontant
interessanti	intéressantes
interessanti	intéressants
dieta	diète
dieta	régime
gustavo	gustavo
incontrare	rencontrer
copenaghen	copenhague
cairo	cairo
cairo	caire
proporre	proposer
rovine	ruines
cercano	cherchent
other	other
sidney	sidney
registro	registre
documentazione	documentation
hermann	hermann
cap	cap
digital	digital
chitarre	guitares
dorsale	dorsale
dorsale	dorsal
tavolo	table
raccolto	moisson
raccolto	récolte
vinci	gagnez
vinci	vinci
nonna	mamie
bulgaro	bulgare
nicole	nicole
anglo	anglo
associata	associée
banco	banc
dominante	dominante
dominante	dominant
honda	honda
comportamenti	comportements
criminali	criminels
trovata	trouvée
altrove	ailleurs
parteciparono	participèrent
vela	voile
imponente	imposant
imponente	imposante
sondaggio	sondage
circoscrizione	circonscription
santos	santos
moro	maure
moro	moro
esponente	exposant
grace	grace
aiutato	aidé
alo	alo
riuscita	réussi
riuscita	réussie
beta	beta
beta	bêta
gennaro	gennaro
gennaro	genna
spostato	décalé
spostato	déplacé
valentino	valentin
valentino	valentino
liberare	libérer
ten	ten
wolfgang	wolfgang
pan	pan
create	créées
fredda	froide
nicholas	nicholas
colpire	frapper
partecipazioni	participations
sweet	sweet
drammatico	dramatique
jesse	jesse
stabilità	stabilité
sinonimo	synonyme
jessica	jessica
brooklyn	brooklyn
cilindrata	cylindrée
gesto	geste
abbandonò	abandonna
scorre	coule
wta	wta
conservatorio	conservatoire
atterraggio	atterrissage
jamie	jamie
uccise	tuées
determinata	déterminée
ambrogio	ambrogio
ambrogio	ambroise
fritz	fritz
clienti	clients
reddito	revenu
reddito	revenus
macedonia	macédoine
deutsche	deutsche
orso	ours
nativi	natifs
operai	ouvriers
contare	compter
coperta	couverte
contribuire	contribuer
esprime	exprime
cappello	casquette
cappello	chapeau
renault	renault
assoluti	absolues
assoluti	absolus
corazzata	cuirassé
chiamare	appeler
estratti	extraits
castro	castriste
castro	castro
silvia	silvia
diesel	gazole
diesel	diesel
apparteneva	appartenait
slovacchia	slovaquie
sub	sub
riflessione	réflexion
vegas	vegas
ragno	araignée
share	share
carrozzeria	carrosserie
dublino	dublin
lussemburgo	luxembourg
basati	basés
francoforte	frankfort
francoforte	francfort
inedito	inédit
quadrati	carrés
lucky	lucky
idrogeno	hydrogène
rilasciato	délivré
ottone	cuivres
ottone	laiton
diventerà	deviendra
orologio	montre
orologio	horloge
ognuna	chacune
separate	séparées
mantenuta	maintenue
disponibilità	disponibilités
disponibilità	disponibilité
tunnel	tunnel
siciliano	sicilien
bank	bank
masters	masters
ascoli	ascoli
approvata	approuvée
marrone	brun
marrone	marron
marrone	brune
ceramica	poterie
ceramica	céramique
eretto	érigé
sassari	sassari
gravità	apesanteur
gravità	pesanteur
gravità	gravité
vocali	voyelles
lentamente	lentement
responsabili	responsables
legend	legend
cleveland	cleveland
strumentale	instrumental
strumentale	instrumentale
madagascar	madagascar
hit	hit
progettata	conçue
julian	julian
collaboratore	collaborateur
collaboratore	contributeur
edgar	edgar
raffaello	raffaello
raffaello	raphaël
memorial	memorial
berlusconi	berlusconi
aurelio	aurelio
aurelio	aurelius
aurelio	aurèle
difficili	difficiles
tifosi	fans
tifosi	supporters
ucraino	ukrainien
dog	dog
ritrovato	retrouvé
franchigia	franchise
tessuti	tissus
josef	josef
martínez	martínez
finalisti	finalistes
allan	allan
mina	mina
incrociatore	croiseur
nacional	nacional
antonino	antonino
essenziale	essentiel
essenziale	essentielle
duello	duel
immediato	immédiat
leggeri	légers
coinvolti	impliqués
suicidio	suicide
carbone	charbon
credito	crédit
adriatico	adriatique
adrian	adrian
fiamme	flammes
august	august
comunisti	communistes
terribile	terrible
hell	hell
kiss	kiss
gestita	gérée
seattle	seattle
nathan	nathan
topolino	mickey
wang	wang
sedici	seize
ref	ref
anticipo	avance
philadelphia	philadelphie
philadelphia	philadelphia
levi	levi
levi	lévi
ispirata	inspirée
iscritti	inscrits
teatri	théâtres
taglia	couper
rettangolare	rectangulaire
riposo	repos
intensa	intense
laser	laser
laser	lasers
mentale	mentale
mentale	mental
allenamento	entrainement
allenamento	entraînement
ritratti	portraits
sergente	sergent
divenire	devenir
invenzione	invention
ristorante	restaurant
porti	ports
lemmon	lemmon
marchi	marques
borghese	bourgeoise
borghese	bourgeois
channel	channel
polemiche	polémiques
consentire	permettre
tentare	tenter
antologia	anthologie
ritardo	retard
cancro	cancer
louise	louise
soprannominato	surnommé
lima	lima
mostrare	montrer
cappelle	chapelles
raggiungono	atteignent
beata	bienheureuse
years	years
bis	bis
werner	werner
perfetta	parfaite
pontefice	pontife
autrice	auteure
marsiglia	marseille
into	into
presentava	présentait
prete	prêtre
marcos	marcos
cadavere	cadavre
periferia	périphérie
cranio	crâne
nono	nono
nono	neuvième
scoprono	découvrent
iscritto	inscrit
cosenza	cosenza
sguardo	regard
borgogna	bourgogne
orizzontale	horizontal
orizzontale	horizontale
catturare	capturer
assisi	assise
assisi	assisi
strati	strates
campana	cloche
campana	marelle
dicono	disent
hart	hart
frederick	frederick
tombe	tombes
studia	étudie
ricostruita	reconstruite
gambe	jambes
puro	pur
miles	miles
connessione	connexion
var	var
conoscono	connaissent
marcus	marcus
castle	castle
rappresentanza	représentation
anziani	seniors
anziani	aînés
predecessore	prédécesseur
canne	roseaux
intellettuale	intellectuelle
intellettuale	intellectuel
full	full
spot	spot
batterie	batteries
batterie	piles
minnesota	minnesota
collezioni	collections
gigi	gigi
riservato	confidentiel
riservato	réservé
manoscritto	manuscrit
jake	jake
completamento	achèvement
acronimo	acronyme
annunciò	annonça
murphy	murphy
premiato	primé
premiato	récompensé
armatura	armature
armatura	armures
armatura	armure
buio	obscurité
buio	sombre
allevamento	élevage
allevamento	elevage
statistica	statistique
laterza	laterza
aaron	aaron
jules	jules
jules	juju
navate	nefs
johannes	johannes
prestigio	prestige
munizioni	munition
munizioni	munitions
votato	voté
esisteva	existait
trionfo	triomphe
identificato	identifié
english	english
lettori	lecteurs
ohio	ohio
approvato	approuvé
organizzatore	organisateur
interpretare	interpréter
glenn	glenn
vertici	sommets
gemelli	gémeaux
gemelli	jumeaux
invitato	invité
presumibilmente	supposément
presumibilmente	prétendument
treccani	treccani
meccanico	mécanicien
lane	lane
lane	laines
trilogia	trilogie
servire	servir
abile	habile
torres	torres
ampliato	agrandi
ampliato	élargi
incluse	incluses
temporaneamente	temporairement
virgilio	virgile
virgilio	virgilio
grassi	graisses
panzer	panzers
panzer	panzer
cecilia	cécilia
cecilia	cecilia
sopravvissuti	survivants
acquisizione	acquisition
morris	morris
depressione	dépression
javier	javier
spessore	épaisseur
identificazione	identification
nominò	nomma
operativa	opérationnelle
inviata	envoyée
petto	poitrine
circostanze	circonstances
igor	igor
descrivere	décrivez
descrivere	décrire
devil	devil
interpretazioni	interprétations
terrestri	terriens
garden	garden
biografie	biographies
repubblicano	républicain
pavimento	plancher
pavimento	sol
zucchero	sucre
funzionalità	fonctionnalité
pdc	pdc
sacerdoti	prêtres
este	este
clero	clergé
frontale	frontal
frontale	frontale
affermando	affirmant
england	england
ordinario	ordinaire
soci	associés
pérez	pérez
hugh	hugh
again	again
eserciti	armées
specializzata	spécialisée
manovra	manoeuvre
manovra	manœuvre
valencia	valencia
valencia	valence
variazione	variation
away	away
order	order
sospensione	suspension
edificata	édifiée
pirati	pirates
veneziano	vénitien
wallace	wallace
loggia	loggia
pesaro	pesaro
sultano	sultan
toro	toro
toro	taureau
eletti	élus
superman	superman
code	queues
modern	modern
mass	mass
percentuali	pourcentages
emissione	émission
emissione	emission
they	they
after	after
ferite	blessures
kiev	kiev
realizzando	réalisant
phoenix	phoenix
alluminio	aluminium
vendere	vendre
datato	datée
datato	daté
corno	corne
corno	cor
piatti	plats
futuri	futurs
protesta	protestation
rachel	rachel
immacolata	immaculée
canti	chants
intellettuali	intellectuels
grey	grey
elia	elie
elia	élie
elia	elia
bersaglio	cible
manifesto	manifeste
napoletano	napolitain
napoletano	napoletano
fedeltà	fidélité
raw	raw
illustri	illustres
integrato	intégrée
integrato	intégré
tomáš	tomáš
watson	watson
interfaccia	interface
scrivendo	écrivant
terrore	terreur
terrore	effroi
mod	mod
china	china
reynolds	reynolds
martiri	martyrs
martiri	martyres
istanbul	istanbul
colorado	colorado
für	für
preceduto	précédée
preceduto	précédé
preceduto	précédés
separati	séparés
continuato	continué
colorazione	coloration
parità	parité
etiopia	éthiopie
etiopia	ethiopie
sandra	sandra
soggiorno	séjour
illinois	illinois
magico	magique
orleans	orleans
spalla	épaule
challenge	challenge
scipione	scipion
bach	bach
getto	gicleur
bros	bros
phillips	phillips
sentito	entendu
sloveno	slovène
call	call
indiani	indiennes
indiani	indiens
aperte	ouvertes
scalo	escale
geometria	géométrie
biagio	biagio
millennio	millénaire
millennio	millénium
giganti	géants
zia	zia
rimosso	enlevé
rimosso	enlevée
our	our
traduzioni	traductions
happy	happy
seguirono	suivirent
estrazione	extraction
accompagnamento	accompagnement
minerali	minéraux
minerali	minerais
ticino	tessin
ticino	ticino
mondi	mondes
mozart	mozart
distinguere	distinguer
bmw	bmw
campionessa	championne
monarchia	monarchie
adolfo	adolfo
installazione	installation
spin	spin
michigan	michigan
comunali	communaux
violoncello	violoncelle
applicata	appliquée
passano	passent
collaboratori	collaborateurs
collaboratori	contributeurs
monferrato	montferrat
gac	gac
esposti	exposés
ampliare	élargir
joão	joão
leon	leon
colli	colli
grotte	grottes
alessandra	alessandra
abiti	robes
assi	axes
assi	essieux
filologo	philologue
ostilità	hostilité
ostilità	inimitié
