rodríguez	rodríguez
hop	hop
compleanno	anniversaire
ernest	ernest
carrara	carrara
carrara	carrare
severo	sévère
return	return
cecil	cecil
cantautrice	compositrice
governi	gouvernements
esistere	exister
comandanti	commandants
pallone	ballon
recitato	récité
attraversato	traversé
arizona	arizona
wagner	wagner
promosse	promues
cristallo	cristal
vercelli	vercelli
secco	sèche
cosimo	cosimo
cosimo	cosme
body	body
body	justaucorps
combatté	combattit
affetto	affection
amanda	amanda
picco	pic
picco	crête
negozi	magasins
rca	rca
ignazio	ignace
ronald	ronald
retro	verso
retro	rétro
retro	retro
naso	nez
melbourne	melbourne
pastorale	pastorale
pastorale	pastoral
peste	peste
ghost	ghost
harvey	harvey
isaac	isaac
pausa	pause
razze	races
razze	raies
know	know
formando	formant
hunt	hunt
coloni	colons
testimone	témoin
mercati	marchés
scendere	descendre
lontana	lointaine
sfruttare	exploiter
sposare	épouser
palmer	palmer
reed	reed
emily	emily
napoletana	napolitaine
acquisito	acquis
dimora	demeure
rivalità	rivalité
rivalità	rivalités
provoca	provoque
hms	hms
transizione	transition
taiwan	taiwan
taiwan	taïwan
circondato	encerclé
circondato	entouré
cardinali	cardinaux
müller	müller
xxi	xxi
xxi	xxie
cantato	chanté
freccia	flèche
stellare	stellaires
stellare	stellaire
colpevole	coupable
protocollo	protocole
folla	foule
concorrente	concurrent
concorrente	concurrente
libia	libye
television	television
uniforme	uniforme
josh	josh
ribellione	rébellion
raro	rare
fausto	fausto
dimostrazione	démonstration
eseguiti	exécutés
frequentare	fréquenter
run	run
aperti	ouverts
duchessa	duchesse
cavo	câble
gallese	galloise
gallese	gallois
tell	tell
carmelo	carmelo
separata	séparée
siviglia	séville
invita	invite
omicidi	meurtres
residente	résidant
residente	résidente
residente	résident
umbria	ombrie
atletico	athlétique
holmes	holmes
diga	barrage
diga	digue
entrano	entrent
reato	délit
militante	militante
sismica	sismique
contemporaneo	contemporain
contemporaneo	contemporaine
trasformare	transformer
got	got
vertice	sommet
gregory	gregory
narrativa	narrative
procuratore	procureur
operatori	opérateurs
rinunciare	renoncer
menzione	mention
spostata	déplacée
dar	dar
verbo	verbe
suggerisce	suggère
uguali	égaux
creatore	créateur
leva	levier
macchia	tache
intenzioni	intentions
rudolf	rudolf
soglia	seuil
hope	hope
liberato	libéré
pirenei	pyrénées
guardare	regarder
nuotatore	nageur
perielio	périhélie
rivali	rivaux
manoscritti	manuscrits
controllata	contrôlée
rettore	recteur
folk	folklorique
folk	folk
beatles	beatles
costruttori	constructeurs
costruttori	fabricants
tendono	tendent
significativa	significative
bombardamenti	bombardements
lou	lou
tubo	tube
tubo	tuyau
adottata	adoptée
decisivo	décisive
decisivo	décisif
canonico	canonique
rex	rex
soffitto	plafond
giove	jupiter
comprensione	compréhension
comprensione	comprendre
fisici	physiciens
recensioni	critiques
vangelo	évangile
vangelo	evangile
cesena	cesena
rogers	rogers
imperatrice	impératrice
ieri	hier
intervallo	intervalle
intervallo	entracte
poetica	poétique
winter	winter
divisi	divisés
violinista	violoniste
pericoloso	dangereux
true	true
trovarono	trouvèrent
analogo	analogue
secondario	secondaire
slovenia	slovénie
negativa	négative
gaio	gaius
gaio	caius
gaio	gai
organista	organiste
crociera	croisière
sonic	sonic
sonic	soniques
sonic	sonique
anteprima	aperçu
anteprima	prévisualisation
carol	carol
han	han
pura	pure
inaugurazione	inauguration
adolf	adolf
correre	courir
orale	orale
orale	oral
eccezionalmente	exceptionnellement
beat	beat
sprint	sprints
sprint	sprint
dinamo	dynamo
liberty	liberty
trinità	trinita
trinità	trinité
guillermo	guillermo
gallia	gaule
svolgimento	déroulement
aggiungendo	ajoutant
australian	australian
violento	violent
riforme	réformes
cipro	chypre
bird	bird
demoni	démons
circostante	environnante
favorire	favoriser
massachusetts	massachusetts
corde	cordes
presidenti	présidents
digimon	digimon
carità	charité
leggende	légendes
saverio	saverio
molecole	molécules
sacrificio	sacrifice
architetti	architectes
cava	cava
porterà	portera
sospetto	suspicion
sospetto	suspect
terminale	terminal
lombardi	lombardi
benzina	essence
zar	tsars
zar	tsar
zar	zar
elementare	élémentaire
reggente	régente
reggente	régent
five	five
rispettare	respecter
olanda	hollande
fatica	fatigue
generazioni	générations
hal	hal
derivati	dérivés
cantare	chanter
vivevano	vivaient
referendum	référendum
referendum	référendums
apostolo	apôtre
fischio	sifflement
lodi	lodi
contee	comtés
gestore	gestionnaire
teramo	teramo
israeliano	israélienne
israeliano	israélien
indie	indie
africano	africain
suite	suite
qualifica	qualification
lino	lino
capaci	capables
ira	ira
make	make
conduzione	conduction
curtis	curtis
continuarono	continuèrent
enormi	énormes
efficienza	efficacité
nina	nina
significativi	significatifs
ritmica	rythmique
nodo	noeud
nodo	nœud
heaven	heaven
unire	unir
unire	combiner
ostacoli	obstacles
sinfonia	symphonie
pasta	pâte
pasta	pâtes
massacro	massacre
massacro	carnage
rolling	rolling
uccisa	assassinée
uccisa	tuée
fall	fall
boemia	bohême
derivata	dérivée
centimetri	centimètres
ginnastica	gymnastique
identificare	identifier
amanti	amants
mason	mason
odore	odeur
bridge	bridge
alain	alain
frutta	fruit
frutta	fruits
algeria	algerie
algeria	algérie
gradualmente	graduellement
gradualmente	progressivement
calice	calice
crimini	crimes
organico	organique
estinzione	extinction
girare	tourner
totali	totaux
trattare	traiter
sostengono	soutiennent
catene	chaines
catene	chaînes
eyes	eyes
ultimate	ultimate
face	face
sinonimi	synonymes
vettore	vecteur
appassionato	passionné
mons	mons
fabbricato	fabriqué
sensibilità	sensibilité
dominazione	domination
causando	causant
gola	gorge
gola	gorges
irene	irene
irene	irène
songs	songs
soap	soap
mvp	mvp
condotti	conduits
gatti	chats
cameron	cameron
evidenti	évidentes
evidenti	évidents
naturalista	naturaliste
suonato	sonné
sforza	sforza
cintura	ceinture
gorizia	gorizia
permetteva	permettait
marziale	martiale
battezzati	baptisés
parchi	parcs
trovati	trouvés
distanze	distances
abbandona	abandonne
uruguay	uruguay
certezza	certitude
felix	felix
cook	cook
lotte	lotte
lotte	luttes
birra	bières
birra	bière
mitragliatrici	mitraillettes
mitragliatrici	mitrailleuses
fallito	échoué
sviluppi	développements
esplicitamente	explicitement
dita	dita
dita	doigts
klaus	klaus
screenshot	screenshot
confessa	confesse
confessa	avoue
knight	knight
jeremy	jérémy
jeremy	jeremy
acquistò	acquit
acquistò	acheta
elegante	elegant
elegante	élégant
elegante	élégante
operaio	ouvrier
becker	becker
adiacente	adjacente
adiacente	adjacent
cannes	cannes
volare	voler
democratici	démocratiques
democratici	démocrates
organizzati	organisés
pontificia	pontificale
hepworth	hepworth
sentimento	sentiment
tubi	tubes
tubi	tuyaux
scafo	coque
positivi	positifs
sopravvivere	survivre
ricercatori	chercheurs
propulsore	propulseur
cifre	chiffres
consorzio	consortium
mensile	mensuel
mensile	mensuellement
mensile	mensuelle
lanciare	lancer
trek	trek
rookie	rookie
library	library
vasi	pots
vasi	vases
ritrovamento	trouvaille
amor	amor
provenienza	provenance
picture	picture
giocata	jouée
contrastare	contrer
contrastare	contrecarrer
stili	styles
costanza	constance
costanza	costanza
uruguaiano	uruguayen
superfici	surfaces
povertà	pauvreté
avellino	avellino
ettari	hectares
crociata	croisades
crociata	croisade
aggiunti	ajoutés
concorrenza	concurrence
beck	beck
xxx	xxx
annualmente	annuellement
caduto	déchu
caduto	tombé
leslie	leslie
animato	animé
jedi	jedi
annunziata	annunziata
bizantina	byzantine
clara	clara
competenze	compétences
quartetto	quartette
quartetto	quartet
quartetto	quatuor
funzionario	fonctionnaire
stadi	stades
prezzi	prix
rinuncia	renonciation
rinuncia	renoncement
enzima	enzyme
poetessa	poétesse
coloniale	colonial
coloniale	coloniale
aviatore	aviateur
gang	gang
gang	gangs
lana	laine
lana	lana
adiacenti	adjacents
adiacenti	adjacentes
disastro	désastre
disastro	catastrophe
riuscirà	réussira
costanzo	costanzo
testimoni	témoins
signoria	seigneurie
magnus	magnus
quattordici	quatorze
tronco	rondin
tronco	bûche
tronco	tronc
tronco	grume
misti	mixtes
registri	registres
considerazioni	considérations
straordinario	extraordinaire
camere	chambres
qualifiche	qualifications
consecutivi	consécutifs
consecutivi	consécutives
archeologia	archéologie
cresta	arête
apprezzato	apprécié
solido	solide
straniera	etrangere
straniera	étrangère
catanzaro	catanzaro
scuderia	écurie
servito	servi
muso	museau
apparente	apparent
apparente	apparente
owen	owen
kenneth	kenneth
randy	randy
controllato	contrôlé
marta	marta
marta	marthe
children	children
architettonico	architectural
short	short
oslo	oslo
grammy	grammy
abbigliamento	habillement
abbigliamento	vêtements
where	where
serpente	serpent
publishing	publishing
felicità	bonheur
particolarità	particularités
particolarità	particularité
illustrato	illustrée
illustrato	illustré
most	most
interessati	intéressés
vincente	gagnante
peggio	pire
doria	doria
bosnia	bosnie
rivolte	émeutes
cornice	cadre
vivente	vivant
nona	nona
urss	urss
celebrato	célébré
hits	hits
sapienza	sapienza
offerto	offert
vampiro	vampire
maturità	maturité
maturità	baccalauréat
drive	drive
vasca	baquet
dottorato	doctorat
miracolo	miracle
corda	corde
ninja	ninja
ninja	ninjas
triangolo	triangle
incinta	enceinte
greatest	greatest
feltrinelli	feltrinelli
annessione	annexion
gallerie	tunnels
gallerie	galeries
confermata	confirmée
cittadella	citadelle
fortunato	chanceux
fortunato	veinard
human	human
cos	cos
afelio	aphélie
corsica	corse
trophy	trophy
inviati	envoyés
carnevale	carnavals
carnevale	carnaval
impulso	impulsion
lucy	lucy
asiatico	asiatique
eco	eco
eco	écho
lars	lars
genoa	genoa
latini	latinos
latini	latins
urbino	urbino
powell	powell
mind	mind
lento	lent
pacific	pacific
illustratore	illustrateur
venduta	vendue
mars	mars
jonas	jonas
fortificazioni	fortifications
thailandia	thaïlande
thailandia	thailande
radiazione	rayonnement
radiazione	radiation
veda	veda
sopravvivenza	survie
vitagraph	vitagraph
accompagnata	accompagnée
caratterizza	caractérise
xavier	xavier
visitatori	visiteurs
roberta	roberta
saltare	sauter
laguna	lagune
laguna	laguna
laguna	lagon
bizantini	byzantins
rappresentati	représentés
derek	derek
nestor	nestor
stoccarda	stuttgart
castiglione	castiglione
galli	galli
atlantic	atlantic
church	church
seguaci	suiveurs
seguaci	adeptes
ricostruito	reconstruit
secondari	secondaires
rispettivi	respectifs
rispettivi	respectif
fusoliera	fuselage
nominata	nominée
butler	butler
vedeva	voyait
sospeso	suspendu
apostoli	apôtres
walt	walt
cooperazione	coopération
verlag	verlag
egiziano	egyptien
mississippi	mississippi
mississippi	mississipi
armeno	arménien
armeno	arméniens
miniere	mines
ashley	ashley
afghanistan	afghanistan
miranda	miranda
armistizio	armistice
attilio	attilio
missile	missile
pugno	poing
liegi	liège
astronomia	astronomie
pensione	pensions
pensione	pension
saudita	saoudien
saudita	saoudienne
masse	masses
ezio	ezio
forest	forest
depositi	dépôts
corruzione	corruption
chiedendo	demandant
mila	mila
direttiva	directive
avviato	démarré
spettro	spectre
pannelli	panneaux
garcia	garcia
genera	génère
look	look
illuminazione	éclairage
illuminazione	eclairage
illuminazione	luminaires
doge	doge
incrociatori	croiseurs
singapore	singapour
fisher	fisher
minacce	menaces
intraprendere	entreprendre
dovere	devoir
armstrong	armstrong
mezzogiorno	mezzogiorno
mangiare	manger
aurora	aurora
aurora	aurore
trappola	piège
albano	albano
bucarest	bucarest
karen	karen
cortina	cortina
esposta	exposée
meccanismi	mécanismes
bang	bang
fattoria	ferme
marinai	marins
marinai	matelots
camp	camp
barriera	barrière
petrolio	pétrole
mas	mas
protestante	protestant
protestante	protestante
jaime	jaime
primario	primaire
bin	bin
duncan	duncan
amata	aimée
arancione	orange
arancione	oranges
legnano	legnano
lipsia	leipzig
orazio	horace
tyler	tyler
elite	élite
elite	elite
joel	joël
joel	joel
combinata	combiné
combinata	combinée
alpini	alpins
incisione	entaille
incisione	gravure
incisione	incision
wendy	wendy
stand	stand
stand	stands
incontrato	rencontré
assassinato	assassiné
rom	rom
rom	roms
sacramento	sacramento
sacramento	sacrement
disposizioni	dispositions
complete	complètes
complete	complete
protetto	protégé
carburante	carburant
xbox	xbox
rabbia	rage
rabbia	colère
edwin	edwin
kenny	kenny
spinto	poussé
seven	seven
giovedì	jeudi
manhattan	manhattan
pesantemente	lourdement
colpita	touchée
colpita	impressionnée
colpita	frappée
imparare	apprendre
lasciata	laissée
dignità	dignité
rari	rare
rari	rares
cavità	cavité
cavità	cavités
espressioni	expressions
australe	australe
australe	austral
violenta	violente
debito	dette
commesso	commis
hank	hank
decimale	décimal
decimale	décimale
adventures	adventures
falco	falco
falco	faucon
torinese	torinese
foster	foster
ristampa	réimpression
lirica	lyrique
iscrizioni	inscriptions
marx	marx
daniela	daniela
storm	storm
fretta	hâte
featuring	featuring
polemica	polémique
elsa	elsa
battesimo	baptême
laurent	laurent
interazione	interaction
diagnosi	diagnostique
diagnosi	diagnostic
africana	africaine
medioevale	médiéval
restanti	restants
carla	carla
trasportare	transporter
child	child
ferita	blessée
ferita	blessure
ferita	plaie
glasgow	glasgow
controlla	vérifie
controlla	vérifiez
coast	coast
installato	installé
installato	installée
hawaii	hawaï
hawaii	hawaii
reliquie	reliques
shanghai	shanghai
shanghai	shanghaï
malcolm	malcolm
malcolm	malcom
pole	pole
espressa	exprimée
espressa	expresse
quotidiani	quotidiens
poggio	poggio
false	fausses
false	false
evil	evil
operativi	opérationnels
censura	censurer
censura	censure
browser	navigateurs
costituiti	constitués
ombre	ombres
nasa	nasa
alonso	alonso
sconosciuta	inconnue
ducale	ducal
ducale	ducale
sicilie	siciles
margini	marges
incrocio	croisement
catturati	capturés
eastern	eastern
stevens	stevens
doug	doug
gilles	gilles
imo	imo
pakistan	pakistan
rod	rod
invisibile	invisible
ltd	ltd
unesco	unesco
mammiferi	mammifères
biologia	biologie
wall	wall
propulsione	propulsion
sonata	sonate
sonata	sonata
crema	crème
assia	hessen
vegetali	végétaux
esclusiva	exclusive
esclusiva	exclusivité
next	next
profeta	prophète
cartone	carton
attivamente	activement
provenza	provence
provenza	provenza
brigate	brigades
incredibile	incroyable
innamorata	amoureuse
comunicare	communiquer
discreto	discret
assegnazione	affectation
patricia	patricia
bond	bond
basilea	bâle
sviluppati	développés
censore	censeur
ana	ana
viveva	vivait
cerchi	jantes
cerchi	cercles
rap	rap
sparta	sparte
sparta	sparta
baroni	barons
persiano	persan
cileno	chilien
visite	visites
veronica	véronica
veronica	veronica
generare	générer
valvole	vannes
valvole	soupapes
valvole	valves
tolosa	toulouse
maya	maya
maya	mayas
pink	pink
raggiungibile	joignable
raggiungibile	réalisable
raggiungibile	atteignable
decima	dîme
decima	dixième
decima	decima
parodia	parodie
wells	wells
alejandro	alejandro
risposto	répondu
pasqua	pâque
pasqua	paques
pasqua	pâques
ordina	trier
made	made
too	too
marketing	marketing
ventura	ventura
etica	ethique
etica	éthique
convoglio	convoi
cole	cole
collaborazioni	collaborations
ribelle	rebelle
dinamica	dynamique
trampolino	tremplin
trampolino	plongeoir
trampolino	trampoline
emi	emi
montato	monté
then	then
plastica	plastique
plastica	plastiques
vantaggi	avantages
risolto	résolu
clarke	clarke
gun	gun
adottare	adopter
punte	bouts
punte	pointes
narrazione	narration
distribuiti	distribués
osservatore	observateur
osservatore	guetteur
fair	fair
disturbi	troubles
diamante	diamant
coinvolgimento	implication
quote	quotas
divino	divin
divorzio	divorce
planet	planet
shaw	shaw
imperatori	empereurs
globe	globe
volontario	volontaire
hughes	hughes
linux	linux
ivo	rco
ivo	ivo
riservata	réservée
funzionale	fonctionnelle
funzionale	fonctionnel
compongono	composent
misteriosa	mystérieuse
alaska	alaska
tradurre	traduire
attribuzione	attribution
attendere	attendre
opposta	opposée
nunzio	nonce
nicolás	nicolás
riti	rites
tipografia	typographie
impiegata	employée
affermazioni	affirmations
adesione	adhésion
reich	reich
angels	angels
indonesia	indonésie
appennino	apennin
applicato	appliqué
superando	surpassant
esegue	exécute
palatinato	palatinat
ovunque	partout
precipitazioni	précipitations
processore	processeur
uccidendo	tuant
ricostruire	reconstruire
nikolaj	nikolaï
mann	mann
mesoregione	mésorégion
proteste	protestations
membrana	membrane
banche	banques
persero	perdirent
piombo	plomb
gustav	gustav
nazisti	nazis
sita	sita
faro	faro
faro	phare
effettivi	effectifs
edimburgo	edimbourg
edimburgo	édimbourg
hood	hood
doppiatori	doubleurs
cripta	caveau
cripta	crypte
uovo	œuf
uovo	oeuf
rifiuti	déchets
sostenendo	soutenant
sysop	sysop
cancelliere	chancelier
cancelliere	greffier
incidenti	incidents
sonda	sonde
boeing	boeing
applicare	appliquer
livio	livius
livio	livio
grasso	graisse
annuncio	annonce
innumerevoli	innombrables
aggregato	agrégat
aggregato	agrégé
effettiva	effective
visitare	visiter
collettivo	collectif
febbre	fièvre
sella	selle
cacciatore	chasseur
mattoni	briques
seta	soie
ideali	idéaux
ideali	idéales
primera	primera
liberali	libéraux
microregione	microrégion
estetica	esthétique
sonno	sommeil
copre	couvre
shadow	shadow
occupare	occuper
eccezionale	exceptionnel
eccezionale	exceptionnelle
chiostro	cloître
incisioni	incisions
incisioni	entailles
incisioni	gravures
lopez	lopez
progressivo	progressif
progressivo	progressive
sardo	sarde
rischi	risques
fusto	fût
rumore	bruit
specializzato	spécialisé
cedere	céder
palestina	palestine
ferdinand	ferdinand
rinascita	renaissance
pompeo	pompée
kyle	kyle
abc	abc
sciatore	skieur
sceglie	choisit
scout	scout
scout	scouts
arabia	arabie
eccessiva	excessive
osservata	observée
attrazione	attraction
divieto	interdiction
earl	earl
nana	nana
nana	naine
intelligente	intelligente
intelligente	intelligent
minoranza	minorité
minoranza	minoritaire
navarra	navarre
navarra	navarra
abraham	abraham
meriti	mérites
say	say
produsse	produisit
michail	mikhaïl
michelle	michelle
molecola	molécule
diocesano	diocésain
beautiful	beautiful
square	square
anversa	anvers
steel	steel
bompiani	bompiani
significative	significatives
bacio	bise
bacio	baiser
bacio	bisou
spara	tire
elisa	elisa
rispose	répondit
supergigante	supergéante
sensibile	sensible
mediaset	mediaset
generico	générique
cartoni	cartons
their	their
guarnigione	garnison
coll	coll
incantesimo	sortilège
incantesimo	incantation
spade	épées
spade	sabres
senna	seine
senna	senna
oliva	oliva
conteneva	contenait
assistere	assister
orsini	orsini
ramírez	ramírez
medievali	médiévaux
diamond	diamond
chang	chang
miniera	mine
umanista	humaniste
determina	détermine
onorario	honoraire
dirette	directes
selezionato	sélectionné
nido	nid
pubblicamente	publiquement
belli	beaux
belli	belli
bundesliga	bundesliga
riso	riz
player	player
occupano	occupent
volpe	renard
poker	poker
mortale	mortel
mortale	mortelle
opzione	option
federato	fédéré
interviste	interviews
interviste	entrevues
celebrare	célébrer
guitar	guitar
sostituisce	remplace
vinti	gagnés
vinti	remportés
vinti	vaincus
some	some
subire	subir
sommergibile	submersible
cantoni	cantons
denver	denver
costruttore	constructeur
pci	pci
württemberg	wurtemberg
board	board
baptiste	baptiste
toscano	toscan
vicente	vicente
preparare	préparer
intel	intel
southern	southern
cicero	cicero
guidare	conduire
provocò	provoqua
bonifacio	boniface
bonifacio	bonifacio
loira	loire
madison	madison
lupi	loups
abuso	abus
capolinea	terminus
moretti	moretti
spiriti	esprits
dirty	dirty
wisconsin	wisconsin
gesuita	jésuite
linguista	linguiste
lang	lang
restaurato	restauré
antifascista	antifasciste
tunisia	tunisie
joey	joey
sophie	sophie
povero	pauvre
rivelazione	révélation
impegnata	engagée
meyer	meyer
accede	accède
lavorava	travaillait
encyclopedia	encyclopedia
spia	espion
spia	spy
becco	bec
combustibile	combustible
viso	visage
fischer	fischer
schiena	dos
fiamma	flamme
risparmio	épargne
brooks	brooks
dorothy	dorothy
dorothy	dorothée
concessa	accordée
facebook	facebook
byron	byron
gómez	gómez
dotazione	dotation
annie	annie
fianchi	flancs
fianchi	hanches
bull	bull
finanza	finances
finanza	finance
sponda	hayon
pressioni	pressions
deboli	faibles
metalli	métaux
mit	mit
chirurgia	chirurgie
diminuzione	diminution
conferenze	conférences
andrés	andrés
seguiti	suivis
loc	loc
vulcano	volcan
vulcano	vulcain
dialoghi	dialogues
adelaide	adélaïde
adelaide	adelaide
preparatore	préparateur
radiale	radiale
radiale	radial
concludere	conclure
dirigere	diriger
videro	virent
schmidt	schmidt
ice	ice
molecolare	moléculaire
molecolare	moléculaires
edificato	édifié
sepoltura	sépulture
sepoltura	inhumation
sepoltura	enterrement
cohen	cohen
tumore	tumeur
cliente	client
biografico	biographique
incisa	gravée
rovina	ruine
brevemente	brièvement
break	break
scade	expire
harvard	harvard
incoronazione	sacre
incoronazione	couronnement
affermare	affirmer
mantello	cape
angoli	coins
angoli	angles
edge	edge
duchi	ducs
sospetti	suspects
sospetti	soupçons
sospetti	suspectes
contribuisce	contribue
approfondimento	approfondissement
imposta	définir
nacquero	naquirent
zhang	zhang
estone	estonien
control	control
miti	mythes
tigre	tigresse
tigre	tigre
portico	porche
portico	portique
spiegazioni	explications
hudson	hudson
granata	obus
informatico	informaticien
bordeaux	bordeaux
provocando	provoquant
biblioteche	bibliothèques
amiche	copines
amiche	amies
corolla	corolla
tales	tales
emiliano	emiliano
aggiunse	ajouta
mercurio	mercure
piattaforme	plateformes
fascio	faisceau
uci	uci
montenegro	montenegro
montenegro	monténégro
aiuti	aides
missionario	missionnaire
vasco	vasco
damiano	damiano
remake	remake
passate	passez
vicariato	vicariat
burton	burton
birmingham	birmingham
row	row
fleming	fleming
determinazione	détermination
berlina	berline
cold	cold
creek	creek
emerge	émerge
suddivisioni	subdivisions
marchesi	marquises
metallica	metallica
ruth	ruth
dee	dee
dee	déesses
tip	tip
kane	kane
occasionalmente	occasionnellement
orléans	orléans
price	price
friends	friends
complessità	complexités
complessità	complexité
cliff	cliff
adventure	adventure
cum	cum
rifiutato	refusé
chirurgo	chirurgienne
chirurgo	chirurgien
celebrazione	célébration
voluta	voulue
resistere	résister
ecuador	équateur
ecuador	equateur
fiandre	flandre
fiandre	flandres
circondata	entourée
circondata	encerclée
koch	koch
cox	cox
repubblicana	républicaine
numerazione	numérotation
viterbo	viterbe
viterbo	viterbo
montevideo	montevideo
soddisfare	satisfaire
cantieri	chantiers
toledo	tolède
toledo	toledo
lombarda	lombarde
paulo	paulo
lanciata	lancée
segmento	segment
teodoro	théodore
teodoro	teodoro
ass	ass
chiusi	chiusi
chiusi	fermés
ginocchio	genou
sullivan	sullivan
consultato	consulté
wind	wind
jackie	jackie
turisti	touristes
mancini	mancini
duetto	duo
lara	lara
early	early
ellis	ellis
conquistata	conquise
consorte	epouse
chiavi	clés
chiavi	clefs
difensiva	défensive
celle	cellules
magnetico	magnétiques
magnetico	magnétique
vivi	vivants
contribuendo	contribuant
vandalismo	vandalisme
nativo	natif
nativo	native
punizione	punition
martello	marteau
martello	maillet
rangers	rangers
kingdom	kingdom
atomi	atomes
spa	pps
spa	spa
ritrovano	retrouvent
templi	temples
avvisi	alertes
studies	studies
pittsburgh	pittsburgh
ein	ein
caserma	casernes
caserma	caserne
elicottero	hélico
elicottero	hélicoptère
fondare	fonder
escluso	exclu
geografico	géographique
affluente	affluent
rain	rain
montgomery	montgomery
trailer	trailer
marcelo	marcelo
accento	accent
cbs	cbs
helsinki	helsinki
mother	mother
caserta	caserte
caserta	caserta
progettista	concepteur
lecco	lecco
brandon	brandon
medina	médina
medina	medina
islanda	islande
compositori	compositeurs
donazione	donation
sentieri	sentiers
podestà	podestà
periodico	périodique
dawn	dawn
dose	dose
appassionati	passionnés
patti	pactes
patti	patti
restaurata	restaurée
sequenze	séquences
orto	ortho
orto	potager
walsh	walsh
pistard	pistard
aprono	ouvrent
hardcore	hardcore
helena	helena
helena	héléna
another	another
pinacoteca	pinacothèque
gil	gil
ladro	cambrioleur
ladro	voleur
mel	mel
streghe	sorcières
alias	alias
equazioni	équations
decisiva	décisive
percy	percy
electric	electric
falsa	fausse
sottolineare	souligner
superficiale	superficielle
superficiale	superficiel
kill	kill
were	were
papà	papa
complimenti	félicitations
complimenti	compliments
faenza	faenza
fazione	faction
sovranità	souveraineté
presunta	supposée
presunta	prétendue
presunta	présumée
sergej	sergueï
bottiglia	bouteille
eliminati	éliminés
preferisce	préfère
senior	senior
genesi	genèse
log	log
log	logs
descritti	décrits
pereira	pereira
altari	autels
pellegrino	pèlerin
discendenza	descendance
causare	causer
hero	héro
hero	hero
attraversare	traverser
frammento	fragment
assistito	assisté
gibson	gibson
combattenti	combattants
alieni	aliens
alieni	extraterrestres
vini	vins
difficilmente	difficilement
difensivo	défensif
vinile	vinyle
vinile	vinyl
avenue	avenue
incursioni	incursions
jenny	jenny
minoranze	minorités
sicura	sûre
parallelamente	parallèlement
definite	définies
distacco	détachement
prefisso	préfixe
cometa	comète
aquitania	aquitaine
effettua	effectue
comunicato	communiqué
kit	kits
kit	kit
vampiri	vampires
dichiarazioni	déclarations
agisce	agit
accessibile	accessible
colombiano	colombien
ragusa	ragusa
ragusa	raguse
separato	distinct
separato	séparée
separato	séparé
mori	mori
mori	maures
sparare	tirer
correggere	corriger
imminente	imminent
imminente	imminente
esclusione	exclusion
duke	duke
decisa	décidée
rubrica	rubrique
virtuale	virtuel
virtuale	virtuelle
midi	midi
danilo	danilo
attaccò	attaqua
generato	généré
capua	capua
capua	capoue
funzionari	fonctionnaires
fighter	fighter
loco	loco
wonder	wonder
wade	wade
gravidanza	grossesse
variare	varier
contrabbasso	contrebasse
volendo	voulant
negativi	négatives
negativi	négatifs
battere	battre
trasferire	transférer
grassetto	gras
grassetto	audacieux
algoritmo	algorithme
riscatto	rançon
brien	brien
marion	marion
ferreira	ferreira
consulente	consultant
potendo	pouvant
edmund	edmund
fitzgerald	fitzgerald
corazzate	cuirassés
abu	abou
abu	abu
holland	holland
funzionare	fonctionner
tastierista	claviériste
versailles	versailles
osserva	observe
nascono	naissent
cicerone	cicéron
slovacco	slovaque
malato	malate
malato	malade
pagani	païens
registra	enregistre
sandy	sandy
nature	natures
libano	liban
isolamento	isolation
isolamento	isolement
consegnato	livré
jana	jana
schieramento	déploiement
sostituiti	remplacés
martedì	mardi
harper	harper
galeazzo	galeazzo
campane	cloches
chieti	chieti
heinz	heinz
elettroni	électrons
compromesso	compromis
march	march
lynn	lynn
fisicamente	physiquement
interrotto	interrompu
lunare	lunaire
ufc	ufc
hearts	hearts
animo	animo
dichiarata	déclarée
dipendenza	addiction
dipendenza	dépendance
bolivia	bolivie
insegnare	enseigner
stretti	détroits
levante	levante
levante	levant
mezzanotte	minuit
centenario	centenaire
yang	yang
risiede	réside
pia	pia
salvataggio	sauvetage
raggruppamento	regroupement
raggruppamento	grouper
distinto	distingué
rieti	rieti
theory	theory
osso	os
chen	chen
pippo	goofy
pippo	dingo
etnia	ethnie
etnia	ethnicité
bristol	bristol
rich	rich
rappresentate	représentées
anatomia	anatomie
compressione	compression
stampato	imprimé
conan	conan
ammessa	admise
beverly	beverly
accompagna	accompagne
sposta	déplacer
sposta	déplace
armonia	harmonie
decorata	décorée
ricade	retombe
edison	edison
esposte	exposées
viareggio	viareggio
regular	regular
patty	patty
ain	ain
devozione	dévotion
pronta	prête
preparato	préparé
meeting	meeting
parlata	parlée
bestia	bête
tattica	tactique
stimato	estimée
stimato	estimé
gioacchino	gioacchino
ibge	ibge
maine	maine
spam	spams
spam	pourriels
spam	spam
possedere	posséder
circle	circle
draghi	draghi
draghi	dragons
pelo	poil
circuiti	circuits
eye	eye
contratti	contrats
profonde	profondes
landkreis	landkreis
urbanistica	urbanisme
buffalo	buffalo
pam	pam
lituania	lithuanie
lituania	lituanie
facilità	facilité
datazione	datant
datazione	datation
coordinamento	coordination
cabina	cabine
bennett	bennett
pensieri	pensées
lanciò	lança
circo	cirque
ebreo	juif
locomotiva	locomotive
saluti	salutations
bush	bush
chelsea	chelsea
progresso	progrès
effettivo	effectif
olimpia	olympe
olimpia	olympie
insegnò	enseigna
raoul	raoul
raoul	raoh
osservato	observé
anders	anders
privilegi	privilèges
ducati	ducats
ducati	ducati
chip	chip
esplorazione	exploration
minimi	minima
minimi	minimums
giudicato	jugé
reid	reid
proiezione	projection
impedisce	empêche
persia	perse
presunto	présumé
presunto	censément
pelliccia	fourrure
firmare	signer
osaka	osaka
through	through
legioni	légions
pinna	nageoire
pinna	aileron
modesto	modesto
modesto	modeste
alternativo	alternatif
inutili	inutiles
bart	bart
omar	omar
cron	cron
compton	compton
estonia	estonie
muhammad	muhammad
bowie	bowie
viktor	viktor
tiziano	tiziano
tiziano	titien
philipp	philipp
logan	logan
titolari	titulaires
necropoli	nécropole
danneggiato	endommagé
passarono	passèrent
bombardieri	bombardiers
nigeria	nigeria
nigeria	nigéria
provocato	provoqué
valentina	valentina
esatto	exact
oklahoma	oklahoma
magazzino	entrepôt
benz	benz
reputazione	réputation
consiglieri	conseillers
suggerimenti	astuces
suggerimenti	suggestions
suggerimenti	conseils
zagabria	zagreb
malesia	malaisie
costiere	côtières
coprire	couvrir
monasteri	monastères
rebecca	rebecca
wwf	wwf
vancouver	vancouver
hannover	hanovre
itunes	itunes
etnie	ethnies
sindacalista	syndicaliste
apertamente	ouvertement
missouri	missouri
denuncia	plainte
denuncia	dénonciation
lusso	luxe
eccezioni	exceptions
ragni	araignées
garda	garda
zeus	zeus
rappresentava	représentait
forever	forever
strange	strange
imposto	imposé
hardware	hardware
murder	murder
spoleto	spoleto
spoleto	spolète
interessata	intéressée
