del	do
che	que
per	para
della	da
nel	no
con	com
una	uma
non	não
dei	dos
dell	dell
alla	ao
come	como
nella	na
nella	no
sono	são
sono	sou
delle	das
dal	pelo
più	mais
anche	também
team	equipe
seed	seed
all	all
the	the
sua	sua
due	duas
due	dois
tra	entre
era	era
era	foi
dalla	pela
suo	seu
dopo	depois
prima	primeiro
parte	parte
stato	estado
altri	outros
bar	bares
anni	anos
italiano	italiano
degli	dos
essere	ser
questo	este
questo	isso
questo	isto
collegamenti	ligações
nell	nell
serie	série
cet	cet
questa	esta
film	filme
città	cidade
solo	só
solo	apenas
uno	um
loro	eles
primo	primeiro
nome	nome
alle	às
san	san
poi	depois
secondo	segundo
nelle	nas
msg	msg
voce	voz
progetti	projetos
sia	seja
dove	onde
quando	quando
anno	ano
durante	durante
mentre	enquanto
voci	vozes
italia	itália
fino	até
quale	qual
tre	três
molto	muito
from	from
può	pode
comune	frequentes
tutti	todos
stagione	temporada
gruppo	grupo
stati	estados
contro	contra
dai	dai
calciatore	futebolista
roma	roma
così	assim
tempo	tempo
till	till
chiesa	igreja
quindi	então
secolo	século
guerra	guerra
sempre	sempre
fatto	feito
erano	eram
storia	história
quella	aquela
fine	fim
aveva	tinha
quello	aquele
album	álbum
album	álbuns
già	já
altre	outras
alcuni	alguns
ancora	ainda
senza	sem
francese	francês
seconda	segunda
finale	final
vita	vida
titolo	título
shift	shift
campionato	campeonato
ogni	cada
mondo	mundo
furono	foram
tutto	tudo
settembre	setembro
nazionale	nacional
italiana	italiana
circa	sobre
quanto	quanto
sotto	abaixo
wikipedia	wikipédia
calcio	futebol
famiglia	família
oltre	além
quali	quais
numero	número
milano	milão
via	via
posto	lugar
ottobre	outubro
maggio	maio
gennaio	janeiro
modo	modalidade
nuovo	novo
perché	porque
perché	porquê
casa	casa
generale	geral
marzo	março
squadra	equipe
dicembre	dezembro
caso	caso
sue	sue
giugno	junho
questi	estes
agosto	agosto
luglio	julho
opera	ópera
fra	entre
aprile	abril
pagina	página
periodo	período
novembre	novembro
giovanni	joão
grazie	obrigado
grazie	obrigada
insieme	juntos
lui	ele
morte	morte
maria	maria
agli	aos
nuova	nova
febbraio	fevereiro
john	john
new	new
centro	centro
inglese	inglês
quattro	quatro
interno	interior
attività	atividades
attività	actividades
alcune	algumas
tutte	todas
causa	causa
edizione	edição
qui	aqui
nord	norte
diretto	direto
esempio	exemplo
ultimo	último
sfondo	fundo
versione	versão
provincia	província
attore	ator
tale	tal
coppa	copa
forma	forma
codice	código
oggi	hoje
base	base
poco	pouco
punto	ponto
figlio	filho
corso	curso
allenatore	treinador
molti	muitos
sistema	sistema
società	sociedade
tipo	tipo
maggiore	maior
club	clube
regione	região
sud	sul
discussione	discussão
padre	pai
linea	linha
santa	santa
pubblicato	publicado
carlo	carlo
progetto	projeto
primi	primeiros
possono	podem
mai	nunca
sito	site
lungo	longo
uso	uso
value	value
tedesco	alemão
grado	grau
uniti	unidos
lavoro	trabalho
isbn	isbn
giorno	dia
principale	principal
termine	termo
mondiale	mundial
regno	reino
ben	ben
specie	espécie
persone	pessoas
pagine	páginas
volte	vezes
set	set
inizio	início
jpg	jpg
vengono	vêm
sarebbe	seria
episodio	episódio
rispetto	respeito
francesco	francisco
posizione	localização
genere	gênero
turno	turno
queste	estas
presidente	presidente
stessa	mesma
militare	militar
uomo	homem
meno	menos
campo	campo
giorni	dias
carriera	carreira
scritto	escrito
ora	agora
territorio	território
gen	gen
gran	gran
antonio	antónio
giuseppe	josé
diversi	diferentes
quasi	quase
data	data
terra	terra
soprattutto	principalmente
allora	então
successo	sucesso
opere	obras
ordine	ordem
categoria	categoria
produzione	produção
strada	estrada
corpo	corpo
quest	quest
scrittore	escritor
lug	lug
file	ficheiros
ultima	última
cura	cura
francia	frança
lingua	língua
zona	zona
livello	nível
battaglia	batalha
premio	prêmio
attrice	atriz
ott	ott
disciplina	disciplina
momento	momento
mag	mag
studio	estudo
oro	ouro
paese	país
cantante	cantora
cantante	cantor
arte	arte
età	idade
storico	histórico
vescovo	bispo
york	york
squadre	equipas
squadre	equipes
precedente	anterior
area	área
episodi	episódios
chi	quem
paolo	paulo
attraverso	através
possibile	possível
avere	ter
servizio	serviço
regista	realizador
punti	pontos
fosse	fosse
repubblica	república
governo	governo
dato	dado
originale	original
state	state
apr	abr
grandi	grandes
palazzo	palácio
giocatore	jogador
università	universidade
isola	ilha
quelle	aquelas
capo	chefe
musica	música
divisione	divisão
luogo	local
ago	agulha
iii	iii
napoli	nápoles
parigi	paris
nonostante	apesar
sembra	parece
david	david
gioco	jogo
terzo	terceiro
feb	fev
ufficiale	oficial
luigi	luís
vittoria	vitória
centrale	central
internazionale	internacional
porta	porta
sei	seis
partire	partir
popolazione	população
piano	plano
origine	origem
prodotto	produto
presenza	presença
libro	livro
scuola	escola
immagine	imagem
esercito	exército
deve	deve
autore	autor
personaggio	personagem
importante	importante
torneo	torneio
europa	europa
quelli	aqueles
firenze	florença
comunità	comunidade
giovane	jovem
avrebbe	teria
presenta	apresenta
vari	vários
pietro	pedro
studi	estudos
fonte	fonte
acqua	água
torino	turim
cinque	cinco
basso	baixo
partito	partido
unità	unidade
fonti	fontes
marcatori	marcadores
politica	política
lei	ela
metà	metade
metà	metades
metri	metros
alto	alto
top	top
testo	texto
align	align
usa	eua
tour	tour
dati	dados
tutta	toda
teatro	teatro
procedura	procedimento
cardinale	cardeal
unico	único
papa	papa
uomini	homens
visto	viu
ricerca	pesquisa
principali	principais
massimo	máximo
massimo	massimo
stile	estilo
left	left
germania	alemanha
donna	mulher
superficie	superfície
alta	alta
castello	castelo
distretto	distrito
nota	nota
mesi	meses
moglie	esposa
tanto	tanto
ritorno	retorno
costruzione	construção
totale	total
canzone	canção
vista	vista
detto	dito
detto	disse
attuale	atual
note	notas
varie	diversos
altezza	altura
band	band
chitarra	guitarra
robert	robert
est	leste
fiume	rio
figlia	filha
realtà	realidade
fuori	fora
paul	paul
for	for
monte	monte
contea	condado
museo	museu
forse	talvez
protagonista	protagonista
legge	lei
mario	mário
molte	muitas
stadio	estádio
fase	fase
classe	classe
amore	amor
michael	michael
fratello	irmão
color	color
sviluppo	desenvolvimento
prime	prime
prime	primeiras
pittore	pintor
sarà	será
pubblico	público
venezia	veneza
media	mídia
media	média
struttura	estrutura
gray	gray
paesi	países
personaggi	personagens
londra	londres
sopra	acima
formazione	formação
world	world
you	you
probabilmente	provavelmente
sant	sant
bene	bem
britannico	britânico
romano	romano
informazioni	informações
utente	usuário
italiani	italianos
james	james
video	vídeos
giochi	jogos
disco	disco
conte	conde
giapponese	japonês
direttore	diretor
peso	peso
meglio	melhor
figli	filhos
avevano	tinham
piccolo	pequeno
unica	única
importanti	importantes
cestista	basquetebolista
von	von
terza	terceira
occasione	ocasião
programma	programa
sta	está
barra	barra
nominato	nomeado
noto	conhecido
testa	cabeça
romanzo	romance
potrebbe	poderia
jean	jean
forte	forte
forze	forças
numerosi	numerosos
william	william
impero	império
diritto	direito
unione	união
star	star
piazza	praça
potere	poder
rgb	rgb
presenze	presenças
senso	sentido
rete	rede
lato	lado
forza	força
superiore	superior
breve	curta
lavori	trabalhos
spagnolo	espanhol
van	van
fronte	testa
ovest	oeste
andrea	andrea
nato	nascido
dipartimento	departamento
controllo	controlo
winner	winner
saint	saint
don	don
passato	passado
caratteristiche	características
edizioni	edições
dire	dizer
guida	guia
diocesi	diocese
gridcolor	gridcolor
consiglio	conselho
villa	villa
lightgrey	lightgrey
mappa	mapa
membri	membros
giorgio	jorge
problemi	problemas
antica	antiga
darkgrey	darkgrey
problema	problema
milioni	milhões
mano	mão
chiamato	chamado
migliore	melhor
pochi	poucos
giornalista	jornalista
mio	meu
festival	festival
civile	civil
evoluzione	evolução
luce	luz
league	league
lista	lista
compositore	compositor
sezione	secção
ultimi	últimos
attualmente	atualmente
ore	horas
edificio	edifício
peter	peter
dio	deus
casi	casos
inizia	comece
sinistra	esquerda
modello	modelo
istituto	instituto
aeroporto	aeroporto
velocità	velocidade
imperatore	imperador
movimento	movimento
motore	motor
femminile	feminino
vero	verdade
piccola	pequena
nuovi	novos
style	style
valore	valor
gruppi	grupos
bologna	bolonha
inizialmente	inicialmente
love	love
cultura	cultura
spazio	espaço
troppo	demais
alessandro	alexandre
amico	amigo
membro	membro
rock	rock
doppio	dobro
doppio	duplo
formato	formato
vinto	ganhei
vinto	ganhou
mezzo	meio
lunghezza	comprimento
processo	processo
attacco	ataque
proprietà	propriedades
interpretato	interpretado
spagna	espanha
titoli	títulos
http	http
colore	cor
vicino	próximo
orientale	oriental
antico	antigo
man	man
principe	príncipe
notte	noite
dice	diz
mese	mês
des	des
nuove	novas
cancellazione	cancelamento
batteria	bateria
immagini	imagens
argento	prata
poeta	poeta
tempi	tempos
persona	pessoa
charles	charles
rosso	vermelho
russo	russo
occidentale	ocidental
comando	comando
bianco	branco
licenza	licença
ambito	âmbito
reti	redes
funzione	função
numerose	numerosas
scena	cena
richard	richard
cinema	cinema
associazione	associação
mia	minha
riferimento	referência
simile	semelhante
simile	similar
ragazza	menina
thomas	thomas
utenti	usuários
franco	franco
costa	costa
entrambi	ambos
arcivescovo	arcebispo
enrico	henrique
torre	torre
reale	real
seguente	seguinte
oppure	ou
vol	vol
corte	tribunal
compagnia	companhia
der	der
produttore	produtor
azione	acção
azione	ação
risultati	resultados
interesse	interesse
aggiornato	atualizado
campione	amostra
campione	campeão
live	live
donne	mulheres
decide	decide
parla	fala
truppe	tropas
possibilità	possibilidade
lunga	longa
nero	preto
roberto	roberto
destra	direita
city	city
difesa	defesa
americano	americano
accordo	acordo
personale	pessoal
dimensioni	dimensões
dimensioni	tamanho
completamente	completamente
seguenti	seguintes
radio	rádio
records	records
sette	sete
capitale	capital
martin	martin
situazione	situação
parole	palavras
los	los
aiuto	ajuda
genova	génova
effetti	efeitos
greco	grego
scopo	finalidade
considerato	considerado
prese	tomadas
idea	idéia
madonna	madonna
rivista	revista
santo	santo
parco	parque
nuovamente	novamente
abbia	tenha
resto	troco
romana	romana
otto	oito
otto	otto
direzione	direção
direzione	direcção
marina	marina
richiesta	pedido
alberto	alberto
editore	editor
risultato	resultado
usato	usado
mostra	mostra
inghilterra	inglaterra
duca	duque
carica	carregar
votazione	votação
sociale	social
maschile	masculino
trovano	encontram
prova	ensaio
qualità	qualidade
wiki	wiki
rapporto	relacionamento
black	black
minuti	minutos
stella	estrela
porto	porto
angelo	anjo
center	center
nulla	nada
tecnica	técnica
lega	liga
speciale	especial
azienda	empresa
artista	artista
anna	anna
record	record
mercato	mercado
versioni	versões
giocatori	jogadores
chiamata	chamada
sale	sal
libri	livros
tali	tais
border	border
trovare	encontrar
stefano	stefano
natura	natureza
tennis	ténis
capacità	capacidade
dare	dar
buona	boa
frazione	fração
nave	navio
estate	verão
giappone	japão
volume	volume
fuoco	fogo
vuole	quer
differenza	diferença
gol	gol
gol	gols
composto	composto
campagna	campanha
accesso	acesso
organizzazione	organização
link	link
link	links
lago	lago
canale	canal
popolare	popular
deceduto	falecido
rimane	permanece
fanno	fazem
ufficiali	oficiais
viaggio	viagem
tappa	etapa
inferiore	inferior
ponte	ponte
materiale	material
pallacanestro	basquetebol
bruno	bruno
fisica	física
pilota	piloto
cancellare	apagar
contiene	contém
armi	armas
relazione	relatório
oggetto	objecto
eventi	eventos
medico	médico
conto	conta
semplice	simples
ministro	ministro
motivo	motivo
sole	sol
rimase	ficou
prodotti	produtos
sport	desportos
direttamente	diretamente
grafica	gráficos
ottenere	obter
creare	criar
divisioni	divisões
isole	ilhas
colonna	coluna
medaglia	medalha
creato	criado
vecchio	velho
bassa	baixa
matrimonio	casamento
minore	menor
aggiornamento	atualização
onda	onda
aspetto	aparência
architetto	arquiteto
precedenti	anteriores
dovuto	devido
contratto	contrato
filippo	filipe
nascita	nascimento
mark	mark
naturale	natural
coppia	casal
presto	logo
vedere	ver
federico	frederico
realizzato	realizado
promozione	promoção
les	les
articolo	artigo
condizioni	condições
complesso	complexo
linee	linhas
futuro	futuro
orchestra	orquestra
right	right
settore	setor
sebbene	embora
camera	quarto
decise	decididas
comandante	comandante
settimana	semana
potenza	potência
giocato	jogou
esiste	existe
atto	ato
collaborazione	colaboração
russia	rússia
cappella	capela
group	group
credo	acho
figura	figura
ecc	etc
fin	fin
rai	rai
giovani	jovens
croce	cruz
zone	zonas
prende	toma
cattolico	católico
company	company
posta	correio
michele	miguel
francesi	franceses
conosciuto	conhecido
art	art
regina	rainha
tradizione	tradição
polizia	polícia
migliori	melhores
sconfitta	derrota
music	music
pace	paz
questione	questão
palermo	palermo
favore	favor
qualcosa	algo
massa	massa
energia	energia
rosa	rosa
aria	ar
militari	militares
storici	historiadores
fondata	fundada
tracce	faixas
nessuno	ninguém
marito	marido
diretta	direta
capitano	capitão
piccoli	pequenos
didascalia	legenda
elezioni	eleições
artisti	artistas
teoria	teoria
distribuzione	distribuição
dieci	dez
evento	evento
internazionali	internacionais
tom	tom
enciclopedia	enciclopédia
joseph	joseph
canzoni	canções
popolo	povo
europeo	europeu
uscita	saída
distanza	distância
portato	trazido
pro	prós
pro	pro
pro	pró
max	max
qualsiasi	qualquer
africa	áfrica
lingue	línguas
memoria	memória
amici	amigos
maestro	mestre
bambino	criança
unito	unido
libero	livre
giacomo	tiago
armata	armada
fratelli	irmãos
vera	vera
standard	padrão
forme	formas
jack	jack
qualcuno	alguém
svg	svg
smith	smith
scoperto	descobriu
scoperto	descoberto
fondazione	fundação
nomi	nomes
importanza	importância
distribuito	distribuído
particolarmente	particularmente
cambio	câmbio
festa	festa
cattolica	católica
cuore	coração
villaggio	aldeia
cerca	pesquisar
scrivere	escrever
buon	bom
partecipanti	participantes
morto	morto
dietro	atrás
apertura	abertura
louis	louis
vittorie	vitórias
chiese	igrejas
galleria	galeria
veniva	vinha
esperienza	experiência
parola	palavra
verde	verde
vince	vince
vince	ganha
sceneggiatore	roteirista
successivi	sucessivos
contributi	contribuições
preso	tomado
preso	pegou
bambini	crianças
santi	santos
fatti	fatos
luca	lucas
passa	passa
facendo	fazendo
servizi	serviços
navi	navios
dedicato	dedicado
with	with
partecipato	participou
elenco	lista
formula	fórmula
arrivo	chegada
titolare	titular
latino	latim
sicilia	sicília
elaborazione	processamento
international	international
open	open
lorenzo	lorenzo
letteratura	literatura
libertà	liberdade
bronzo	bronze
tecniche	técnicas
fascia	faixa
continua	continua
ambiente	ambiente
andare	ir
missione	missão
regionale	regional
arriva	chega
evitare	evitar
frank	frank
dovrebbe	deveria
dovrebbe	deve
composta	composta
henry	henry
costruito	construído
intervento	intervenção
pietra	pedra
europea	europeia
case	casas
show	show
bandiera	bandeira
proposta	proposta
national	national
critica	crítica
tecnico	técnico
foto	fotos
arbitro	árbitro
blocca	bloquear
vedi	veja
percorso	caminho
one	one
quartiere	bairro
cinese	chinês
svizzera	suíça
luoghi	locais
blu	azul
nobile	nobre
trattato	tratado
american	american
diritti	direitos
eletto	eleito
soldati	soldados
king	king
federazione	federação
passaggio	passagem
off	off
ragazzo	menino
ottenuto	obtido
male	mal
confronti	comparações
rossi	rossi
carattere	caráter
bottom	bottom
monaco	mónaco
angeles	angeles
soggetto	sujeito
soggetto	tópico
rappresenta	representa
operazione	operação
sorella	irmã
aree	áreas
vincitore	vencedor
lee	lee
raccoglie	coleta
permette	permite
sicurezza	segurança
passo	passo
xvi	xvi
biblioteca	biblioteca
brasile	brasil
sistemi	sistemas
volo	voo
web	web
significa	significa
architettura	arquitetura
simili	similares
simili	semelhantes
necessario	necessário
difficoltà	dificuldade
under	under
punteggio	pontuação
tema	tema
animali	animais
ingresso	entrada
piccole	pequenas
val	val
olandese	holandês
musicista	músico
deriva	deriva
caccia	caça
creazione	criação
nasce	nasce
poteva	podia
noi	nós
cesare	césar
colori	cores
diff	diff
cattedrale	catedral
stampa	imprensa
mosca	moscovo
lettera	letra
europei	europeus
appartenente	pertencente
messa	missa
esistono	existem
austria	áustria
singolare	singular
pos	pos
esemplari	espécimes
daniel	daniel
insee	insee
voti	votos
motivi	motivos
motivi	razões
giulio	júlio
giulio	giulio
pubblicazione	publicação
berlino	berlim
onore	honra
super	super
conoscenza	conhecimento
mettere	colocar
aperto	aberto
semplicemente	simplesmente
blocco	bloco
maglia	malha
corsa	corrida
pratica	prática
commissione	comissão
generalmente	geralmente
attenzione	atenção
play	play
period	period
arco	arco
autorità	autoridade
campi	campos
oggetti	objectos
domenico	domingos
autori	autores
origini	origens
abbastanza	bastante
bob	bob
tedeschi	alemães
lettere	letras
effetto	efeito
resistenza	resistência
tentativo	tentativa
intera	inteira
xix	xix
west	west
orientation	orientation
gestione	gerência
gestione	gestão
canvas	canvas
scala	escala
censimento	recenseamento
chris	chris
die	die
contrario	contrário
partecipazione	participação
mike	mike
vincenzo	vincenzo
prendere	tomar
modifiche	alterações
omonimo	xará
canadese	canadense
scalemajor	scalemajor
passare	passar
timeaxis	timeaxis
imagesize	imagesize
famiglie	famílias
plotarea	plotarea
svedese	sueco
australia	austrália
match	match
best	best
secoli	séculos
grand	grand
press	press
ottiene	obtém
esterno	exterior
sangue	sangue
dateformat	dateformat
sergio	sérgio
traduzione	tradução
piani	planos
padova	pádua
ricevuto	recebido
intero	inteiro
pierre	pierre
ghiaccio	gelo
chiaro	claro
trovato	encontrei
trovato	encontrado
cina	china
censiti	recenseados
justify	justify
alignbars	alignbars
backgroundcolors	backgroundcolors
alpi	alpes
scaleminor	scaleminor
supporto	suporte
nicola	nicolau
difficile	difícil
voto	voto
lotta	luta
ragazzi	galera
india	índia
misura	medida
pianta	planta
termini	termos
occhi	olhos
bianca	bianca
regioni	regiões
spacewatch	spacewatch
california	califórnia
costruita	construída
marcatore	marcador
spettatori	espectadores
premi	prêmios
risposta	resposta
inserito	inserido
nessun	nenhum
medio	médio
commenta	comenta
atleta	atleta
culturale	cultural
entrambe	ambas
realizzazione	realização
secondi	segundos
utilizzata	utilizada
modelli	modelos
verrà	virá
politiche	políticas
sesso	sexo
portò	levou
ragione	razão
strumenti	ferramentas
steve	steve
contenuto	conteúdo
famoso	famoso
juan	juan
terreno	terreno
piedi	pés
cielo	céu
notevole	notável
rossa	vermelha
xiii	xiii
durata	duração
componenti	componentes
analisi	análise
maggioranza	maioria
usare	usar
appunto	precisamente
tempio	templo
gesù	jesus
quantità	quantidade
joe	joe
concerto	concerto
mani	mãos
jones	jones
minori	menores
austriaco	austríaco
williams	williams
filosofia	filosofia
natale	natal
discussioni	discussões
aggiunta	adicionando
disponibile	disponível
vienna	viena
guardia	guarda
competizione	competição
attivo	ativo
conflitto	conflito
partecipa	participe
confine	fronteira
stelle	estrelas
crisi	crise
moderna	moderna
avvocato	advogado
quarta	quarta
claudio	claudio
bassi	baixos
facciata	fachada
entra	entra
descrizione	descrição
nata	nascida
raggiunto	atingido
raggiunto	alcançado
avendo	tendo
fondato	fundado
avanti	avançar
conquista	conquista
esistenza	existência
entrò	entrou
canada	canadá
aereo	avião
anime	anime
economia	economia
devono	devem
regole	regras
detta	dita
trasmissione	transmissão
air	air
tornare	voltar
criteri	critérios
sarebbero	seriam
pianeta	planeta
segno	sinal
romani	romanos
edifici	edifícios
pianoforte	piano
acque	águas
maschi	machos
sapere	saber
doveva	devia
time	time
nessuna	nenhuma
scott	scott
guglielmo	guilherme
legno	madeira
altare	altar
amministrazione	administração
fossero	fossem
poche	poucas
guest	guest
storie	histórias
terminata	terminada
ospedale	hospital
bordo	bordo
funzioni	funções
metodo	método
strutture	estruturas
operazioni	operações
trono	trono
nazioni	nações
simon	simon
image	image
rispettivamente	respectivamente
red	red
religione	religião
vecchia	velha
commerciale	comercial
uscì	saiu
arma	arma
indica	indica
house	house
conseguenza	consequência
ufficialmente	oficialmente
trasporto	transporte
scene	cenas
teste	cabeças
utile	útil
life	life
royal	royal
vii	vii
aiutare	ajudar
signore	senhor
imperiale	imperial
cristo	cristo
monastero	mosteiro
contatto	contato
diffusione	difusão
lascia	deixa
white	white
big	big
tipi	tipos
dollari	dólares
territori	territórios
lavorare	trabalhando
lavorare	trabalhar
amministratore	administrador
orbita	órbita
walter	walter
madrid	madrid
letto	cama
disposizione	disposição
leone	leão
ala	asa
genitori	pais
xii	xii
simbolo	símbolo
quinto	quinto
xviii	xviii
ingegnere	engenheiro
bgcolor	bgcolor
luna	lua
resti	restos
argentina	argentina
stemma	brasão
leggi	leia
religioso	religioso
spirito	espírito
soluzione	solução
statistiche	estatísticas
iniziata	iniciada
ministero	ministério
niente	nada
computer	computadores
merito	mérito
merito	mereço
morti	mortos
settimane	semanas
series	series
protezione	proteção
protezione	protecção
bari	bari
ufficio	escritório
filosofo	filósofo
vai	vai
sur	sur
ultime	últimas
harry	harry
danni	danos
atti	atos
chitarrista	guitarrista
azioni	acções
azioni	ações
xvii	xvii
und	und
numeri	números
ferro	ferro
protetta	protegida
avesse	tivesse
messico	méxico
normale	normal
traccia	faixa
siamo	somos
washington	washington
scelto	escolhido
messaggio	mensagem
entrare	entrar
borgo	borgo
out	out
categorie	categorias
parma	parma
united	united
iniziato	começou
geografia	geografia
latitudine	latitude
sonora	sonora
strumento	ferramenta
brasiliano	brasileiro
colpo	batida
colpo	golpe
brian	brian
uscito	saiu
ipotesi	pressupostos
influenza	gripe
vivo	vivo
modalità	modo
night	night
organo	órgão
capire	compreender
giallo	amarelo
metropolitana	metrô
grecia	grécia
leader	líderes
mura	muralhas
scienze	ciências
celebre	célebre
comitato	comité
that	that
etichetta	rótulo
#aaa	#aaa
scritti	escritos
coda	fila
coda	cauda
park	park
chiede	pede
considerata	considerada
incidente	acidente
xiv	xiv
sostituito	substituído
jim	jim
verona	verona
basilica	basílica
composizione	composição
guido	guido
significato	significado
responsabile	responsável
solid	solid
femmine	fêmeas
valign	valign
abbiamo	temos
fede	fé
prove	ensaios
nemico	inimigo
documenti	documentos
specialità	especialidade
poteri	poderes
young	young
segretario	secretário
istituzione	instituição
decreto	decreto
iniziale	inicial
concetto	conceito
venivano	vinham
edit	edit
sesto	sexto
gradi	graus
lasciare	deixar
rivoluzione	revolução
bill	bill
motori	motores
tiro	tiro
campioni	amostras
intitolato	intitulado
differenti	diferentes
abitato	habitado
piante	plantas
temperatura	temperatura
imprenditore	empresário
vivere	viver
perso	perdeu
brescia	brescia
americana	americana
awards	awards
asteroide	asteróide
riprese	filmagem
riprese	filmagens
longitudine	longitude
benedetto	abençoado
carlos	carlos
scoperta	descoberta
culto	culto
guerre	guerras
carta	cartão
fuga	fuga
tony	tony
post	post
usata	usada
notare	notar
ungherese	húngaro
macchina	automóvel
cavallo	cavalo
decisione	decisão
obiettivo	objetivo
euro	euro
chicago	chicago
oscar	oscar
tradizionale	tradicional
enciclopedica	enciclopédico
ciclo	ciclo
vice	vice
viii	viii
internet	internet
presentato	apresentado
sovietica	soviética
edward	edward
scuole	escolas
reggimento	regimento
difensore	defender
sconfitto	derrotado
olio	óleo
possiede	possui
costituita	constituída
conosciuta	conhecida
diverso	diferente
privata	privada
fisico	físico
talk	talk
pezzi	peças
critico	crítico
immediatamente	imediatamente
cittadina	cidadã
registrato	gravado
registrato	registado
raggiunge	atinge
dubbio	dúvida
pensiero	pensamento
ebbero	tiveram
commedia	comédia
terre	terras
realizzata	realizada
introduzione	introdução
dotato	dotado
principio	princípio
amm	mva
punta	ponta
deciso	decidido
alexander	alexander
test	teste
caps	caps
egitto	egito
valori	valores
portiere	goleiro
avrebbero	teriam
uefa	uefa
ricerche	pesquisas
dominio	domínio
mantenere	manter
brown	brown
conti	contas
omonima	homónima
parlare	falar
elemento	elemento
your	your
zero	zero
giocare	jogar
cittadini	cidadãos
compare	aparece
resta	fica
day	day
corrente	corrente
hall	hall
scultore	escultor
jan	jan
articoli	artigos
amministrativa	administrativa
nipote	neto
title	title
php	php
dischi	discos
polacco	polonês
riforma	reforma
posso	posso
statua	estátua
clubnat	clubnat
software	software
speciali	especiais
necessità	necessidade
attacchi	ataques
principessa	princesa
debutto	estréia
montagna	montanha
malattia	doença
livelli	níveis
professore	professor
felice	feliz
nera	preta
denominazione	denominação
flotta	frota
sin	sin
argentino	argentino
salvatore	salvador
comportamento	comportamento
corona	coroa
costituzione	constituição
combattimento	combate
copyright	copyright
nostra	nossa
parlamento	parlamento
caduta	queda
visione	visão
sviluppato	desenvolvido
mette	coloca
rivolta	revolta
capitolo	capítulo
sovrano	soberano
vide	viu
dvd	dvd
prodotta	produzida
consenso	consentimento
vedo	vejo
pisa	pisa
compito	tarefa
notizie	notícias
rilievo	relevo
pio	pio
concorso	concurso
utilizzati	utilizados
inglesi	ingleses
france	france
partenza	partida
sam	sam
figure	figuras
rischio	risco
olimpici	olímpicos
nazione	nação
primavera	primavera
london	london
agente	agente
nazionalità	nacionalidade
college	faculdade
aperta	aberta
umano	humano
beni	bens
sardegna	sardenha
indipendenza	independência
materiali	materiais
eccentricità	excentricidade
banda	banda
commercio	comércio
png	png
bianchi	brancos
legate	ligadas
nove	nove
diego	diego
ali	asas
completa	completa
can	can
svolge	desempenha
televisione	televisão
sceneggiatura	roteiro
laura	laura
basato	baseado
riccardo	ricardo
fiori	flores
vergine	virgem
spettacolo	show
byte	bytes
posizioni	posições
polonia	polónia
toscana	toscana
fanteria	infantaria
piero	piero
admin	admin
lasciato	deixado
costruire	construir
canto	canto
alex	alex
modifica	editar
marino	marinho
coro	coro
frase	frase
industria	indústria
uccidere	matar
asia	ásia
lord	lord
lord	lorde
atp	atp
comunicazione	comunicação
hockey	hóquei
rugby	rugby
scrittrice	escritora
norvegese	norueguês
serve	serve
johnson	johnson
politici	políticos
racconto	conto
umani	humanos
bretagna	bretanha
vescovi	bispos
potente	poderosa
esclusivamente	exclusivamente
elezione	eleição
tribù	tribo
personalità	personalidade
finalista	finalista
indicare	indicar
interpretazione	interpretação
christian	christian
definizione	definição
partecipare	participar
convento	convento
interpretata	interpretada
portale	portal
province	províncias
legato	amarrado
centri	centros
protagonisti	protagonistas
assegnato	atribuído
nemici	inimigos
elettrica	elétrica
errore	erro
mondadori	mondadori
recente	recente
semi	sementes
settanta	setenta
leonardo	leonardo
originariamente	originalmente
universo	universo
domenica	domingo
pressione	pressão
puntata	aposta
arthur	arthur
limite	limite
presa	tomada
first	first
ottanta	oitenta
medici	médicos
collega	colega
collega	lig
chilometri	quilómetros
volontà	vontade
assenza	ausência
filmografia	filmografia
porte	portas
orario	horário
indipendente	independente
caratteristica	característica
abilità	habilidade
governatore	governador
giusto	certo
catastale	cadastral
blue	blue
umana	humana
monumento	monumento
classica	clássica
materia	matéria
creata	criada
patria	pátria
dipinto	pintura
date	datas
carico	carga
fenomeno	fenômeno
roger	roger
interamente	inteiramente
alleanza	aliança
forti	fortes
vie	vias
sigla	sigla
copie	cópias
gianni	gianni
condizione	condição
regime	regime
lancio	lançamento
aspetti	espere
citato	citado
pista	pista
rivela	revela
centrocampista	centroavante
linguaggio	linguagem
facilmente	facilmente
espressione	expressão
iso	iso
appartiene	pertence
manifestazione	manifestação
pieno	cheio
belga	belga
giustizia	justiça
venti	vinte
collezione	coleção
ritiro	retiro
firma	assinatura
siti	sites
poesia	poesia
occhio	olho
cavaliere	cavaleiro
inizi	comece
segreto	segredo
santuario	santuário
little	little
miss	miss
taylor	taylor
racconti	contos
gas	gás
lady	lady
relativa	relativa
latina	latina
trovava	encontrava
superiori	superiores
prestito	empréstimo
baviera	baviera
ciclista	ciclista
aerei	aviões
signora	senhora
fondatore	fundador
sindaco	prefeito
visita	visita
dinastia	dinastia
identità	identidade
dimensione	tamanho
finalmente	finalmente
sacro	sagrado
emilia	emilia
basta	basta
portata	alcance
mezzi	meios
salute	saúde
chiara	chiara
cori	cori
veneto	veneto
maurizio	maurício
oriente	oriente
war	war
proprietario	proprietário
principi	princípios
volumi	volumes
marie	marie
programmi	programas
finali	finais
grave	grave
informazione	informaçoes
siena	siena
davis	davis
real	real
economico	econômico
archivio	arquivo
fortemente	fortemente
contesto	contexto
matteo	mateus
catena	cadeia
jackson	jackson
albert	albert
https	https
definito	definido
elena	helena
rimasto	permaneceu
vale	vale
ray	ray
domanda	pergunta
danno	dano
arrivare	chegar
svezia	suécia
studenti	estudantes
appartenenti	pertencentes
occupa	ocupa
habitat	habitat
classico	clássico
faccia	cara
faccia	faça
pop	pop
catania	catania
cristiana	cristã
permesso	permissão
challenger	challenger
viola	viola
varietà	variedade
km²	km²
circuito	circuito
disegno	desenho
antiche	antigas
discorso	discurso
targa	matrícula
attaccante	atacante
saranno	serão
reazione	reação
spedizione	expedição
medicina	medicina
gente	gente
eric	eric
abbazia	abadia
muto	mudo
piloti	pilotos
eccezione	exceção
sessanta	sessenta
vincere	ganhar
rendere	tornar
suddivisione	subdivisão
compreso	incluindo
successive	sucessivas
posteriore	traseiro
faceva	fazia
riceve	recebe
ferrari	ferrari
calabria	calábria
dizionario	dicionário
giornale	jornal
provinciale	provincial
home	home
registrazione	gravação
girl	girl
medievale	medieval
ungheria	hungria
possesso	posse
monumenti	monumentos
trasmessa	transmitida
portoghese	português
sezioni	secções
contemporanea	contemporânea
fuso	fuso
colonne	colunas
utilizzando	usando
barbara	barbara
carte	cartas
giardino	jardim
foglie	folhas
street	street
stanza	quarto
kevin	kevin
green	green
savoia	saboia
interventi	intervenções
compagni	companheiros
idee	idéias
assedio	cerco
indicato	indicado
potuto	pôde
confini	fronteiras
www	www
spada	espada
consiste	consiste
regolare	ajustar
civili	civis
ospita	hospeda
online	online
naturali	naturais
aumento	aumento
lavora	trabalha
chiave	chave
seguire	siga
penso	penso
penso	acho
compagno	camarada
scozzese	escocês
affari	negócios
irlandese	irlandês
vetrina	vitrine
albero	árvore
relazioni	relatórios
augusto	augusto
esecuzione	execução
imho	imho
parziale	parcial
precedenza	precedência
successi	sucessos
reggio	reggio
hill	hill
esempi	exemplos
documento	documento
caratterizzato	caracterizado
nucleo	núcleo
insegnante	professor
hans	hans
ebrei	judeus
congresso	congresso
patrick	patrick
artiglieria	artilharia
gentile	gentil
jazz	jazz
davvero	realmente
banca	banco
concerti	concertos
gigante	gigante
trieste	trieste
arcidiocesi	arquidiocese
lasciando	deixando
barcellona	barcelona
karl	karl
salvare	salvar
minimo	mínimo
vicina	vizinha
dando	dando
ordini	encomendas
giudizio	julgamento
autonoma	autônoma
tesi	tese
opinione	opinião
mediterraneo	mediterrâneo
jacques	jacques
moto	moto
vittime	vítimas
colonia	colônia
colonia	colónia
somma	soma
crescita	crescimento
regionali	regionais
giudice	juiz
lati	lados
andrew	andrew
messina	messina
recenti	recentes
costituisce	constitui
cambiare	mudar
portogallo	portugal
renato	renato
americani	americanos
tokyo	tóquio
alleati	aliados
lontano	longe
variante	variante
dichiarato	declarado
estremamente	extremamente
françois	françois
leggenda	lenda
disponibili	disponíveis
costante	constante
luis	luis
precedentemente	anteriormente
generazione	geração
piattaforma	plataforma
belgio	bélgica
modena	modena
famosa	famosa
biografia	biografia
digitale	digital
mente	mente
omicidio	assassinato
omicidio	homicídio
fotografia	fotografia
umberto	umberto
caterina	catarina
afferma	afirma
nostro	nosso
abate	abade
mauro	mauro
tommaso	tommaso
svolta	viragem
conosce	conhece
aldo	aldo
high	high
dotata	dotada
comunista	comunista
kim	kim
alfonso	afonso
dentro	dentro
vantaggio	vantagem
riconoscimento	reconhecimento
game	game
mandato	mandato
interpreti	intérpretes
ampio	amplo
zio	tio
pensare	pensar
rose	rosas
colonnello	coronel
visibile	visível
ritratto	retrato
scienza	ciência
luciano	luciano
termina	termina
termina	terminar
vendita	venda
perdita	perda
this	this
brigata	brigada
combattere	lutar
parere	parecer
novanta	noventa
carl	carl
generi	gêneros
tecnologia	tecnologia
scrittura	escrita
cover	cover
irlanda	irlanda
virginia	virgínia
suono	som
generali	generais
attiva	ativar
matematica	matemática
completo	completo
tipico	típico
ceco	checo
passione	paixão
ruoli	papéis
artistico	artístico
largo	largo
andré	andré
flag	flag
moderno	moderno
interni	interiores
concessione	concessão
anderson	anderson
affrontare	enfrentar
amministrativo	administrativo
tim	tim
votare	votar
trattamento	tratamento
contributo	contribuição
assoluto	absoluto
cimitero	cemitério
salvo	salvo
trofeo	troféu
espansione	expansão
amicizia	amizade
senato	senado
verdi	verdes
realizzare	realizar
fumetti	quadrinhos
originario	originário
temi	temas
invasione	invasão
lewis	lewis
chiedere	perguntar
mille	mil
inverno	inverno
componente	componente
avviso	aviso
ottocento	oitocentos
divisa	dividida
atene	atenas
alan	alan
collegamento	ligação
emanuele	emanuele
sposa	noiva
collegio	colégio
marchese	marquês
praticamente	praticamente
victor	victor
champions	champions
previsto	previsto
pokémon	pokémon
girato	filmado
cavalieri	cavaleiros
nick	nick
ivan	ivan
billy	billy
pezzo	peça
sovietico	soviético
novecento	novecentos
contenente	contendo
rappresentato	representado
automatico	automático
napoleone	napoleão
resa	rendição
specialmente	especialmente
promosso	promovido
inclinata	inclinada
corsi	cursos
lazio	lazio
anima	alma
song	song
evidente	evidente
wilson	wilson
sufficiente	suficiente
stretto	estreito
dialetto	dialecto
lavorato	trabalhou
dodici	doze
texas	texas
immediata	imediata
docente	docente
fabio	fabio
emilio	emilio
regola	regra
clima	clima
pil	pib
prix	prix
cittadino	cidadão
pittura	pintura
enorme	enorme
simone	simone
google	google
men	men
presentano	apresentem
presentano	apresentam
atletica	atletismo
scientifico	científico
tenente	tenente
vento	vento
howard	howard
gaetano	gaetano
cristiano	cristiano
laterali	laterais
braccio	braço
angolo	ângulo
attori	atores
solare	solar
specifico	específico
danese	dinamarquês
angeli	anjos
eclittica	eclíptica
movimenti	movimentos
chiama	chama
spalle	ombros
back	back
adam	adam
favorevoli	favoráveis
sfida	desafio
will	will
vorrei	gostaria
avversario	adversário
interpreta	interpreta
documentario	documentário
lunghi	comprido
equipaggio	tripulação
facile	fácil
prevede	prevê
stazioni	estações
studiosi	estudiosos
parrocchia	paróquia
estende	estende
diffusa	difusa
impianti	instalações
windows	windows
relativamente	relativamente
leggermente	levemente
leggermente	ligeiramente
fortuna	fortuna
fortuna	sorte
traffico	tráfego
prestazioni	desempenho
jimmy	jimmy
trenta	trinta
segnali	sinais
tornato	voltou
society	society
ampia	ampla
ciao	olá
esposizione	exposição
ford	ford
alessandria	alexandria
assemblea	assembleia
assemblea	assembléia
foresta	floresta
dante	dante
corpi	corpos
musicisti	músicos
miniserie	minissérie
ispirato	inspirado
piena	cheia
penisola	península
force	force
potevano	podiam
cinquanta	cinquenta
agostino	agostinho
discografico	discográfico
doppiatore	dublador
slalom	slalom
paura	medo
history	history
motivazione	motivação
anti	anti
sostegno	apoio
candidato	candidato
cannoni	canhões
letterario	literário
infanzia	infância
inviato	afixado
religiose	religiosas
capace	capaz
lettura	leitura
originali	originais
occupazione	emprego
anne	anne
popolazioni	populações
fasi	fases
rappresentazione	representação
fernando	fernando
capelli	cabelo
restauro	restauração
daniele	daniele
possibili	possíveis
detentore	detentor
colle	colas
tastiere	teclados
estratto	extrato
costo	custo
aquila	águia
parrocchiale	paroquial
romanzi	romances
fusione	fusão
saga	saga
francis	francis
assoluta	absoluta
assolutamente	absolutamente
fama	fama
autonomia	autonomia
goals	goals
vino	vinho
assistente	assistente
remix	remix
vincitori	vencedores
copertina	capa
ricostruzione	reconstrução
vicenza	vicenza
disputato	disputou
boy	boy
johann	johann
alice	alice
individuale	individual
perde	perde
pericolo	perigo
legati	amarrados
suolo	solo
cast	elenco
iniziativa	iniciativa
tabella	tabela
organizzato	organizado
dovuta	devida
johnny	johnny
applicazione	aplicação
sogno	sonho
patrimonio	património
ragazze	meninas
sposato	casado
ferrara	ferrara
legata	amarrada
compresa	incluindo
risorse	recursos
commissario	comissário
occidentali	ocidentais
ugo	ugo
enzo	enzo
jeff	jeff
asse	eixo
denaro	dinheiro
intervista	entrevista
north	north
vota	vota
successione	sucessão
lucio	lucio
famosi	famosos
critiche	críticas
south	south
australiano	australiano
chiuso	fechado
sacerdote	sacerdote
tomba	túmulo
frutto	fruto
segnalazione	denúncia
votazioni	votações
estensione	extensão
amica	amiga
stephen	stephen
potrebbero	poderiam
dolce	doce
margherita	margarida
pellicola	película
diametro	diâmetro
sir	sir
bergamo	bergamo
dan	dan
anthony	anthony
distruzione	destruição
mantova	mantova
stare	ficar
usando	usando
tennista	tenista
modi	maneiras
trasferimento	transferência
perdere	perder
aerea	aérea
treni	comboios
chimica	química
long	long
livorno	livorno
usati	usados
romania	roménia
trama	trama
ceca	checa
anello	anel
passeggeri	passageiros
bruce	bruce
golden	golden
piemonte	piemonte
michel	michel
disputa	disputa
marcia	marcia
not	not
offre	oferece
pallavolo	voleibol
conoscere	conhecer
vendite	vendas
residenza	residência
ducato	ducado
trasporti	transportes
liberazione	libertação
ricco	rico
formare	formar
profondità	profundidade
edoardo	eduardo
alba	amanhecer
alfred	alfred
nobili	nobres
bacino	bacia
rocca	rocca
story	story
scientifica	científica
aggiunto	adicionado
rifugio	refúgio
alte	altas
andy	andy
fortezza	fortaleza
rapidamente	rapidamente
annunciato	anunciou
personalmente	pessoalmente
bosco	bosco
pelle	pele
classificazione	classificação
tranne	exceto
cambridge	cambridge
profilo	perfil
colpi	batidas
barone	barão
catalogo	catálogo
corretto	corrigido
migliorare	melhorar
federale	federal
giulia	júlia
indiano	índio
pubblicazioni	publicações
ammiraglio	almirante
cantone	cantão
istruzione	educação
saggio	sábio
ambienti	ambientes
association	association
socialista	socialista
cagliari	cagliari
manuel	manuel
produrre	produzir
caratteri	caracteres
apparizione	aparição
conservato	conservado
bibliografia	bibliografia
interessante	interessante
riuscito	conseguiu
design	design
doppia	duplo
orientali	orientais
are	are
contava	contava
purtroppo	infelizmente
olimpiadi	olimpíadas
avventura	aventura
possiamo	podemos
assunto	assumido
assunto	contratado
esercizio	exercício
impegno	compromisso
disegni	desenhos
british	british
urbano	urbano
perdite	perdas
las	las
collana	colar
town	town
cane	cão
blues	blues
death	death
ricca	rica
selezione	selecção
allen	allen
mobile	móvel
hollywood	hollywood
interrotta	interrompida
classificata	classificada
fabbrica	fábrica
intenzione	intenção
inserita	inserida
reali	reais
norma	norma
douglas	douglas
riferimenti	referências
liceo	liceu
continuare	continuar
vito	vito
teresa	teresa
aeronautica	aeronáutica
what	what
east	east
processi	processos
muro	parede
disney	disney
capito	entendi
colpito	bateu
consigliere	conselheiro
miller	miller
down	down
segna	marcar
scomparsa	desaparecimento
giuliano	juliano
fred	fred
pesante	pesado
errori	erros
piede	pé
impiegato	empregado
riconosciuto	reconhecido
civica	cívica
uguale	igual
ricordare	lembrar
diplomatico	diplomata
normalmente	normalmente
nomina	nomeação
sicuro	segura
fox	fox
gordon	gordon
veloce	rápido
manager	gerente
passando	passando
wrestling	wrestling
danimarca	dinamarca
scozia	escócia
bocca	boca
arena	arena
end	end
lunghe	longas
criminale	criminoso
trasmesso	transmitido
ritorna	volta
acido	ácido
francesca	francesca
ludovico	ludovico
elisabetta	isabel
robin	robin
who	who
leo	leo
percussioni	percussão
charlie	charlie
fiducia	confiança
org	org
svolto	desempenhou
battaglione	batalhão
fiat	fiat
salto	salto
aziende	empresas
fabrizio	fabrizio
raggio	raio
frequenza	frequência
atleti	atletas
tornei	torneios
alti	altos
erede	herdeiro
desiderio	desejo
matt	matt
lancia	lança
ken	ken
faccio	faço
chiamati	chamados
inserimento	inserção
lucia	lúcia
popolari	populares
bel	bel
infinito	infinito
trasferito	transferido
richieste	pedidos
minaccia	ameaça
jane	jane
marc	marc
girolamo	girolamo
oceano	oceano
pensa	pensa
scritte	escritas
recentemente	recentemente
sequenza	sequência
amante	amante
rilevante	relevante
pesi	pesos
ritirato	retirado
argomenti	tópicos
alfredo	alfredo
uscire	sair
voleva	queria
giapponesi	japoneses
missioni	missões
vittima	vítima
riva	riva
necessaria	necessária
tribunale	tribunal
metodi	métodos
prezzo	preço
limiti	limites
oxford	oxford
autunno	outono
meccanica	mecânica
cavalleria	cavalaria
basi	bases
descritto	descrito
archi	arcos
definita	definida
legame	laço
boston	boston
sanremo	sanremo
comunemente	comumente
trento	trento
trad	trad
perugia	perugia
avventure	aventuras
rocco	rocco
congregazione	congregação
finlandese	finlandês
gamma	gama
heart	heart
eva	eva
civiltà	civilização
panorama	panorama
land	land
vecchi	velhos
dipinti	pinturas
golfo	golfo
gabriele	gabriel
veramente	realmente
favorevole	favorável
trasformazione	transformação
pre	pré
aumentare	aumentar
wild	wild
prigionieri	prisioneiros
agricoltura	agricultura
israele	israel
accusa	acusação
carri	vagões
responsabilità	responsabilidade
road	road
franz	franz
morire	morrer
gregorio	gregório
dark	dark
fame	fome
treno	comboio
davide	davi
states	states
last	last
fan	fã
chiedo	pergunto
chiedo	peço
pdf	pdf
copia	copiar
condotta	conduta
milan	milan
privato	privado
morale	moral
henri	henri
aires	aires
eroe	herói
alpino	alpino
adriano	adriano
tipologia	tipologia
segni	sinais
incluso	incluído
acquistato	comprou
acquistato	comprado
greci	gregos
pasquale	pasquale
pontificio	pontifício
buenos	buenos
proposto	propôs
corse	corridas
espresso	expresso
introdotto	introduzido
sassonia	saxônia
fiumi	rios
friedrich	friedrich
uccelli	aves
elizabeth	elizabeth
status	status
cavalli	cavalos
organizzata	organizada
variabile	variável
mix	mix
pianista	pianista
cibo	comida
annuale	anual
cristiani	cristãos
migliaia	milhares
moore	moore
indoor	indoor
divinità	divindade
acciaio	aço
campagne	campanhas
corrispondenza	correspondência
violino	violino
bonus	bônus
campanile	campanário
settimo	sétimo
tradizionali	tradicionais
differenze	diferenças
razza	raça
laboratorio	laboratório
abbandonato	abandonado
corrispondente	correspondente
baseball	beisebol
sostituzione	substituição
oliver	oliver
brevi	breves
limitata	limitada
avrà	terá
costi	custos
occasioni	ocasiões
probabile	provável
ryan	ryan
prefettura	prefeitura
interessi	juros
hot	hot
fornire	fornecer
opposizione	oposição
istituzioni	instituições
poesie	poemas
dura	dura
elettronica	eletrônica
eliminazione	eliminação
monete	moedas
pareti	paredes
stone	stone
convinto	convencido
spaziale	espacial
arabo	árabe
dave	dave
torrente	torrente
sinistro	esquerdo
menzionato	mencionado
vuoi	quer
marmo	mármore
sky	sky
indiana	indiana
russell	russell
scontri	confrontos
way	way
periodi	períodos
commento	comentário
certamente	certamente
composti	compostos
nostri	nossos
terrestre	terrestre
gloria	glória
riescono	conseguem
jonathan	jonathan
western	western
andato	ido
turchia	turquia
relativo	relativo
continuo	continuo
continuo	contínuo
sun	sun
vincitrice	vencedora
classi	classes
alternativa	alternativa
cognome	apelido
realizza	realiza
speranza	esperança
esattamente	exatamente
feat	feat
sembrano	parecem
montagne	montanhas
italo	italo
schermo	tela
norvegia	noruega
power	power
women	women
riduzione	redução
distretti	distritos
manuale	manual
conferenza	conferência
like	like
venduto	vendido
dick	dick
varianti	variantes
comics	comics
assume	contrata
pesce	peixe
gerusalemme	jerusalém
alberi	árvores
two	two
batterista	baterista
conclude	conclui
decenni	décadas
punk	punk
salerno	salerno
riviste	revistas
good	good
violenza	violência
jason	jason
ridotto	reduzido
considerazione	consideração
confronto	comparação
valutazione	avaliação
chiaramente	claramente
canali	canais
estremità	extremidade
estremità	extremidades
regio	regio
universale	universal
dance	dance
considerati	considerados
inutile	inútil
successore	sucessor
claude	claude
fascista	fascista
conservazione	conservação
offerta	oferta
roy	roy
bartolomeo	bartolomeu
senatore	senador
arrestato	preso
colspan	colspan
soldi	dinheiro
capisce	entende
son	son
propone	propõe
arrivando	chegando
cenni	acenos
bernard	bernard
democratico	democrata
include	inclui
misure	medidas
stub	stub
risolvere	resolver
ombra	sombra
giunta	junta
year	year
paola	paula
logo	logótipo
logo	logotipo
deputato	deputado
deputato	congressista
virtù	virtudes
agenzia	agência
partiti	partidos
altitudine	altitude
cerimonia	cerimônia
distrutto	destruído
boss	boss
oratorio	oratório
superare	superar
free	free
sostanza	substância
spiega	explica
bad	bad
varia	varia
ancona	ancona
ospite	convidado
versi	versos
organi	órgãos
sofia	sofia
medaglie	medalhas
religiosi	religiosos
tag	tag
jordan	jordan
paragrafo	parágrafo
confederazione	confederação
special	special
musical	musical
navigazione	navegação
performance	performance
fondi	fundos
box	box
bernardo	bernardo
raffaele	rafael
cambiato	mudado
cambiato	mudou
tipica	típica
venire	vir
eugenio	eugenio
portando	levando
comprendeva	incluía
osservazione	observação
classifiche	recordes
corea	coreia
html	html
formazioni	formações
copertura	cobertura
beach	beach
possano	possam
costantinopoli	constantinopla
entrato	entrou
larghezza	largura
dettagli	detalhes
vendetta	vingança
garibaldi	garibaldi
gian	gian
clemente	clemente
martire	mártir
pesanti	pesados
spazi	espaços
yard	yard
preparazione	preparação
carolina	carolina
condannato	condenado
esperto	perito
rappresentanti	representantes
cento	cem
voi	vocês
cucina	cozinha
einaudi	einaudi
affidata	confiada
sepolto	enterrado
specifica	especificação
costellazione	constelação
eccellenza	excelência
ideale	ideal
unite	unidas
firmato	assinado
sconfitte	derrotas
prevedeva	previa
castel	castel
ricordi	lembranças
system	system
nicolas	nicolas
umanità	humanidade
montana	montana
baby	baby
discesa	descida
cristina	cristina
terremoto	terramoto
cemento	cimento
space	space
legale	legal
ucraina	ucrânia
tasso	taxa
esistente	existente
kelly	kelly
private	private
sabato	sábado
portano	levam
portano	trazem
qualificazione	qualificação
arrivato	chegou
cause	causas
agenti	agentes
compresi	incluindo
descrive	descreve
tastiera	teclado
veicoli	veículos
fatte	feitas
accetta	aceita
clan	clã
impatto	impacto
gary	gary
programmazione	programação
vicini	vizinhos
fattori	fatores
diviso	dividido
dead	dead
sessuale	sexual
praga	praga
turco	turco
dimostra	demonstra
steven	steven
statue	estátuas
sto	estou
centinaia	centenas
pavia	pavia
larga	larga
great	great
rappresentante	representante
tradotto	traduzido
min	min
old	old
dolore	dor
studiare	estudar
impossibile	impossível
vissuto	vivi
wayne	wayne
accademico	acadêmico
gino	gino
chiesto	perguntado
abbandonare	abandonar
manifestazioni	manifestações
entità	entidade
portarono	trouxeram
tensione	tensão
toni	toni
produce	produz
milanese	milanesa
hamilton	hamilton
progettato	projetado
insegnamento	ensino
conferma	confirmação
tradizioni	tradições
danza	dança
tentativi	tentativas
turismo	turismo
popoli	povos
inter	inter
chimico	químico
vasta	vasta
sydney	sydney
compagnie	companhias
segreti	segredos
pietroburgo	petersburgo
vivono	vivem
magia	magia
christopher	christopher
stranieri	estrangeiros
associazioni	associações
eseguito	executado
patto	pacto
candidatura	candidatura
sánchez	sánchez
river	river
drago	dragão
prato	gramado
ligure	ligure
fedeli	fiéis
bryan	bryan
iscrizione	inscrição
dubbi	dúvidas
prigione	prisão
conclusione	conclusão
britannici	britânicos
utc	utc
tecnici	técnicos
dimostrato	demonstrado
loneos	loneos
giancarlo	giancarlo
collina	colina
kong	kong
contrasto	contraste
animazione	animação
recupero	recuperação
corporation	corporation
eliminato	eliminado
conserva	conserva
scambio	troca
gatto	gato
elettrico	elétrico
esame	exame
procedure	procedimentos
requisiti	requisitos
cilindri	cilindros
ross	ross
rito	rito
densità	densidade
citata	citada
maurice	maurice
decennio	década
esemplare	exemplar
araldica	heráldica
miei	meus
battaglie	batalhas
santiago	santiago
romeo	romeu
gold	gold
giurista	jurista
proposte	propostas
schema	esquema
his	his
corrado	corrado
vasto	vasto
iata	iata
inferiori	inferiores
nba	nba
clark	clark
rapper	rapper
romagna	romagna
silvio	silvio
ernesto	ernesto
pacifico	pacífico
parzialmente	parcialmente
adams	adams
voglia	queira
amsterdam	amesterdão
passi	passos
treviso	treviso
fantasy	fantasy
vocale	vocal
polo	polo
indice	índice
imprese	empresas
castelli	castelos
tetto	telhado
here	here
pier	pier
teologo	teólogo
recuperare	recuperar
moderni	modernos
institute	institute
florida	flórida
uccide	mata
playoff	playoffs
vuoto	vazio
gilbert	gilbert
stabile	estável
detective	detetive
rappresentata	representada
friuli	friuli
bell	bell
questioni	questões
ingegneria	engenharia
vincent	vincent
sound	sound
juventus	juventus
familiari	familiares
miliardi	bilhões
ordinato	ordenado
giovanna	joana
cile	chile
realizzate	realizadas
individui	indivíduos
killer	killer
eddie	eddie
ettore	heitor
ceduto	cedido
emisfero	hemisfério
wikimedia	wikimedia
lavoratori	trabalhadores
morta	morta
maschio	macho
rappresentano	representam
sostituire	substituir
malgrado	apesar
nucleare	nuclear
fumo	fumaça
letteraria	literária
indipendenti	independentes
disegnato	desenhado
confermato	confirmado
lupo	lobo
presidenza	presidência
silva	silva
diretti	diretos
letteralmente	literalmente
bolla	bolha
coinvolto	envolvido
drammaturgo	dramaturgo
teorie	teorias
aggiunte	adições
vigore	vigor
finlandia	finlândia
ferito	ferido
villaggi	aldeias
modificato	modificado
esistenti	existentes
dicendo	dizendo
law	law
sviluppa	desenvolve
phil	phil
nino	nino
tutt	tud
cambiamento	mudança
flusso	fluxo
invito	convite
columbia	columbia
editoriale	editorial
georges	georges
notevoli	notáveis
mattina	manhã
minuto	minuto
miglia	milhas
pictures	pictures
grant	grant
situazioni	situações
book	book
dover	dover
novara	novara
cambiamenti	mudanças
minor	minor
guy	guy
olimpico	olímpico
democrazia	democracia
professionale	profissional
scoprire	descobrir
indirizzo	endereço
jerry	jerry
moda	moda
edition	edition
partendo	partindo
richiede	exige
richiede	requer
etc	etc
ridurre	reduzir
raymond	raymond
vite	parafuso
fenomeni	fenômenos
zelanda	zelândia
esseri	seres
prototipo	protótipo
hard	hard
rosario	rosário
presentazione	apresentação
assalto	assalto
tante	tantas
professione	profissão
fermata	parar
deputati	deputados
staffetta	revezamento
virus	vírus
conquistare	conquistar
audio	áudio
samuel	samuel
applicazioni	aplicações
carter	carter
junior	junior
server	servidor
bassista	baixista
carne	carne
cantata	cantada
pesci	peixes
spero	espero
esilio	exílio
lisa	lisa
version	version
criterio	critério
sconosciuto	desconhecido
rick	rick
robot	robô
apostolico	apostólico
bobby	bobby
momenti	momentos
stewart	stewart
saggista	ensaísta
aragona	aragão
fiore	flor
sorpresa	surpresa
costantino	constantino
guidato	guiado
merci	mercadorias
determinato	determinado
soldato	soldado
ispirazione	inspiração
conseguenze	consequências
terreni	terrenos
botanico	botânico
bay	bay
ridotta	reduzida
astronomo	astrónomo
testimonianza	testemunho
celeste	celeste
stabilito	estabelecido
rimangono	permanecem
acquisto	compra
woman	woman
assunta	contratada
was	was
type	type
sarah	sarah
calendario	calendário
barry	barry
ball	ball
potenti	poderosas
laterale	lateral
prevista	prevista
cresciuto	cresceu
bit	bits
figlie	filhas
adattamento	adaptação
mitologia	mitologia
herbert	herbert
piacenza	piacenza
grigio	cinzento
classici	clássicos
botswana	botswana
botswana	botsuana
ricordato	lembrou
bloccato	bloqueado
pistola	pistola
nonno	avô
forniti	fornecidos
binari	trilhos
queen	queen
norman	norman
colpa	culpa
perù	peru
fallimento	falência
fallimento	fracasso
specifiche	especificações
tenore	tenor
fedele	fiel
taranto	taranto
juniores	juniores
pianura	planície
fornisce	fornece
nelson	nelson
misto	misto
atteggiamento	atitude
obiettivi	objetivos
donato	doado
vapore	vapor
naturalmente	naturalmente
parker	parker
assistenza	assistência
costituiscono	constituem
filo	fio
proteggere	proteger
conquistato	conquistado
ian	ian
cugino	primo
tesoro	querida
armati	armados
mba	mba
sponsor	patrocinadores
sponsor	patrocinador
scegliere	escolher
profondo	profundo
may	may
morgan	morgan
limitato	limitado
assumere	contratar
coppie	casais
ita	ita
paradiso	paraíso
margine	margem
spettacoli	shows
cronaca	crônica
light	light
citazione	citação
deserto	deserto
raggiungendo	alcançando
comico	comediante
voglio	quero
bizantino	bizantino
spese	despesas
accettare	aceitar
malattie	doenças
boys	boys
trattava	tratava
eseguita	executada
atmosfera	atmosfera
cat	cat
catturato	capturado
gene	gene
lucca	lucca
formano	formam
liste	listas
incendio	incêndio
udine	udine
over	over
partigiano	partidário
pov	pov
terry	terry
probabilità	probabilidade
girls	girls
colombo	colombo
playstation	playstation
simboli	símbolos
raramente	raramente
bowl	bowl
abbandono	abandono
parlato	falou
sostanze	substâncias
scusa	desculpa
dovevano	deviam
positivo	positivo
decorazione	decoração
addestramento	treinamento
fiorentina	florentina
dovrebbero	devem
dovrebbero	deveriam
scrittori	escritores
cattolici	católicos
prendendo	tomando
circolare	circular
pag	pag
hitler	hitler
arresto	batente
decidono	decidem
costruiti	construídos
organizzazioni	organizações
cross	cross
office	office
sorelle	irmãs
studiato	estudado
completato	concluído
neve	neve
ruote	rodas
asti	asti
ravenna	ravenna
arts	arts
vaticano	vaticano
calibro	calibre
approccio	abordagem
stima	estimativa
scienziato	cientista
fire	fire
pazienti	doentes
armato	armado
messaggi	mensagens
distruggere	destruir
concordo	concordo
marshall	marshall
uffici	escritórios
righe	linhas
scultura	escultura
varese	varese
parlando	falando
sente	sente
inferno	inferno
risoluzione	resolução
part	part
commenti	comentários
freddo	frio
stanley	stanley
pino	pino
pino	pinheiro
onde	ondas
das	das
dea	deusa
dario	dario
avversari	adversários
dipende	depende
party	party
pareggio	empate
femmina	fêmea
lloyd	lloyd
bruxelles	bruxelas
moon	moon
budapest	budapeste
aviazione	aviação
fort	fort
necessari	necessários
larry	larry
puglia	puglia
philip	philip
adottato	adotado
finito	terminou
inaugurato	inaugurado
pubblicità	publicidade
demo	demo
more	more
occupato	ocupado
mito	mito
testimonianze	testemunhos
marine	marine
radici	raízes
ella	ella
bolzano	bolzano
jay	jay
vietnam	vietname
diavolo	diabo
tommy	tommy
seguita	seguida
round	round
colombia	colômbia
dichiarazione	declaração
fermo	parado
georgia	geórgia
rowspan	rowspan
esperti	peritos
ampiamente	amplamente
ampiamente	extensivamente
lombardo	lombardo
dispone	dispõe
ann	ann
signori	cavalheiros
signori	senhores
ginevra	genebra
serbo	sérvio
difendere	defender
god	god
games	games
architetture	arquiteturas
denti	dentes
niccolò	niccolò
equilibrio	equilíbrio
continente	continente
tipicamente	tipicamente
attribuito	atribuído
side	side
iniziare	começar
archeologico	arqueológico
critici	críticos
luisa	luísa
veicolo	veículo
insetti	insetos
isabella	isabella
sviluppare	desenvolver
scudetto	scudetto
discutere	discutir
medie	médias
duo	duo
lawrence	lawrence
cristianesimo	cristianismo
visibili	visíveis
times	times
pablo	pablo
patriota	patriota
episcopale	episcopal
gallo	galo
affidato	confiado
accompagnato	acompanhado
cacciatorpediniere	contratorpedeiro
messicano	mexicano
celebri	célebres
richiesto	requerido
mail	mail
priva	priva
stuart	stuart
scudo	escudo
precisione	precisão
vedova	viúva
curva	curva
angel	angel
scaduto	expirou
manchester	manchester
get	get
memorie	memórias
russi	russos
mariano	mariano
gonzaga	gonzaga
operato	operado
operato	operou
visconti	visconti
when	when
meccanismo	mecanismo
esteri	ésteres
pagamento	pagamento
todd	todd
lost	lost
testamento	testamento
ricevere	receber
paesaggio	paisagem
gonzález	gonzález
roman	roman
dirige	dirige
tracciato	traçado
produzioni	produções
potenziale	potencial
usate	usem
ibn	ibn
anton	anton
soluzioni	soluções
cena	jantar
sebastiano	sebastião
rurale	rural
devo	devo
stradale	rodoviário
viaggi	viagens
ospiti	convidados
distrutta	destruída
victoria	victoria
entertainment	entertainment
ebraico	hebraico
musei	museus
wilhelm	wilhelm
coscienza	consciência
movie	movie
alfa	alpha
alfa	alfa
siracusa	siracusa
tipici	típicos
baia	baía
blocchi	blocos
produttori	produtores
aosta	aosta
interessato	interessado
country	country
tito	tito
nfl	nfl
attaccare	atacar
frammenti	trechos
spirituale	espiritual
centrali	centrais
monaci	monges
superato	ultrapassado
erba	erva
age	age
convocato	convocado
apparentemente	aparentemente
frazioni	fracções
metallo	metal
raggi	raios
tende	tendas
sottospecie	subespécie
raggruppa	agrupar
lecce	lecce
infortunio	lesão
dottrina	doutrina
arrivano	chegam
microsoft	microsoft
denis	denis
lópez	lópez
dream	dream
offensiva	ofensiva
conference	conference
benjamin	benjamin
finestre	janelas
fattore	fator
fumetto	quadrinhos
permettono	permitem
barocco	barroco
temporale	temporal
pronto	pronto
marvel	marvel
adulti	adultos
decidere	decidir
anonimo	anónimo
danny	danny
parametri	parâmetros
foreste	florestas
iniziano	começam
grazia	graça
gay	gay
armando	armando
journal	journal
roccia	rocha
finestra	janela
undici	onze
estrema	extrema
editori	editores
eredità	herança
funzionamento	funcionamento
paziente	paciente
dramma	drama
ron	ron
fotografo	fotografo
permanente	permanente
broadway	broadway
cannone	canhão
palazzi	palácios
lezioni	lições
rotta	rota
videoclip	videoclip
camillo	camillo
serra	serra
residenti	residentes
ministri	ministros
hong	hong
dottore	doutor
ville	villas
dragon	dragon
risalgono	remontam
domande	perguntas
miami	miami
fossili	fósseis
monza	monza
franchi	francos
opportunità	oportunidade
eroi	heróis
reno	reno
uova	ovos
dimostrare	demonstrar
scelte	escolhas
sostituita	substituída
name	name
estremo	extremo
rappresentare	representar
taglio	corte
fondatori	fundadores
arabi	árabes
perdendo	perdendo
harris	harris
convenzione	convenção
individuali	individuais
emma	emma
jon	jon
track	track
wright	wright
union	union
garcía	garcía
disputata	disputada
maestri	mestres
vetta	cume
universal	universal
mettendo	colocando
calore	calor
cratere	cratera
cooper	cooper
perfettamente	perfeitamente
wars	wars
collo	pescoço
rotazione	rotação
settori	setores
settori	sectores
soprano	soprano
albanese	albanês
popolarità	popularidade
destinata	destinada
lake	lake
logica	lógica
pallavolista	voleibolista
grotta	caverna
giocando	jogando
segnato	marcado
commons	commons
european	european
monica	monica
navy	navy
let	let
economici	baratos
murray	murray
moderne	modernas
dino	dino
draft	draft
viva	viva
indicata	indicada
ricordano	recordam
canton	canton
costruite	construídas
teologia	teologia
nate	nate
antichità	antiguidades
walker	walker
consumo	consumo
satellite	satélite
valido	válido
farà	fará
rimini	rimini
martina	martina
novità	novidades
percentuale	percentagem
mussolini	mussolini
css	css
opposto	oposto
fantasma	fantasma
greg	greg
assist	assistências
survey	survey
compiti	tarefas
warner	warner
pietre	pedras
spezia	especiaria
ascolti	ouça
conosciuti	conhecidos
malta	malta
valli	vales
volontari	voluntários
rispondere	responder
temperature	temperaturas
mtv	mtv
patriarca	patriarca
parentesi	parênteses
scavi	escavações
donald	donald
dialogo	diálogo
pubblicate	publicadas
second	second
vladimir	vladimir
esploratore	explorador
sex	sex
coalizione	coligação
dipendenti	funcionários
suore	freiras
cinesi	chineses
maschera	máscara
classificato	classificado
detti	ditos
condanna	condenação
genio	gênio
galles	gales
matrice	matriz
dettaglio	detalhe
legione	legião
dean	dean
mount	mount
calcolo	cálculo
mostro	monstro
ribelli	rebeldes
dispositivo	dispositivo
comporta	comporta
associato	associado
gravemente	gravemente
austin	austin
liquido	líquido
stefan	stefan
massiccio	maciço
sperimentale	experimental
territoriale	territorial
campbell	campbell
salita	subida
regolamento	regulamento
margaret	margaret
amato	amei
feudo	feudo
rizzoli	rizzoli
assassino	assassino
radicale	radical
decine	dezenas
mac	mac
dotati	dotados
notato	notou
capitoli	capítulos
spiaggia	praia
aka	aka
informatica	computadores
flora	flora
nobiltà	nobreza
divina	divina
omaggio	homenagem
ruota	roda
castiglia	castela
tessuto	tecido
nascosto	escondido
sentimenti	sentimentos
vetro	vidro
soul	soul
giornali	jornais
verificare	verificar
troviamo	encontramos
fifa	fifa
privati	privados
occupata	ocupada
giardini	jardins
dna	dna
affermazione	afirmação
renzo	renzo
appaiono	aparecem
ring	ring
georg	georg
battendo	batendo
valerio	valerio
debole	fraco
mistero	mistério
maresciallo	marechal
newton	newton
revisione	revisão
palla	bola
pesca	pesca
sessione	sessão
messi	messi
salvezza	salvação
garantire	garantir
individuo	indivíduo
variazioni	variações
feriti	feridos
studente	estudante
discipline	disciplinas
podio	pódio
trazione	tracção
carabinieri	carabinieri
family	family
verifica	verificação
litri	litros
quaranta	quarenta
graham	graham
people	people
comparsa	aparecimento
rené	rené
magazine	magazine
sfera	esfera
profondamente	profundamente
sara	sara
milita	milita
nati	nascidos
impedire	impedir
raccogliere	recolher
efficace	eficaz
single	solteira
single	solteiro
andando	indo
ama	ama
disambigua	desambiguação
porzione	porção
bianche	brancas
diana	diana
bbc	bbc
rivale	rival
cupola	cúpula
airlines	airlines
accusato	acusado
principato	principado
action	action
orlando	orlando
socio	sócio
ralph	ralph
segnalare	denunciar
liberi	livres
ambasciatore	embaixador
accordi	acordos
platino	platina
contribuito	contribuiu
contribuito	contribuído
partecipano	participam
filippine	filipinas
toronto	toronto
automaticamente	automaticamente
sbagliato	errado
fascismo	fascismo
molta	muita
hugo	hugo
pagare	pagar
universitario	universitário
nuoto	natação
angela	ângela
osservazioni	observações
cattura	captura
place	place
zampe	patas
four	four
archeologici	arqueológicos
dette	ditas
neil	neil
attraversa	atravessa
billboard	billboard
equivalente	equivalente
appartenenza	pertença
lorena	lorena
ripreso	retomado
artificiale	artificial
scorta	escolta
orientamento	orientação
guide	guias
caduti	caídos
sovrani	soberanos
fiction	ficção
esplosione	explosão
jersey	jersey
introdotta	introduzida
promuovere	promover
geografica	geográfica
elio	hélio
economista	economista
sindrome	síndrome
youtube	youtube
just	just
europe	europe
inciso	gravado
dimissioni	demissão
quartieri	bairros
gianfranco	gianfranco
trattati	tratados
seminario	seminário
dichiara	declara
rami	ramos
fonda	funda
ospitare	hospedar
configurazione	configuração
achille	aquiles
viale	avenida
collabora	colabora
ammesso	admitiu
ammesso	admitido
cita	cita
service	service
gioventù	juventude
lettore	leitor
composizioni	composições
now	now
acustica	acústica
nazista	nazista
coraggio	coragem
settima	sétima
nova	nova
casale	casale
cattivo	mau
parenti	parentes
science	science
chan	chan
lanciato	lançado
mostrato	mostrado
pozzo	poço
aggiunge	adiciona
diario	diário
crescente	crescente
buono	bom
integrale	integral
legislatura	legislatura
arnold	arnold
forum	fórum
three	three
dennis	dennis
trio	trio
separazione	separação
seguono	seguem
spiegare	explicar
considerando	considerando
serbia	sérvia
dilettanti	amadores
ottenuta	obtida
gestire	gerir
guarda	olha
sandro	sandro
essenzialmente	essencialmente
cade	cade
sentire	sentir
carro	vagão
tue	tue
derby	derby
formati	formatos
contessa	condessa
sentenza	sentença
professionisti	profissionais
tonnellate	toneladas
alimentazione	alimentação
ted	ted
mercedes	mercedes
delta	delta
colonie	colónias
only	only
provare	tentar
batman	batman
claudia	cláudia
claudia	claudia
neo	neo
creature	criaturas
futura	futura
arturo	arturo
comprendere	compreender
ernst	ernst
marcel	marcel
organizzare	organizar
inaugurata	inaugurada
trasformato	transformado
veri	verdadeiros
martín	martín
chiamate	chamadas
cure	curas
perry	perry
piacere	prazer
wwe	wwe
vedono	veem
vedono	vêem
umane	humanas
contatti	contatos
silenzio	silêncio
bilancio	orçamento
premier	premier
vicario	vigário
sceriffo	xerife
bobina	bobina
riconosciuta	reconhecida
ottavo	oitavo
ampliata	alargada
credere	acreditar
campania	campânia
alessio	alessio
arcipelago	arquipélago
blood	blood
poveri	pobres
sea	sea
salva	gravar
maddalena	madalena
tecnologie	tecnologias
usano	usam
prossima	próxima
tappe	etapas
rodolfo	rodolfo
croato	croata
busto	busto
parziali	parciais
nintendo	nintendo
fumettista	cartunista
palma	palma
supercoppa	supercopa
colleghi	colegas
verticale	vertical
autonomo	autônomo
extra	extras
extra	extra
page	page
cremona	cremona
jacopo	jacopo
terzi	terceiros
calci	pontapés
industriali	industriais
indagine	inquérito
strano	estranho
terapia	terapia
pete	pete
incaricato	encarregado
guerrieri	guerreiros
insegna	ensina
registrazioni	gravações
luke	luke
schiavi	escravos
prigioniero	prisioneiro
amministratori	administradores
point	point
harold	harold
curiosità	curiosidades
robinson	robinson
matthew	matthew
radar	radar
trasmissioni	transmissões
complessi	complexos
dedica	dedica
julia	julia
penale	penal
guinea	guiné
baker	baker
visti	vistos
tragedia	tragédia
alternative	alternativas
registrati	registar
cadere	cair
books	books
ottavi	oitavos
leggero	leve
rocce	rochas
consecutive	consecutivas
segnando	marcando
colline	colinas
dallas	dallas
mitchell	mitchell
marte	marte
sconfiggere	derrotar
den	den
philippe	philippe
monumentale	monumental
colin	colin
psicologia	psicologia
preliminare	preliminar
vaglio	crivo
heinrich	heinrich
attivi	ativos
cinquecento	quinhentos
presero	pegaram
milione	milhão
negativo	negativo
rally	rali
perfetto	perfeito
borsa	bolsa
mie	minhas
declino	declínio
specifici	específicos
patrono	patrono
rimozione	remoção
ispettore	inspetor
strategia	estratégia
conservata	conservada
normali	normais
fidanzata	namorada
uccello	pássaro
flavio	flavio
intensità	intensidade
discografia	discografia
deposito	depósito
salone	salão
core	core
appello	apelação
appello	apelo
jugoslavia	jugoslávia
mantenendo	mantendo
braccia	braços
abside	abside
venere	vênus
tempesta	tempestade
brillante	brilhante
battle	battle
adige	adige
violazione	violação
annuncia	anuncia
apparso	apareceu
trentino	trentino
buone	boas
never	never
quindici	quinze
pat	pat
pioggia	chuva
caldo	quente
straniero	estrangeiro
stagionale	sazonal
teorema	teorema
zurigo	zurique
pubblicare	publicar
citare	citar
turchi	turcos
impiegati	empregados
days	days
volere	querer
citati	citados
croazia	croácia
mari	mari
processione	procissão
fiorentino	florentino
determinare	determinar
anelli	anéis
tendenza	tendência
usi	usos
autostrada	autoestrada
affronta	enfrenta
magistrato	magistrado
quadri	quadros
bot	bots
ponti	pontes
equazione	equação
rita	rita
canta	canta
causato	causado
divide	divide
massimiliano	massimiliano
sebastian	sebastian
apollo	apollo
silver	silver
regolarmente	regularmente
flauto	flauta
bibbia	bíblia
ludwig	ludwig
forlì	forlì
thompson	thompson
contadini	camponeses
strato	camada
rottura	rompimento
binario	binário
cortile	pátio
giordano	jordão
have	have
project	project
griffith	griffith
competenza	competência
avvento	advento
inclusi	incluídos
necessarie	necessárias
ecclesiastica	eclesiástica
inseriti	inseridos
magno	magno
costume	traje
frasi	frases
cervello	cérebro
inseguimento	perseguição
stabilimento	estabelecimento
necessariamente	necessariamente
spostamento	deslocamento
grandezza	grandeza
concesso	concedido
abruzzo	abruzzo
combattimenti	combates
singole	singles
archeologo	arqueólogo
peccato	pecado
descritta	descrita
caratteristico	característico
citazioni	citações
valley	valley
organismo	organismo
dite	digam
dite	diga
esecutivo	executivo
hunter	hunter
genovese	genovese
registrare	gravar
boris	boris
linguistica	linguística
nastro	fita
esperimenti	experiências
proprietari	proprietários
info	info
latte	leite
biennale	bienal
conoscenze	conhecimentos
albania	albânia
pechino	pequim
urbana	urbana
pescara	pescara
iran	irã
iran	irão
messe	messe
diploma	diploma
joan	joan
conversione	conversão
immaginario	imaginário
parlano	falam
augusta	augusta
serena	serena
rientro	recuo
intervenire	intervir
dedicati	dedicados
ottava	oitava
costituzionale	constitucional
provato	tentou
provato	tentei
ospitato	hospedado
partner	parceiros
fiera	feira
verranno	virão
viaggiatori	viajantes
apparizioni	aparições
discendenti	descendentes
andreas	andreas
dico	digo
abbandonata	abandonada
ristrutturazione	reestruturação
secret	secret
lama	lâmina
particelle	partículas
regni	reinos
antoine	antoine
anziano	ancião
anziano	idoso
rimanendo	permanecendo
field	field
sogni	sonhos
consigli	dicas
apostolica	apostólica
guerriero	guerreiro
indicano	indicam
siria	síria
jacob	jacob
sottile	fina
bombardamento	bombardeio
bombardamento	bombardeamento
contenere	conter
rigore	rigor
permettendo	permitindo
slam	slam
julie	julie
evidenza	destaque
istruzioni	instruções
alleato	aliado
mobili	mobiliário
esprimere	expressar
hip	hip
contengono	contêm
she	she
traduttore	tradutor
rivelato	revelado
accuse	acusações
summer	summer
preferito	preferido
osservare	observar
mal	mal
repertorio	repertório
detroit	detroit
ritmo	ritmo
iniziali	iniciais
comunicazioni	comunicações
incipit	incipit
collaborare	colaborar
lugano	lugano
corrispondenti	correspondentes
inventore	inventor
japan	japan
prosa	prosa
prendono	tomam
formale	formal
stoccolma	estocolmo
simpson	simpson
kennedy	kennedy
prussia	prússia
appartengono	pertencem
persa	perdida
leonard	leonard
ottenuti	obtidos
dispositivi	dispositivos
statuto	estatutos
miglioramento	melhoria
cadenza	cadência
vuelta	vuelta
rivoluzionario	revolucionário
scacchi	xadrez
consegna	entrega
formalmente	formalmente
amedeo	amedeo
qualificata	qualificada
missili	mísseis
take	take
derivato	derivado
vitale	vital
talento	talento
stop	parar
operare	operar
liguria	liguria
varsavia	varsóvia
marocco	marrocos
compagna	companheira
preghiera	oração
interprete	intérprete
primarie	primárias
conflitti	conflitos
business	negócio
autorizzazione	autorização
iniziative	iniciativas
evans	evans
riproduzione	reprodução
completata	concluída
amministrative	administrativas
there	there
nudo	nu
integrazione	integração
pane	pão
sensi	sentidos
ossa	ossos
possedeva	possuía
mini	mini
pittori	pintores
kate	kate
parrocchie	paróquias
allenatori	treinadores
duro	duro
unisce	une
head	head
dos	dos
esteso	prorrogado
esteso	estendido
houston	houston
compone	compõe
rendono	tornam
rob	rob
amichevole	amigável
emergenza	emergência
susan	susan
suona	soa
ottomano	otomano
amy	amy
pomeriggio	tarde
distinzione	distinção
jennifer	jennifer
mayer	mayer
potter	potter
nancy	nancy
indicazioni	indicações
droga	droga
iraq	iraque
liberale	liberal
foggia	foggia
piatto	prato
doppiaggio	dobragem
mostrano	mostram
sapore	sabor
evidentemente	evidentemente
utilizzano	utilizam
prospettiva	perspectiva
arrondissement	arrondissement
redazione	redação
sean	sean
piemontese	piemontês
atlantico	atlântico
leopoldo	leopoldo
continentale	continental
cuba	cuba
cella	célula
permanenza	permanência
completare	completar
modificata	modificada
qualificato	qualificado
caro	querido
mulino	moinho
michelangelo	michelangelo
religioni	religiões
century	century
collection	collection
adatto	adequado
funziona	funciona
pronuncia	pronúncia
palio	palio
her	her
future	future
parametro	parâmetro
martini	martini
mezza	meia
ricchi	ricos
diversamente	diferentemente
manutenzione	manutenção
pratiche	práticas
riconoscere	reconhecer
significativo	significativo
justin	justin
about	about
concentrazione	concentração
mamma	mãe
chuck	chuck
sassofono	saxofone
mira	mira
gioia	alegria
locomotive	locomotivas
betty	betty
specchio	espelho
utilità	utilidade
warren	warren
soppresso	suprimido
lineare	linear
cittadinanza	nacionalidade
trovavano	encontravam
assegnata	atribuída
collins	collins
rame	cobre
pianeti	planetas
kurt	kurt
accreditato	acreditado
includono	incluem
card	card
bulgaria	bulgária
fucile	espingarda
settimanale	semanal
falso	falso
prince	prince
social	social
carmine	carmine
cattedra	cátedra
frutti	frutos
supera	ultrapassa
supera	supera
difese	defesas
riprendere	retomar
letterato	literato
registrata	registada
risposte	respostas
dylan	dylan
promessa	promessa
quanti	quantos
tentato	tentado
facevano	faziam
discendente	descendente
concetti	conceitos
decisioni	decisões
sec	sec
delegazione	delegação
reazioni	reacções
farina	farinha
telefono	telefone
tredici	treze
arezzo	arezzo
racing	racing
rimbalzi	rebotes
trasformata	transformada
lisbona	lisboa
assente	ausente
disegnatore	desenhador
disegnatore	desenhista
apple	apple
keith	keith
doc	doc
scoperte	descobertas
segnalato	relatou
attentato	atentado
port	port
pugile	pugilista
amburgo	hamburgo
convincere	convencer
autobus	autocarro
coperto	coberto
confusione	confusão
cantanti	cantores
candidati	candidatos
kansas	kansas
grosseto	grosseto
stars	stars
adozione	adoção
trent	trent
vogliono	querem
promossa	promovida
scherma	esgrima
padrone	mestre
guardie	guardas
fornito	fornecido
ruggero	rogério
dir	dir
vecchie	antigas
concorrenti	concorrentes
basse	baixas
storicamente	historicamente
beatrice	beatriz
tradizionalmente	tradicionalmente
estesa	estendida
división	división
assegnati	atribuídos
cresce	cresce
caffè	café
giurisprudenza	jurisprudência
bonaparte	bonaparte
wolf	wolf
potenze	potências
ossigeno	oxigénio
strategica	estratégica
variabili	variáveis
raggiunta	alcançada
nizza	nice
carbonio	carbono
agire	agir
attaccato	atacado
edwards	edwards
canna	cana
alfabeto	alfabeto
esposto	exposto
avessero	tivessem
indicazione	indicação
seicento	seiscentos
lione	lyon
helen	helen
eliminata	eliminada
integrare	integrar
inserite	inseridas
gamba	perna
mountain	mountain
montaggio	montagem
continuità	continuidade
cifra	dígito
cifra	algarismo
islam	islã
inc	inc
riguardano	afectam
attivista	ativista
creatura	criatura
vestito	vestido
blake	blake
ercole	hércules
apparire	aparecer
minerale	mineral
austro	austro
partì	partiu
approvazione	aprovação
cronache	crônicas
polvere	pó
model	model
franklin	franklin
nicolò	nicolò
policy	policy
trasforma	transforma
sony	sony
partecipando	participando
mago	mago
luci	luzes
galassia	galáxia
cani	cães
primato	primazia
destinazione	destino
anteriori	dianteiras
harrison	harrison
apice	auge
want	want
guidati	guiados
dialetti	dialectos
unita	unida
combinazione	combinação
compaiono	aparecem
magic	magic
obbligo	obrigação
frequentato	frequentado
gianluca	gianluca
sculture	esculturas
restano	ficam
restano	permanecem
blog	blog
cronometro	cronômetro
proteine	proteína
venezuela	venezuela
pose	poses
charlotte	charlotte
congo	congo
decimo	décimo
ram	ram
prefetto	prefeito
domani	amanhã
emittente	emitente
trasformazioni	transformações
operatore	operador
scioglimento	dissolução
roland	roland
parallelo	paralelo
supremo	supremo
rinascimento	renascença
inno	hino
andrej	andrei
giudici	juízes
sat	sat
major	major
classic	classic
fisso	fixo
giuria	júri
eredi	herdeiros
roll	roll
olivier	olivier
voli	voos
strega	bruxa
serio	sério
presentare	apresentar
normandia	normandia
benevento	benevento
collegata	ligada
vere	verdadeiras
tradimento	traição
spiegato	explicado
spiegato	explicou
aumenta	aumenta
prof	prof
maglie	malhas
brasiliana	brasileira
innamorato	apaixonado
inchiesta	inquérito
rinascimentale	renascentista
scomparso	desaparecido
scomparso	desapareceu
correttamente	corretamente
franca	franca
demone	demônio
entrando	entrando
scale	escadas
grano	trigo
delegato	delegado
fernández	fernández
earth	earth
servono	servem
pastore	pastor
bernardino	bernardino
inediti	inéditos
designer	designer
fidanzato	namorado
turner	turner
asta	leilão
cerchio	círculo
volante	volante
spencer	spencer
modulo	formulário
clinica	clínica
cellulare	celular
khan	khan
scandalo	escândalo
sintomi	sintomas
dintorni	arredores
url	url
globale	global
flash	flash
express	express
progressivamente	progressivamente
decorato	decorado
pennsylvania	pensilvânia
rumeno	romeno
carmen	carmen
spareggio	desempate
goffredo	godofredo
wood	wood
giurisdizione	jurisdição
spider	spider
spiegazione	explicação
sbarco	desembarque
caroline	caroline
tromba	trombeta
tromba	trompete
trapani	trapani
unici	únicos
intelligenza	inteligência
johan	johan
cantiere	estaleiro
testata	ogiva
ricci	ricci
sovietici	soviéticos
stan	stan
aggiungo	acrescento
ballerina	bailarina
siciliana	siciliana
impegnati	empenhados
ordinamento	ordenação
brad	brad
cuneo	cunha
orecchie	orelhas
apparve	apareceu
roberts	roberts
grafico	gráfico
atlanta	atlanta
radice	raiz
giornalisti	jornalistas
avvio	iniciando
belgrado	belgrado
sposata	casada
savona	savona
heavy	heavy
osservatorio	observatório
misterioso	misterioso
influenze	influências
complessa	complexa
prefazione	prefácio
propaganda	propaganda
odio	odeio
circolazione	circulação
christmas	christmas
influenzato	influenciado
sembrava	parecia
sembrava	pareceu
ricchezza	riqueza
rifiuto	rejeição
hills	hills
deep	deep
domini	domínios
liverpool	liverpool
frati	frades
gestito	gerido
net	net
fotografie	fotografias
suoni	sons
venduti	vendidos
marini	marinhos
riconosce	reconhece
iron	iron
musulmani	muçulmanos
convince	convence
arcangelo	arcanjo
quadrato	quadrado
riunione	reunião
shakespeare	shakespeare
mafia	máfia
crocifisso	crucifixo
sforzi	esforços
conservati	conservados
erik	erik
sforzo	esforço
mostri	monstros
sufficienti	suficientes
distingue	distingue
scienziati	cientistas
nobel	nobel
craig	craig
kid	kid
addio	adeus
eleonora	leonor
crescere	crescer
pavel	pavel
vegetazione	vegetação
mantenuto	mantido
lincoln	lincoln
brindisi	brinde
armenia	arménia
brothers	brothers
primaria	primária
creati	criados
distinti	distintos
act	act
codici	códigos
costantemente	constantemente
frequentemente	freqüentemente
pellegrini	peregrinos
sostenitori	apoiantes
poeti	poetas
kent	kent
intenso	intenso
comandi	comandos
inesistenti	inexistentes
ottica	óptica
accettò	aceitou
liberamente	livremente
baden	baden
visibilità	visibilidade
salvato	salvou
salvato	guardado
libreria	livraria
double	double
drammatica	dramática
fantasia	fantasia
pilastri	pilares
peli	pêlos
civico	cívico
gotico	gótico
aspettare	esperar
ward	ward
coordinate	coordenadas
disputate	disputados
interessanti	interessantes
season	season
dieta	dieta
gustavo	gustavo
copenaghen	copenhaga
cairo	cairo
proporre	propor
rovine	ruínas
centre	centre
cercano	buscam
appuntamento	encontro
other	other
sidney	sidney
documentazione	documentação
hermann	hermann
cap	cap
chitarre	guitarras
dorsale	dorsal
tavolo	mesa
raccolto	colheita
vinci	vinci
seno	seios
indicati	indicados
nonna	vovó
justice	justice
bulgaro	búlgaro
nicole	nicole
anglo	anglo
associata	associada
banco	bancada
scende	desce
dominante	dominante
honda	honda
criminali	criminosos
trovata	encontrada
vela	vela
sondaggio	enquete
moro	moro
esponente	expoente
grace	grace
aiutato	ajudou
aiutato	ajudado
alo	alo
beta	beta
gennaro	gennaro
spostato	movido
valentino	valentino
liberare	libertar
ten	ten
wolfgang	wolfgang
pan	pan
create	criadas
barca	barca
fredda	fria
nicholas	nicholas
partecipazioni	participações
rendendo	tornando
sweet	sweet
drammatico	dramático
jesse	jesse
individuare	localize
raimondo	raimundo
stabilità	estabilidade
sottofamiglia	subfamília
sinonimo	sinônimo
percorsi	caminhos
jessica	jessica
brooklyn	brooklyn
cilindrata	cilindrada
motto	lema
gesto	gesto
scorre	flui
wta	wta
conservatorio	conservatório
atterraggio	aterragem
tipiche	típicas
jamie	jamie
determinata	determinada
ambrogio	ambrósio
fritz	fritz
clienti	clientes
reddito	rendimento
manufacturing	manufacturing
macedonia	macedónia
deutsche	deutsche
orso	urso
nativi	nativos
contare	contar
coperta	cobertor
contribuire	contribuir
esprime	exprime
cappello	chapéu
renault	renault
assoluti	absolutos
chiamare	chamar
estratti	extratos
castro	castro
silvia	silvia
sconfitti	derrotados
diesel	diesel
apparteneva	pertencia
slovacchia	eslováquia
conquistando	conquistando
sub	sub
riflessione	reflexão
vegas	vegas
ragno	aranha
share	share
carrozzeria	carroçaria
dublino	dublin
lussemburgo	luxemburgo
basati	baseados
francoforte	frankfurt
inedito	inédito
quadrati	quadrados
lucky	lucky
idrogeno	hidrogênio
rilasciato	libertado
rilasciato	emitido
collegati	ligados
collegati	conectados
ottone	latão
italian	portuguese
orologio	relógio
separate	separadas
mantenuta	mantida
disponibilità	disponibilidade
siciliano	siciliano
bank	bank
machine	machine
masters	masters
ascoli	ascoli
fate	fadas
approvata	aprovada
marrone	marrom
ceramica	cerâmica
eretto	erguido
sassari	sassari
bravo	bravo
gravità	gravidade
vocali	vogais
lentamente	devagar
responsabili	responsáveis
legend	legend
cleveland	cleveland
strumentale	instrumental
madagascar	madagáscar
hit	hit
perdono	perdão
julian	julian
partigiani	partidários
edgar	edgar
berlusconi	berlusconi
aurelio	aurélio
difficili	difíceis
tifosi	fãs
ucraino	ucraniano
dog	dog
tessuti	tecidos
josef	josef
martínez	martínez
finalisti	finalistas
allan	allan
incrociatore	cruzador
antonino	antonino
essenziale	essencial
duello	duelo
immediato	imediato
leggeri	leves
accade	acontece
coinvolti	envolvidos
scenografo	cenógrafo
suicidio	suicídio
parlamentari	parlamentares
carbone	carvão
vanta	ostenta
adriatico	adriático
adrian	adrian
famose	famosas
fiamme	chamas
august	august
comunisti	comunistas
organismi	organismos
terribile	terrível
hell	hell
kiss	kiss
gestita	gerida
seattle	seattle
nathan	nathan
topolino	ratinho
wang	wang
sedici	dezesseis
anticipo	adiantamento
philadelphia	filadélfia
levi	levi
crimine	crime
empire	empire
iscritti	inscritos
teatri	teatros
orange	orange
rettangolare	retangular
riposo	repouso
riposo	descanso
intensa	intensa
laser	laser
mentale	mental
allenamento	treino
ritratti	retratos
sergente	sargento
invenzione	invenção
ristorante	restaurante
porti	portos
lemmon	lemmon
marchi	marcas
borghese	borghese
channel	channel
frequenta	frequenta
antologia	antologia
ritardo	atraso
fauna	fauna
cancro	câncer
louise	louise
soprannominato	apelidado
lima	lima
bande	bandas
