que	dass
uma	eine
com	mit
para	für
foi	war
como	wie
não	nicht
não	nein
mais	mehr
sua	ihre
utc	utc
são	sind
seu	ihr
min	min
também	auch
the	the
ser	sein
ele	er
mas	aber
discussão	diskussion
entre	zwischen
anos	jahre
sobre	über
tem	hat
nos	uns
até	bis
cidade	stadt
quando	wenn
quando	wann
janeiro	januar
onde	wo
grande	groß
brasil	brasilien
rio	fluss
estado	staat
ano	jahr
primeiro	zuerst
primeiro	ersten
pode	kann
ligações	verbindungen
parte	teil
este	dieser
este	dieses
este	diese
primeira	erste
nome	namen
nome	name
ainda	noch
outros	sonstige
esta	diese
sem	ohne
ela	sie
dia	tag
dois	zwei
muito	sehr
região	region
apenas	nur
ter	haben
msg	msg
julho	juli
lista	liste
maio	mai
março	märz
norte	norden
família	familie
abril	april
sul	süden
grupo	gruppe
setembro	september
paulo	paulo
ver	sehen
ver	siehe
outubro	oktober
isso	das
maior	größte
maior	größer
álbum	album
junho	juni
contra	gegen
tempo	zeit
dezembro	dezember
fevereiro	februar
forma	form
vez	mal
novembro	november
assim	so
então	dann
três	drei
série	serie
além	zusätzlich
final	finale
desde	seit
história	geschichte
filme	film
antes	vor
melhor	besser
melhor	beste
guerra	krieg
população	bevölkerung
estados	staaten
bem	gut
mundo	welt
banda	band
km²	km²
gols	tore
nacional	nationalen
jogos	spiele
alguns	einige
center	center
vida	leben
possui	besitzt
cada	jede
música	musik
página	seite
dias	tage
campeonato	meisterschaft
josé	josé
futebol	fußball
portugal	portugal
joão	johannes
tinha	hatte
clube	club
unidos	vereinigten
novo	neu
segunda	zweite
pessoas	personen
presidente	präsident
caso	fall
jogo	spiel
sistema	system
período	zeitraum
século	jahrhundert
título	titel
casa	haus
enquanto	während
seja	sei
oficial	offizielle
oficial	offizier
filho	sohn
governo	regierung
pois	denn
artigos	artikel
distrito	distrikt
fazer	tun
trabalho	arbeit
acordo	abkommen
número	zahl
maria	maria
vários	mehrere
vários	verschiedene
terra	erde
igreja	kirche
universidade	universität
qualquer	jede
podem	können
centro	zentrum
início	beginn
tipo	typ
santa	santa
conhecido	bekannt
mundial	weltweiten
cerca	zaun
português	portugiesisch
rei	könig
algumas	einige
quem	wer
água	wasser
quatro	vier
exemplo	beispiel
morte	tod
eram	waren
brasileira	brasilianische
produção	produktion
temporada	saison
muitos	viele
wikipédia	wikipedia
time	time
geral	allgemein
aqui	hier
versão	version
fim	ende
carlos	carlos
menos	weniger
programa	programm
porto	hafen
fontes	quellen
deve	muss
seria	wäre
sempre	immer
site	webseite
livro	buch
equipe	team
escola	schule
várias	mehrere
dados	daten
copa	copa
posição	position
internacional	international
hoje	heute
província	provinz
países	länder
embora	obwohl
inglês	englisch
pouco	wenig
porque	weil
projeto	projekt
você	sie
atual	aktuell
john	john
ordem	ordnung
pai	vater
estádio	stadion
partido	partei
começou	begann
ilha	insel
carreira	karriere
campo	feld
uso	gebrauch
linha	zeile
linha	linie
poder	macht
muitas	viele
principais	wichtigsten
conta	konto
tarde	nachmittag
vila	dorf
política	politik
frança	frankreich
direito	recht
nem	weder
real	real
rede	netzwerk
obra	werk
jpg	jpg
chamado	genannt
chamado	namens
fase	phase
pedro	pedro
lisboa	lissabon
capital	hauptstadt
isbn	isbn
ponto	punkt
empresa	unternehmen
corpo	körper
década	jahrzehnt
divisão	abteilung
república	republik
votação	abstimmung
américa	amerika
data	datum
agora	jetzt
condado	county
condado	grafschaft
desenvolvimento	entwicklung
mil	tausend
diretor	direktor
toda	ganz
categoria	kategorie
cintura	taille
mar	meer
militar	militärische
diz	sagt
sucesso	erfolg
francisco	francisco
original	original
fora	außen
comunidade	gemeinschaft
idade	alter
cinco	fünf
maioria	mehrheit
alemanha	deutschland
tudo	alles
média	durchschnitt
vai	geht
quase	fast
boa	gute
dentro	innen
processo	prozess
último	letzter
milhões	millionen
rock	rock
arte	kunst
total	gesamt
total	insgesamt
lei	gesetz
importante	wichtig
presente	geschenk
feito	erledigt
central	zentrale
central	zentral
língua	sprache
sede	sitz
pontos	punkte
costa	costa
origem	ursprung
exército	armee
santo	heiliger
incluindo	einschließlich
ouro	gold
federal	federal
quanto	wieviel
texto	text
membros	mitglieder
nada	nichts
cor	farbe
direção	richtung
nível	ebene
imagem	bild
homem	mann
junto	zusammen
criação	schaffung
border	border
silva	silva
construção	bau
jogador	spieler
televisão	fernsehen
social	sozialen
revista	zeitschrift
vitória	sieg
união	union
cultura	kultur
canal	kanal
http	http
papel	rolle
força	kraft
força	stärke
principalmente	hauptsächlich
lançamento	start
personagem	charakter
estilo	stil
território	territorium
world	world
será	wird
mãe	mutter
nunca	niemals
movimento	bewegung
santos	santos
you	you
pessoa	person
fato	tatsache
fato	fakt
cruz	kreuz
espanha	spanien
possível	möglich
fonte	quelle
localidades	orte
bairro	viertel
acima	oben
filha	tochter
liga	liga
vice	vize
diversos	verschiedenes
from	from
sim	ja
sociedade	gesellschaft
império	reich
episódio	episode
batalha	schlacht
seleção	auswahl
seed	seed
cidades	städte
encontra	findet
espaço	raum
municipal	municipal
deus	gott
paris	paris
clubes	clubs
filmes	filme
modelo	modell
alemão	deutsch
musical	musical
meu	meine
páginas	seiten
oeste	westen
chamada	anruf
ator	schauspieler
popular	beliebt
última	letzte
luta	kampf
disco	scheibe
estes	diese
criado	erstellt
francês	französisch
festival	festival
general	general
especial	besondere
teatro	theater
seis	sechs
minha	meine
problemas	probleme
superior	superior
cinema	kino
deu	gab
disse	sagte
nossa	unsere
participação	beteiligung
participação	teilnahme
membro	mitglied
modo	modus
grupos	gruppen
usado	gebraucht
antigo	alten
resultado	ergebnis
atriz	schauspielerin
meses	monate
estúdio	studio
código	code
momento	moment
iii	iii
antiga	ehemaligen
instituto	institut
autor	autor
chegou	angekommen
forte	stark
david	david
amor	liebe
terceiro	dritter
espécies	arten
espécies	tierart
descoberto	entdeckt
alto	hohen
termo	begriff
san	san
mulher	frau
parece	scheint
densidade	dichte
luís	ludwig
fica	bleib
itália	italien
irmão	bruder
conteúdo	inhalt
causa	ursache
japão	japan
terceira	dritter
terceira	dritte
personagens	figuren
vista	vista
formação	ausbildung
rua	straße
apoio	unterstützung
rádio	radio
frente	vorderseite
torneio	turnier
organização	organisation
museu	museum
educação	bildung
histórico	historischen
comum	gemeinsamen
peso	gewicht
alta	hohe
áreas	bereichen
homens	männer
valor	wert
velocidade	geschwindigkeit
profissional	berufliche
problema	problem
jovem	jung
livre	kostenlos
tema	thema
vivo	lebend
minas	minen
natural	natürliche
sete	sieben
estudos	studien
cantora	sängerin
del	del
consenso	konsens
zona	zone
ganhou	gewann
criar	erstellen
castelo	burg
próximo	nahe
próximo	nächster
sentido	sinn
função	funktion
editora	verlag
etc	usw
etc	etc
algo	etwas
ambos	beide
jorge	jorge
jornal	zeitung
manuel	manuel
poderia	könnte
james	james
show	show
inglaterra	england
life	life
branco	weiß
acesso	zugang
fernando	fernando
york	york
conselho	rat
guitarra	gitarre
roma	rom
verão	sommer
manter	halten
manter	beibehalten
interior	inneren
dar	geben
livros	bücher
love	love
londres	london
anterior	vorherige
anterior	früheren
classe	klasse
evento	veranstaltung
united	united
capacidade	fähigkeit
governador	gouverneur
leste	osten
noite	nacht
energia	energie
casos	fälle
contém	enthält
aproximadamente	ungefähr
ministro	minister
simples	einfach
fala	spricht
luz	licht
horas	stunden
imperador	kaiser
competição	konkurrenz
príncipe	prinz
william	william
serviços	dienstleistungen
vale	tal
ação	aktion
escreveu	schrieb
futebolista	fußballspieler
apresenta	präsentiert
paul	paul
michael	michael
escrito	geschrieben
controle	kontrolle
eleito	gewählt
vídeo	video
saúde	gesundheit
teria	hätte
produtor	produzent
atividade	aktivität
fundação	stiftung
verdade	stimmt
estas	diese
melhores	besten
internet	internet
antônio	antônio
decisão	entscheidung
estrutura	struktur
abaixo	unten
conde	graf
ajuda	hilfe
bandeira	flagge
inclinação	neigung
music	music
escritor	schriftsteller
falta	fehlt
ngc	ngc
pedido	antrag
pedido	anfrage
morreu	starb
semana	woche
pesquisa	suche
excentricidade	exzentrizität
teoria	theorie
méxico	mexiko
jesus	jesus
robert	robert
bloqueio	blockade
oliveira	oliveira
black	black
top	top
madeira	holz
medalha	medaille
paulista	paulista
china	china
músicas	lieder
músicas	songs
mulheres	frauen
campos	felder
esposa	ehefrau
esposa	gattin
alguém	jemand
wiki	wiki
verde	grün
luiz	luiz
destaque	highlight
eua	usa
pessoal	personal
sub	sub
pequena	kleine
direitos	rechte
eventos	veranstaltungen
argentina	argentinien
editor	herausgeber
usar	verwenden
áfrica	afrika
chefe	boss
flora	flora
set	set
palácio	palast
qualidade	qualität
regras	regeln
metal	metall
orbital	orbital
regiões	regionen
proposta	vorschlag
vocal	vocal
dizer	sagen
mercado	markt
aparece	erscheint
referência	referenz
via	via
ocupação	besetzung
voz	stimme
bateria	batterie
empresas	unternehmen
records	records
letras	buchstaben
george	george
feminino	weiblich
padrão	standard
dez	zehn
miguel	miguel
resultados	ergebnisse
responsável	verantwortlich
tinham	hatten
usuários	benutzer
defesa	verteidigung
episódios	episoden
bar	bar
ilhas	inseln
minutos	minuten
administração	verwaltung
pequeno	kleinen
pequeno	klein
campanha	kampagne
red	red
prefeito	bürgermeister
duque	herzog
bgcolor	bgcolor
povo	volk
material	material
imagens	bilder
segurança	sicherheit
especialmente	besonders
situação	situation
presença	anwesenheit
equipes	mannschaften
realizado	durchgeführt
artista	künstler
classificação	einstufung
cantor	sänger
pop	pop
global	global
eliminação	entsorgung
ataque	angriff
papa	papst
missão	mission
elementos	elemente
visto	visum
raio	radius
termos	begriffe
antónio	antónio
palavra	wort
concelho	landkreis
hora	uhrzeit
henrique	heinrich
compositor	komponist
significa	bedeutet
plano	plan
interesse	interesse
cabo	kabel
economia	wirtschaft
programas	programme
ferro	eisen
masculino	männlich
armas	waffen
deixar	lassen
álbuns	alben
comando	befehl
produtos	erzeugnisse
coisas	dinge
dado	gegeben
sistemas	systeme
perto	vorbei
marca	markiert
nacionalidade	staatsangehörigkeit
volume	lautstärke
italiano	italienisch
médio	nahen
estudo	studie
fronteira	grenze
vem	kommt
prova	beweis
super	super
ali	ali
relatório	bericht
predefinição	voreinstellung
caminho	pfad
caminho	weg
serra	sierra
rainha	königin
faculdade	college
características	merkmale
casamento	hochzeit
formato	format
relevância	relevanz
lima	akte
ocorreu	aufgetreten
polícia	polizei
unidade	einheit
nascimento	geburt
estreia	premiere
romano	romano
mês	monat
charles	charles
opinião	meinung
van	van
crianças	kinder
claro	klar
quarto	zimmer
quarto	schlafzimmer
espírito	geist
publicado	veröffentlicht
jean	jean
sexo	geschlecht
carvalho	eiche
espanhol	spanisch
oito	acht
azul	blau
ocidental	westlichen
species	species
ficar	bleiben
palavras	worte
fundada	gegründet
conhecimento	wissen
prata	silber
academia	akademie
digital	digitalen
digital	digital
city	city
paz	frieden
animais	tiere
eduardo	eduardo
amigo	freund
relações	beziehungen
alegre	fröhlich
nascido	geboren
monte	monte
praia	strand
necessário	erforderlich
importância	bedeutung
rússia	russland
natal	weihnachten
pereira	pereira
eleições	wahlen
provavelmente	wahrscheinlich
britânico	britisch
atenção	achtung
começa	beginnt
razão	grund
disputa	streit
amigos	freunde
influência	einfluss
distribuição	verteilung
velho	alt
municípios	gemeinden
senhor	herr
crítica	kritik
crítica	kritisch
roberto	roberto
aumento	anstieg
condições	bedingungen
nice	nizza
comunicação	mitteilung
cabeça	kopf
jardim	garten
web	web
ciências	wissenschaften
entrada	eintritt
tempos	zeiten
tom	tom
independente	selbständig
independente	unabhängige
comercial	kommerzielle
#aaa	#aaa
sol	sonne
mestre	meister
las	las
online	online
tipos	typen
abertura	öffnung
critérios	kriterien
bispo	bischof
all	all
prática	praxis
ministério	ministerium
ana	ana
capitão	kapitän
ambiente	umwelt
futuro	zukunft
unidades	einheiten
física	physik
aeroporto	flughafen
peter	peter
quantidade	menge
originalmente	ursprünglich
mandato	mandat
diagrama	diagramm
tamanho	größe
link	link
encontrar	finden
praça	platz
normalmente	normalerweise
bahia	bahia
estrela	stern
finalmente	endlich
richard	richard
justiça	gerechtigkeit
mostra	zeigt
atrás	hinten
americanos	amerikaner
produzido	produziert
indústria	industrie
thomas	thomas
existência	existenz
xix	xix
mapa	karte
massa	masse
recursos	ressourcen
tecnologia	technologie
austrália	australien
som	sound
talvez	vielleicht
man	man
nota	anmerkung
comércio	handel
autoridade	behörde
natureza	natur
formas	formen
respeito	respekt
linhas	linien
califórnia	kalifornien
prazo	frist
ponte	brücke
fundo	hintergrund
roteiro	drehbuch
altitude	höhe
bureau	bureau
cujo	deren
cujo	dessen
passado	vergangenheit
pais	eltern
saint	saint
literatura	literatur
treinador	trainer
salvador	salvador
vermelho	rot
nós	wir
org	org
vol	vol
brasileiros	brasilianer
escolas	schulen
estreou	debütierte
https	https
tropas	truppen
trabalhar	arbeiten
canadá	kanada
ciência	wissenschaft
revolução	revolution
engenharia	engineering
fogo	feuer
daniel	daniel
ferreira	ferreira
funções	funktionen
live	live
catarina	katharina
comentários	kommentare
distância	entfernung
tratado	vertrag
ninguém	niemand
comissão	kommission
poucos	wenige
corte	schnitt
irmãos	brüder
preto	schwarz
contrato	vertrag
prêmios	auszeichnungen
passar	verbringen
realmente	wirklich
transporte	transport
one	one
motivo	motiv
tradução	übersetzung
federação	föderation
administrador	administrator
permite	erlaubt
banco	bank
rosa	rosa
antonio	antonio
irmã	schwester
mudança	änderung
regional	regionale
crescimento	wachstum
metade	hälfte
religião	religion
trabalhou	arbeitete
paraná	paraná
veio	kam
cristo	christus
jornalista	journalist
análise	analyse
mensagem	nachricht
festa	party
cena	szene
capela	kapelle
médico	arzt
resposta	antwort
comandante	commander
categorias	kategorien
pedra	stein
planeta	planet
comprimento	länge
índia	indien
tiveram	hatten
leão	löwe
projetos	projekte
nordeste	nordosten
versões	versionen
independência	unabhängigkeit
tenho	habe
certo	richtig
avenida	avenue
augusto	augusto
formado	gebildet
russo	russisch
veja	siehe
liberdade	freiheit
conceito	konzept
torre	turm
localização	lage
alexandre	alexander
feira	messe
times	times
marinha	marine
princesa	prinzessin
açores	azoren
ribeiro	ribeiro
hospital	krankenhaus
don	don
nações	nationen
histórias	geschichten
mão	hand
filosofia	philosophie
pertence	gehört
efeito	effekt
www	www
viagem	reise
sousa	sousa
construído	gebaut
esquerda	links
leandro	leandro
martin	martin
peças	teile
castro	castro
coração	herz
ricardo	ricardo
tradicional	traditionell
sou	bin
ffffff	ffffff
american	american
colégio	kollegium
guarda	wache
motor	motor
línguas	sprachen
efeitos	effekte
efeitos	auswirkungen
reis	könige
visão	vision
cores	farben
guilherme	wilhelm
ajudar	helfen
humano	menschlich
conflito	konflikt
dinheiro	geld
imprensa	presse
dvd	dvd
tour	tour
porta	tür
marco	marco
oficialmente	offiziell
superfície	fläche
comentário	kommentar
medida	maßnahme
jack	jack
national	national
decidiu	entschied
constituição	verfassung
memória	speicher
biblioteca	bibliothek
medicina	medizin
precisa	braucht
peça	stück
semanas	wochen
propriedade	eigentum
fundador	gründer
regra	regel
tratamento	behandlung
google	google
rodrigues	rodrigues
aberto	geöffnet
falar	sprechen
carta	charta
proteção	schutz
sonora	sonora
carro	auto
max	max
japonês	japanisch
geração	generation
necessidade	notwendigkeit
fortaleza	festung
conheço	kenne
bronze	bronze
áustria	österreich
incluem	umfassen
descoberta	entdeckung
satélite	satelliten
svg	svg
participar	teilnehmen
mata	tötet
imperial	imperial
vou	werde
trilha	schiene
luis	luis
lago	see
dupla	doppelte
arena	arena
henry	henry
comédia	komödie
relevante	relevant
sala	wohnzimmer
extensão	erweiterung
smith	smith
números	zahlen
direita	rechts
isabel	elisabeth
anteriormente	zuvor
candidato	kandidat
morto	tot
evitar	vermeiden
rocha	felsen
objeto	objekt
king	king
madrid	madrid
alberto	alberto
difícil	schwierig
césar	cäsar
gomes	gomes
mudanças	veränderungen
afonso	afonso
fórmula	formel
experiência	erfahrung
composição	zusammensetzung
método	methode
capaz	fähig
obrigado	danke
semelhante	ähnliche
expressão	ausdruck
templo	tempel
tribunal	gericht
escrever	schreiben
conhecidos	bekannte
famoso	berühmt
lee	lee
soldados	soldaten
prefeitura	präfektur
estrelas	sterne
famílias	familien
políticos	politiker
disponível	verfügbar
desenvolvido	entwickelt
programação	programmierung
bandas	bands
letra	buchstabe
software	software
white	white
tradição	tradition
pequenos	kleinen
grego	griechisch
decreto	dekret
flores	blumen
autores	autoren
rios	flüsse
taxa	gebühr
clara	clara
doença	krankheit
valores	werte
quinta	fünfte
navio	schiff
nove	neun
alex	alex
águas	gewässern
princípio	grundsatz
princípio	prinzip
suficiente	ausreichend
suficiente	genug
washington	washington
comportamento	verhalten
perfil	profil
universo	universum
juan	juan
secretário	sekretär
piloto	pilot
mãos	hände
meia	halbe
horizonte	horizont
till	till
completo	komplett
tentar	versuchen
próxima	nächste
tropical	tropischen
anunciou	angekündigt
contexto	kontext
corrida	rennen
sangue	blut
lucas	lukas
pena	todesstrafe
park	park
matemática	mathematik
universal	universal
les	les
conquista	eroberung
almeida	almeida
apareceu	erschienen
apareceu	erschien
caixa	kasten
alunos	schüler
produto	produkt
gol	tor
atlético	sportlich
marido	ehemann
operações	operationen
cópias	kopien
temperatura	temperatur
bruno	bruno
plantas	pflanzen
publicação	veröffentlichung
joseph	joseph
transmissão	übermittlung
mínimo	minimum
mínimo	minimal
suécia	schweden
prémio	prämie
máximo	maximum
night	night
ataques	angriffe
poeta	dichter
instituição	institution
objetos	objekte
participantes	teilnehmer
individual	individuell
individual	individuelle
inverno	winter
walter	walter
desenho	zeichnung
portal	portal
can	can
técnicas	techniken
exposição	ausstellung
perda	verlust
declaro	erkläre
pintura	malerei
enciclopédia	enzyklopädie
carioca	carioca
congresso	kongress
bibliografia	bibliographie
drama	drama
apresentou	präsentierte
this	this
brasília	brasília
criança	kind
recentemente	kürzlich
modelos	modelle
modelos	vorlagen
séculos	jahrhunderte
apresentação	einreichung
linear	linear
mark	mark
marcelo	marcelo
prisão	gefängnis
igual	gleich
derrota	niederlage
concurso	ausschreibung
planta	pflanze
suíça	schweiz
realidade	realität
realidade	wirklichkeit
piano	klavier
colocado	platziert
clima	klima
entrevista	interview
jones	jones
renda	einkommen
normal	normal
administradores	administratoren
gravação	aufnahme
segue	folgt
ascensão	aufstieg
martins	martins
engenheiro	ingenieur
resto	rest
vandalismo	vandalismus
israel	israel
alves	alves
big	big
exemplos	beispiele
figura	abbildung
pressão	druck
escala	skala
cursos	kurse
chris	chris
grau	grad
erro	fehler
publicou	veröffentlichte
fifa	fifa
mudar	ändern
billboard	billboard
house	house
tabela	tabelle
complexo	komplex
textos	texte
arquitetura	architektur
chave	schlüssel
vinte	zwanzig
ponta	spitze
manutenção	wartung
louis	louis
frank	frank
joaquim	joaquim
fusão	fusion
out	out
saída	ausgang
mortos	tote
duração	dauer
samba	samba
parceria	partnerschaft
mário	mário
best	best
assumiu	übernahm
navios	schiffe
ásia	asien
animal	tier
diferença	unterschied
aqueles	jene
harry	harry
deixa	lass
filipe	philipp
profissionais	profis
encontro	treffen
permaneceu	blieb
coronel	oberst
estudou	studierte
galáxia	galaxie
dança	tanz
movimentos	bewegungen
olhos	augen
reforma	reform
voltar	zurück
solução	lösung
instrumento	instrument
contato	kontakt
escolha	wahl
críticas	kritik
diocese	diözese
disney	disney
setor	sektor
gabriel	gabriel
presentes	geschenke
trono	thron
ben	ben
santiago	santiago
braga	braga
crise	krise
levar	mitnehmen
royal	royal
encontrado	gefunden
wilson	wilson
latina	latina
hall	hall
record	record
biografia	biografie
apagar	löschen
química	chemische
química	chemie
casal	paar
núcleo	kern
grécia	griechenland
neto	enkel
fazenda	bauernhof
sérvia	serbien
serviu	diente
queria	wollte
resistência	widerstand
acidente	unfall
debate	debatte
indivíduos	einzelpersonen
conclusão	abschluss
instituições	institutionen
torres	torres
menores	minderjährige
recife	riff
leis	gesetze
décadas	jahrzehnte
recebe	erhält
barcelona	barcelona
células	zellen
apresentar	vorzulegen
oscar	oscar
crime	verbrechen
atua	wirkt
hot	hot
possibilidade	möglichkeit
grand	grand
infantaria	infanterie
retorno	rückkehr
scott	scott
seriam	würden
seriam	wären
estudantes	studenten
ramos	zweige
machado	axt
brown	brown
rodrigo	rodrigo
definição	definition
xvi	xvi
rótulo	etikett
pan	pan
solar	solar
expansão	expansion
ufc	ufc
serão	werden
chegada	ankunft
segundos	sekunden
estatuto	statut
chile	chile
medalhas	medaillen
sudeste	südosten
jackson	jackson
assuntos	angelegenheiten
berlim	berlin
agricultura	landwirtschaft
utilização	verwendung
souza	souza
provas	beweise
dinastia	dynastie
gelo	eis
coimbra	coimbra
design	design
fauna	fauna
materiais	materialien
franco	franco
alcançou	erreichte
xviii	xviii
texas	texas
cenas	szenen
atuação	darbietung
west	west
instrumentos	instrumente
vendas	verkäufe
martinez	martinez
tony	tony
fãs	fans
rafael	rafael
oceano	ozean
taxonomy	taxonomy
joe	joe
posse	besitz
destino	schicksal
wrestling	wrestling
coroa	krone
daí	daraus
introdução	einleitung
aldeia	dorf
coleção	sammlung
day	day
ceará	ceará
catedral	kathedrale
exterior	außen
infantil	kindisch
mídia	medien
flor	blume
lopes	lopes
christian	christian
troca	austausch
ficção	fiktion
mike	mike
risco	risiko
juntos	zusammen
situado	gelegen
jogar	spielen
reconhecimento	anerkennung
oposição	opposition
clássico	klassisch
fácil	einfach
passo	schritt
felipe	felipe
noroeste	nordwesten
noroeste	nordwest
vontade	wille
honra	ehre
romanos	römer
vicente	vicente
aires	aires
ler	lesen
meios	mittel
diego	diego
avaliação	bewertung
barão	baron
chicago	chicago
zero	null
tentou	versuchte
conhecer	kennenlernen
conhecer	kennen
níveis	ebenen
manteve	behielt
pernambuco	pernambuco
advogado	rechtsanwalt
advogado	anwalt
orquestra	orchester
america	america
rural	ländliche
pista	spur
faleceu	verstorben
anti	anti
carnaval	karneval
estações	stationen
veículos	fahrzeuge
are	are
ganhar	gewinnen
condição	bedingung
lhes	ihnen
chama	nennt
egito	ägypten
windows	windows
continental	continental
brian	brian
executivo	exekutive
argumento	argument
enviado	gesendet
editar	bearbeiten
capa	cover
atacante	angreifer
arquipélago	archipel
peru	peru
steve	steve
competições	wettbewerbe
cavaleiro	ritter
diário	täglich
diário	tagebuch
voo	flug
plataforma	plattform
ciclo	zyklus
séries	reihen
serve	dient
ncbi	ncbi
árabe	arabisch
aplicação	anwendung
senado	senat
golpe	schlag
parlamento	parlament
povos	völker
dito	gesagt
constante	konstante
notícias	nachrichten
jogou	spielte
igrejas	kirchen
turismo	tourismus
retornou	zurückgekehrt
cobertura	deckung
vive	lebt
enorme	riesig
pierre	pierre
geografia	geographie
mtv	mtv
europaea	europaea
trabalhadores	arbeitnehmer
pintor	maler
poesia	poesie
floresta	wald
eric	eric
lua	mond
arthur	arthur
disciplina	disziplin
recorde	rekord
young	young
árvore	baum
invasão	invasion
mary	mary
fox	fox
computador	computer
casado	verheiratet
preciso	brauche
pinto	pinto
fotos	fotos
relativamente	relativ
construir	bauen
bento	benedikt
península	halbinsel
aspectos	aspekte
juventude	jugend
propriedades	eigenschaften
café	kaffee
irlanda	irland
elemento	element
pro	pro
deputados	abgeordneten
deputados	abgeordnete
imediatamente	sofort
territórios	gebiete
acredita	glaubt
venda	verkauf
juiz	richter
asteróides	asteroiden
planos	pläne
presidência	vorsitz
infância	kindheit
williams	williams
arquivo	datei
arquivo	archiv
corrente	kette
curitiba	curitiba
edward	edward
melhorar	verbessern
determinado	entschlossen
residência	wohnsitz
fabiano	fabiano
imdb	imdb
aparentemente	anscheinend
posições	positionen
direcção	richtung
verdadeiro	zutreffend
victor	victor
boca	mund
teste	test
santana	santana
not	not
bola	ball
exibido	angezeigt
bob	bob
organizações	organisationen
arco	bogen
interpretação	auslegung
blue	blue
preso	verhaftet
distritos	distrikte
matriz	matrix
empresário	unternehmer
viu	gesehen
frase	satz
anual	jährlich
carolina	carolina
detalhes	details
oxford	oxford
graduação	graduierung
produzir	produzieren
eliminado	gelöscht
girl	girl
críticos	kritiker
princípios	grundsätze
vasco	vasco
passageiros	passagiere
guitarrista	gitarrist
bélgica	belgien
agência	agentur
back	back
pico	pico
latim	latein
leite	milch
what	what
sucessor	nachfolger
senador	senator
angola	angola
alterações	änderungen
dinamarca	dänemark
will	will
bill	bill
doze	zwölf
arma	waffe
servidor	server
viveu	lebte
south	south
custo	kosten
intenção	absicht
peixe	fisch
longe	weit
coreia	korea
fins	zwecke
exceto	außer
meias	socken
execução	ausführung
execução	durchführung
fluminense	fluminense
representante	vertreter
sudoeste	südwesten
palco	bühne
estruturas	strukturen
mostrar	anzeigen
músicos	musiker
derrotou	besiegte
paraíba	paraíba
ferramentas	werkzeuge
gonçalves	gonçalves
florestas	wälder
alvo	ziel
guerras	kriege
aliança	allianz
fernandes	fernandes
céu	himmel
mendes	mendes
cenário	szenario
right	right
milhares	tausende
descrição	beschreibung
especificamente	spezifisch
especificamente	speziell
documentos	dokumente
folhas	blätter
soares	soares
embaixada	botschaft
tomou	nahm
nuclear	nukleare
frederico	friedrich
nação	nation
agente	agent
domingo	sonntag
sexual	sexuell
sexual	sexuelle
ônibus	bus
rodovia	autobahn
rápido	schnell
selo	siegel
redes	netzwerke
constelação	sternbild
trás	hinten
poderiam	könnten
nelson	nelson
criador	schöpfer
argumentos	argumente
similar	gleichartigen
high	high
promoção	förderung
alpes	alpen
identidade	identität
artístico	künstlerischen
johnson	johnson
anexo	anhang
característica	merkmal
rica	rica
representação	vertretung
insetos	insekten
judeus	juden
atlântico	atlantik
testes	tests
variedade	vielzahl
state	state
propaganda	propaganda
cruzeiro	kreuzfahrt
taylor	taylor
possivelmente	möglicherweise
anunciado	verkündet
medidas	maßnahmen
gás	gas
vieira	vieira
leitura	lesung
recebido	empfangen
possuía	besaß
galeria	galerie
nobre	edle
decide	entscheidet
decide	beschließt
long	long
expedição	versand
esperança	hoffnung
circuito	schaltung
astronomia	astronomie
missões	missionen
alma	seele
opção	option
titular	inhaber
melo	melo
revolta	aufstand
significado	bedeutung
sam	sam
leonardo	leonardo
discussões	diskussionen
flávio	flavius
arquivos	dateien
máquina	maschine
mosteiro	kloster
profissão	beruf
atletas	athleten
órbita	orbit
limites	grenzen
cara	gesicht
critério	kriterium
exploração	betrieb
jornais	zeitungen
kim	kim
perder	verlieren
potencial	potenzial
legal	cool
canto	ecke
roger	roger
diâmetro	durchmesser
andrade	andrade
econômico	ökonomisch
rui	rui
capítulo	kapitel
métodos	methoden
goiás	goiás
marcado	markiert
dicionário	wörterbuch
originais	originale
php	php
jazz	jazz
little	little
batista	batista
png	png
mario	mario
urbano	städtischen
pele	haut
podia	konnte
reunião	sitzung
colômbia	kolumbien
joga	spielt
miranda	miranda
society	society
frequência	häufigkeit
quadrinhos	comics
mail	mail
revistas	zeitschriften
tenente	lieutenant
ramo	zweig
noruega	norwegen
indicação	anwendungsgebiet
vencer	siegen
power	power
paula	paula
montanha	berg
escócia	schottland
historiador	historiker
aparição	erscheinung
montanhas	berge
chico	chico
aumentar	erhöhen
colaboração	mitarbeit
adaptação	anpassung
transformada	verarbeitete
denominação	bezeichnung
major	major
conflitos	konflikte
ácido	säure
hugo	hugo
classes	klassen
carros	autos
acacia	acacia
sebastião	sebastian
gêneros	genres
extra	extra
mistura	mischung
posterior	späteren
herói	held
províncias	provinzen
frota	flotte
possuir	besitzen
inimigos	feinde
home	haupt
xvii	xvii
continente	kontinent
punk	punk
anthony	anthony
centros	zentren
lógica	logik
dona	besitzerin
anderson	anderson
personalidade	persönlichkeit
notável	bemerkenswert
aniversário	geburtstag
hungria	ungarn
começar	beginnen
edifícios	gebäude
doutor	doktor
pedir	bitten
matar	töten
moderno	modern
liderança	führung
lança	startet
troféu	pokal
convidado	eingeladen
convidado	gast
hill	hill
mesa	tisch
revisão	rezension
revisão	überprüfung
inimigo	feind
citação	zitat
conceição	conceição
simon	simon
cristãos	christen
aves	vögel
fábrica	fabrik
visita	besuch
stone	stone
assistente	assistent
existir	existieren
sur	sur
flamengo	flämischen
silveira	silveira
boy	boy
villa	villa
green	green
chinês	chinesisch
proprietário	eigentümer
trabalha	arbeitet
cunha	cunha
razões	gründe
aviso	warnung
doenças	krankheiten
ribeira	ribeira
ray	ray
participações	beteiligungen
bloqueado	gesperrt
remix	remix
visual	visuelle
conferência	konferenz
oferece	bietet
autoridades	behörden
seguido	gefolgt
útil	nützlich
coluna	spalte
teixeira	teixeira
aliados	verbündete
exatamente	genau
vii	vii
dificuldades	schwierigkeiten
comunista	kommunistischen
reação	reaktion
fatos	tatsachen
regular	regulär
regular	regelmäßige
tempestade	sturm
pedidos	anträge
interna	interne
estrangeiros	ausländer
oportunidade	gelegenheit
folha	blatt
bernardo	bernhard
situa	stationiert
teresa	teresa
terminal	terminal
medo	angst
latino	latino
alice	alice
classificado	eingestuft
hollywood	hollywood
uruguai	uruguay
anime	anime
veículo	fahrzeug
desejo	wunsch
onda	welle
inaugurado	eingeweiht
derrotado	besiegt
professores	lehrer
seguiu	folgte
who	who
documentário	dokumentarfilm
garcia	garcia
animação	animation
guia	leitfaden
caça	jagd
arcebispo	erzbischof
violência	gewalt
dan	dan
órgãos	organe
venezuela	venezuela
curto	kurz
corinthians	korinther
estudar	studieren
moradores	bewohner
loja	laden
formando	bilden
diferenças	unterschiede
eurovisão	eurovision
nele	ihm
ave	vogel
responsabilidade	verantwortung
responsabilidade	haftung
avião	flugzeug
sinais	zeichen
conhece	kennst
licença	lizenz
mix	mix
cardoso	cardoso
beleza	schönheit
pictures	pictures
pés	füße
interesses	interessen
air	air
pacífico	pazifik
relacionamento	beziehung
part	part
alan	alan
festas	partys
rtp	rtp
barbosa	barbosa
media	media
lojas	geschäfte
albert	albert
tio	onkel
atualizado	aktualisiert
belém	bethlehem
foto	foto
tocar	berühren
coelho	kaninchen
proteger	schützen
errado	falsch
cardeal	kardinal
braço	arm
bloco	block
beira	beira
junta	junta
religioso	religiösen
way	way
notáveis	bemerkenswerte
viena	wien
first	first
ópera	oper
marie	marie
bragança	bragança
amazonas	amazonas
situações	situationen
voleibol	volleyball
legislação	gesetzgebung
exceção	ausnahme
direto	direkt
darwin	darwin
end	end
round	round
mateus	matthäus
bela	schöne
consumo	verbrauch
listas	listen
tim	tim
motores	motoren
portas	türen
canais	kanäle
campinas	campinas
tiago	tiago
camisa	hemd
iniciativa	initiative
normas	normen
north	north
últimas	neueste
patrimônio	heritage
redução	verringerung
helena	helena
cônjuge	ehepartner
cônjuge	ehegatten
cavalo	pferd
tiro	schuss
guimarães	guimarães
chamou	benannte
chamou	nannte
pior	schlimmer
largo	largo
registros	aufzeichnungen
goleiro	torwart
prima	drücken
trinta	dreißig
baía	bucht
last	last
hans	hans
rita	rita
jim	jim
death	death
maranhão	maranhão
marquês	marquis
publicações	veröffentlichungen
ranking	ranking
índios	indianer
catálogo	katalog
civis	zivilisten
proponente	bieter
playstation	playstation
barros	barros
tribo	stamm
alimentos	lebensmittel
escravos	sklaven
castela	kastilien
candidatos	kandidaten
milhão	million
concerto	konzert
vento	wind
skin	skin
resolver	lösen
viria	käme
turquia	türkei
ferramenta	werkzeug
momentos	momente
menino	junge
promovido	gefördert
lewis	lewis
traz	bringt
fatores	faktoren
permanente	ständigen
instalação	installation
karl	karl
socialista	sozialistischen
carl	carl
retirada	rücknahme
interessante	interessant
mor	mor
davis	davis
lagoa	lagune
galáxias	galaxien
secção	abschnitt
catalogue	catalogue
moths	moths
representou	vertreten
representou	vertrat
enciclopédico	enzyklopädische
marques	marques
brasão	wappen
rugby	rugby
ajudou	half
jan	jan
amarelo	gelb
metro	metro
guiné	guinea
mister	mister
aux	aux
descendentes	nachkommen
salvar	speichern
árbitro	schiedsrichter
duarte	duarte
nuno	nuno
adam	adam
opções	optionen
gustavo	gustavo
funcionários	beamten
pib	bip
trouxe	brachte
documento	dokument
comitê	komitee
bacia	becken
produziu	produzierte
paraguai	paraguay
ausência	abwesenheit
destruição	zerstörung
destruição	vernichtung
douglas	douglas
ativo	aktiv
country	country
abreu	abreu
descrito	beschrieben
cria	schafft
salto	sprung
tela	bildschirm
raça	rasse
bilhões	milliarden
habilidades	fähigkeiten
contar	erzählen
cambridge	cambridge
carne	fleisch
lord	lord
medieval	mittelalterlichen
perdido	verloren
servir	dienen
lutar	kämpfen
indígenas	indigenen
palmeiras	palmen
potência	leistung
imigrantes	einwanderer
espada	schwert
funciona	funktioniert
opera	opera
vertical	vertikale
árvores	bäume
sonho	traum
tido	gehabt
assinatura	unterschrift
assinatura	unterzeichnung
organizado	organisiert
partidos	parteien
alternativa	alternative
xavier	xavier
habitats	lebensräume
treinamento	training
wwe	wwe
mitologia	mythologie
renato	renato
kevin	kevin
elite	elite
jong	jong
emprego	beschäftigung
mostrou	zeigte
vendido	verkauft
divisões	abteilungen
recepção	empfang
open	open
aviões	flugzeuge
zelândia	seeland
largura	breite
bruce	bruce
componentes	komponenten
cemitério	friedhof
gonçalo	gonçalo
centenas	hunderte
monteiro	monteiro
petróleo	erdöl
permitir	zulassen
paixão	leidenschaft
humanidade	menschheit
lady	lady
aeronaves	luftfahrzeuge
assumir	übernehmen
orçamento	haushalt
específico	spezifischen
concentração	konzentration
campus	campus
pinheiro	pinheiro
caiu	fiel
mente	verstand
botafogo	botafogo
artilharia	artillerie
boston	boston
permitiu	erlaubte
permitiu	ermöglichte
abrir	öffnen
intervenção	intervention
heart	heart
missouri	missouri
incluir	einschließen
famosos	berühmte
mecânica	mechanik
mecânica	mechanische
arquiteto	architekt
kelly	kelly
esforço	aufwand
esforço	anstrengungen
indivíduo	individuum
passos	schritte
produtores	erzeuger
influências	einflüsse
vizinhos	nachbarn
atenas	athen
integração	integration
vargas	vargas
transportes	verkehr
cresceu	aufgewachsen
confederação	konföderation
gil	gil
down	down
colonial	kolonialen
telefone	telefon
paredes	wände
conservação	erhaltung
ameaça	bedrohung
bíblia	bibel
pergunta	frage
tese	these
declaração	erklärung
primo	cousin
holanda	niederlande
lenda	legende
ideal	ideal
chamadas	anrufe
aventura	abenteuer
pedras	steine
araújo	araújo
plant	plant
desenhos	zeichnungen
sucessão	nachfolge
download	download
download	herunterladen
aparência	aussehen
apresentações	präsentationen
garden	garden
observação	anmerkung
observação	beobachtung
observação	bemerkung
excelente	ausgezeichnet
descobrir	entdecken
chão	boden
deuses	götter
lagos	lagos
grão	korn
valign	valign
inúmeras	unzählige
johnny	johnny
nick	nick
definido	definiert
confiança	vertrauen
habilidade	geschicklichkeit
árabes	araber
bot	bot
tratar	behandeln
ginástica	gymnastik
sugestões	anregungen
his	seins
blog	blog
açúcar	zucker
angra	angra
laboratório	labor
enviou	schickte
drogas	drogen
fases	phasen
jerusalém	jerusalem
moda	mode
doutrina	doktrin
samuel	samuel
eixo	achse
inteligência	intelligenz
carregado	geladen
ford	ford
claramente	eindeutig
good	good
olho	auge
jacques	jacques
blues	blues
dificuldade	schwierigkeit
costas	rücken
opiniões	meinungen
instalações	anlagen
objetivos	ziele
ligado	verbunden
alfredo	alfredo
parcial	teilweise
aplicações	anwendungen
descreve	beschreibt
descobriu	entdeckte
stephen	stephen
marcas	marken
cuba	kuba
tarefa	aufgabe
círculo	kreis
alcance	reichweite
consciência	bewusstsein
preço	preis
viii	viii
caminhos	pfade
dedicado	gewidmet
universidades	universitäten
tavares	tavares
andrew	andrew
empate	unentschieden
font	font
facebook	facebook
areia	sand
períodos	zeiträume
jason	jason
inaugurada	eingeweiht
teclado	tastatur
cavalaria	kavallerie
aceita	akzeptiert
extinção	aussterben
patrick	patrick
dead	dead
vídeos	videos
convenção	übereinkommen
regimento	geschäftsordnung
editorial	redaktionelle
xiii	xiii
culto	kult
democracia	demokratie
billy	billy
moral	moral
microrregião	mikroregion
flórida	florida
get	get
calor	wärme
provável	wahrscheinliche
atletismo	leichtathletik
irmãs	schwestern
constantinopla	konstantinopel
pede	bittet
nunes	nunes
polónia	polen
discutir	diskutieren
liberal	liberal
lourenço	lourenço
mérito	verdienst
interno	internen
práticas	praktiken
depressão	depression
caetano	caetano
moreira	moreira
compra	kauf
leve	leicht
conceitos	konzepte
dark	dark
nintendo	nintendo
artilheiro	torschützen
raimundo	raimund
representar	repräsentieren
rota	route
elizabeth	elizabeth
certos	bestimmte
microsoft	microsoft
sun	sun
cristianismo	christentum
desambiguação	begriffsklärung
uefa	uefa
ruy	ruy
their	their
revelou	offenbarte
revelou	ergab
foco	brennpunkt
molecular	molekulare
dimensões	abmessungen
warner	warner
year	year
estudante	student
amizade	freundschaft
amiga	freundin
giovanni	giovanni
vantagem	vorteil
peixes	fische
cláudio	claudius
goethe	goethe
médicos	ärzte
sanderson	sanderson
plants	plants
transição	übergang
muda	ändert
terror	terror
cri	cri
durou	dauerte
baterista	schlagzeuger
jimmy	jimmy
bad	bad
net	net
clark	clark
conquistar	erobern
experiências	erfahrungen
moeda	währung
visconde	viscount
rose	rose
paranaense	paranaense
atitude	haltung
feliz	glücklich
síria	syrien
primavera	frühling
popularidade	beliebtheit
popularidade	popularität
dave	dave
xii	xii
porte	porte
ribeirão	ribeirão
azevedo	azevedo
dúvidas	zweifel
spam	spam
calendário	zeitplan
decisões	entscheidungen
aulas	unterricht
charlie	charlie
marvel	marvel
definir	definieren
garantir	garantieren
equador	ecuador
resultou	führte
chance	chance
subsp	subsp
terrestre	terrestrischen
contemporânea	zeitgenössische
page	page
miller	miller
libertadores	befreier
teorias	theorien
sessão	sitzung
toronto	toronto
assis	assisi
manoel	manoel
columbia	columbia
heróis	helden
onze	elf
estratégia	strategie
aceitar	akzeptieren
britânicos	briten
campanhas	kampagnen
kong	kong
idéia	idee
eletrônica	elektronik
light	light
morrer	sterben
grêmio	grêmio
viagens	reisen
computação	computing
integrante	integraler
magalhães	magellan
subtropicais	subtropischen
virtual	virtuelle
máquinas	maschinen
agentes	bediensteten
pilotos	piloten
geórgia	georgien
verificar	überprüfen
quente	heiß
danos	schaden
sony	sony
michel	michel
junior	junior
ibge	ibge
matt	matt
freitas	freitas
superman	superman
procurar	suchen
torcida	verdreht
professora	lehrerin
comparação	vergleich
correto	korrekt
correto	richtig
cujos	deren
tupi	tupi
bordo	bord
colegas	kollegen
maurício	moritz
escudo	schild
revelado	aufgedeckt
bbc	bbc
teologia	theologie
trazer	mitbringen
howard	howard
explicar	erklären
cumprir	erfüllen
lutas	kämpfe
certas	bestimmte
macau	macau
endémica	endemisch
iluminação	beleuchtung
sobrinho	neffe
câncer	krebs
foz	foz
abc	abc
declinação	deklination
teriam	hättet
teriam	hätten
relacionado	verwandt
sueco	schwedisch
ryan	ryan
jaime	jaime
correspondente	entsprechenden
more	more
separação	trennung
cristina	cristina
sofia	sofia
moura	moura
indiana	indiana
ips	ips
adultos	erwachsene
jane	jane
glória	ruhm
estilos	stile
cerimônia	zeremonie
gigante	riese
vírus	viren
ganha	gewinnt
chuva	regen
raízes	wurzeln
allen	allen
ditadura	diktatur
fábio	fábio
restante	rest
soul	soul
estradas	straßen
transformação	verarbeitung
infelizmente	leider
atmosfera	atmosphäre
play	play
africano	afrikanische
médica	ärztin
tendência	trend
tendência	tendenz
óleo	öl
matemático	mathematiker
nomeação	ernennung
fred	fred
especialista	experte
mac	mac
fachada	fassade
talk	talk
other	other
filósofo	philosoph
wikimedia	wikimedia
aeronave	luftfahrzeug
confronto	konfrontation
jeff	jeff
sal	salz
xiv	xiv
fonseca	fonseca
piauí	piauí
idh	hdi
psicologia	psychologie
graus	grad
moçambique	mosambik
polo	polo
autonomia	autonomie
bulgária	bulgarien
laura	laura
operacional	operationellen
tóquio	tokio
definitivamente	definitiv
cerco	belagerung
ondas	wellen
percussão	percussion
francis	francis
permanece	bleibt
iraque	irak
legenda	untertitel
fenômeno	phänomen
estatística	statistische
estatística	statistik
finlândia	finnland
desconhecido	unbekannt
supremo	obersten
humor	humor
interface	schnittstelle
produções	produktionen
extinto	ausgestorben
sabia	wusste
poema	gedicht
determinar	bestimmen
great	great
necessidades	bedürfnisse
substituir	ersetzen
filhas	töchter
espera	warte
sons	klänge
destruir	zerstören
tentativas	versuche
tarefas	aufgaben
ensaio	prüfung
receita	rezept
objectos	objekte
parar	anhalten
quinze	fünfzehn
lixo	müll
cônsul	konsul
tabelas	tabellen
gregos	griechen
pires	pires
escolher	wählen
datas	termine
youtube	youtube
videoclipe	musikvideo
dna	dna
causou	verursachte
value	value
exerceu	ausgeübt
australian	australian
casar	heiraten
contava	zählte
dor	schmerz
dor	schmerzen
colega	kollegin
duplo	doppelten
hino	hymne
diogo	diogo
convite	einladung
frio	kalt
adicional	zusätzliche
leonard	leonard
italianos	italiener
mover	verschieben
may	may
impossível	unmöglich
clientes	kunden
aranha	spinne
anel	ring
hop	hop
instrumental	instrumental
con	con
rádios	radios
have	have
contando	zählen
viana	viana
formal	förmlichen
cedo	früh
marte	mars
convidados	gäste
iniciais	initialen
gosta	gefällt
batalhas	schlachten
cobre	kupfer
lúcio	lucius
ida	ida
commons	commons
equilíbrio	gleichgewicht
espiritual	spirituelle
camada	schicht
defensor	verteidiger
católicos	katholiken
morre	stirbt
morre	stirb
limpeza	reinigung
hip	hip
testamento	testament
avô	großvater
partículas	partikel
tribos	stämme
hipótese	hypothese
traduzido	übersetzt
democrata	demokrat
indústrias	industrien
fator	faktor
transformar	transformieren
illinois	illinois
mariana	mariana
gordon	gordon
santuário	schrein
cantar	singen
hard	hard
planejamento	planung
gray	gray
restauração	wiederherstellung
fugir	fliehen
impressão	eindruck
bloqueios	blockaden
confusão	verwirrung
now	now
dimensão	dimension
tensão	spannung
causas	ursachen
mhz	mhz
cordas	seile
when	when
assinado	unterzeichnet
receberam	erhielten
desafio	herausforderung
free	free
aço	stahl
alchemilla	alchemilla
leon	leon
vencedores	gewinner
concertos	konzerte
pontuação	score
pesca	angeln
cópia	kopie
produtora	produzentin
wild	wild
memórias	erinnerungen
precedente	präzedenzfall
pdf	pdf
joana	johanna
adversário	gegner
margarida	marguerite
estátua	statue
fire	fire
rolling	rolling
ernesto	ernesto
placa	platte
christopher	christopher
jornalismo	journalismus
recuperação	erholung
editado	bearbeitet
moore	moore
lake	lake
atuando	acting
gabinete	kabinett
estranho	seltsam
votações	abstimmungen
html	html
endereço	adresse
defendeu	verteidigte
milão	mailand
sintomas	symptome
álvaro	álvaro
let	let
perspectiva	perspektive
maddox	maddox
dama	dame
trio	trio
marcha	marsch
inspirado	inspiriert
composições	kompositionen
boys	boys
exercício	übung
exercício	ausübung
navegação	navigation
culturas	kulturen
citar	zitieren
manual	handbuch
clã	clan
var	var
progresso	fortschritt
dragão	drache
parede	wand
toneladas	tonnen
assume	übernimmt
combustível	kraftstoff
sic	sic
espero	hoffe
mecanismo	mechanismus
hitler	hitler
congo	kongo
norma	norm
europe	europe
profundidade	tiefe
substituição	ersatz
nobreza	adel
cão	hund
cadeira	stuhl
interpretar	interpretieren
over	over
ivan	ivan
françois	françois
old	old
explica	erklärt
restos	überreste
governos	regierungen
lesão	verletzung
combinação	kombination
dei	dei
vegetação	vegetation
hong	hong
monarquia	monarchie
batalhão	bataillon
vozes	stimmen
perseguição	verfolgung
veneza	venedig
asas	flügel
tradições	traditionen
comunicações	kommunikation
almirante	admiral
escritora	schriftstellerin
limitada	limitiert
caio	gaius
zagueiro	abwehrspieler
equação	gleichung
identificação	identifizierung
alfred	alfred
bolívia	bolivien
mello	mello
memorial	memorial
varia	variiert
vasconcelos	vasconcelos
enviar	senden
queen	queen
vinho	wein
carbono	kohlenstoff
virgem	jungfrau
borges	borges
aragão	aragon
away	away
mudo	stumm
sarah	sarah
olimpíadas	olympiade
napoleão	napoleon
bomba	bombe
dezenas	dutzende
dream	dream
just	just
companhias	firmen
escritório	büro
mini	mini
magia	magie
válido	gültig
postal	postkarte
quebra	bricht
treze	dreizehn
nicolau	nikolaus
place	place
administrativo	administrativen
segredo	geheimnis
della	della
decidir	entscheiden
fuga	flucht
vir	vir
finalidade	zweck
rick	rick
side	side
miami	miami
representado	vertreten
dragon	dragon
florianópolis	florianópolis
east	east
temperaturas	temperaturen
moon	moon
exposições	ausstellungen
deserto	wüste
bônus	bonus
construiu	baute
tênis	tennis
soma	summe
cem	hundert
pastor	pastor
aviação	luftfahrt
ventos	winde
candidatura	bewerbung
deusa	göttin
pobres	armen
irã	iran
manaus	manaus
escreve	schreibt
revelação	offenbarung
descreveu	beschrieb
patente	patent
causando	verursacht
filipinas	philippinen
reformas	reformen
anne	anne
batman	batman
afluente	zulauf
ocorreram	traten
manchester	manchester
acervo	besitzstand
torneios	turniere
libertação	freilassung
gilberto	gilberto
atribuído	zugewiesen
marina	marina
roteirista	drehbuchautor
automaticamente	automatisch
inspiração	inspiration
ucrânia	ukraine
especializada	spezialisiert
estrangeiro	ausland
condados	grafschaften
type	type
concílio	konzil
abuso	missbrauch
supostamente	angeblich
andy	andy
constantino	konstantin
moraes	moraes
marketing	marketing
raul	raul
some	some
variável	variable
ouvir	hören
perigo	gefahr
brilhante	brillant
bytes	bytes
constantemente	ständig
prorrogação	verlängerung
aprovado	genehmigt
cuidado	vorsicht
baixista	bassist
lutador	kämpfer
paralelo	parallel
equipamento	ausrüstung
visitantes	besucher
certamente	sicherlich
sydney	sydney
incluído	eingeschlossen
age	age
cientista	wissenschaftler
democrático	demokratisch
ohio	ohio
victoria	victoria
deriva	drift
acompanhado	begleitet
saga	saga
jerry	jerry
estúdios	studios
soluções	lösungen
vapor	dampf
pagamento	zahlung
acusado	angeklagt
virtude	tugend
cabelo	haare
tecnologias	technologien
companheiros	kameraden
encerramento	schließung
amaral	amaral
vieram	kamen
maestro	maestro
indonésia	indonesien
ruínas	ruinen
vencedora	gewinnerin
querer	wollen
marechal	marschall
aloe	aloe
instalado	installiert
coro	chor
aceitou	akzeptierte
parceiro	partner
particulares	privatpersonen
imperatriz	kaiserin
grammy	grammy
neve	schnee
mortes	todesfälle
publicidade	werbung
platina	platin
sporting	sporting
olhar	blick
dispositivo	gerät
presidentes	präsidenten
iniciar	starten
basílica	basilika
companheiro	kumpel
cidadão	bürger
sampaio	sampaio
perde	verliert
marcar	markieren
caro	teuer
raios	speichen
pablo	pablo
reality	reality
completar	vervollständigen
altar	altar
andrea	andrea
visível	sichtbar
jonathan	jonathan
colocando	indem
religiões	religionen
legislatura	wahlperiode
mencionado	erwähnt
pequim	peking
bispos	bischöfe
master	master
paraíso	paradies
lisa	lisa
reduzir	verringern
madonna	madonna
esr	esr
colonização	kolonisierung
muçulmanos	muslime
cirurgia	operation
proporção	anteil
hamilton	hamilton
lost	lost
sujeito	subjekt
heavy	heavy
personalidades	persönlichkeiten
fantasia	fantasie
preparação	zubereitung
ensaios	prüfungen
modos	modi
fabricante	hersteller
then	then
requisitos	anforderungen
post	post
ian	ian
aplicada	angewandte
seções	abschnitte
gales	wales
soldado	soldat
madalena	magdalena
esperar	warten
abordagem	ansatz
hit	hit
hit	treffer
básico	grundlegende
belga	belgier
bell	bell
wagner	wagner
planalto	plateau
tripulação	besatzung
identificar	identifizieren
benjamin	benjamin
wayne	wayne
civilização	zivilisation
alfabeto	alphabet
vereador	stadtrat
ciclismo	radfahren
líquido	flüssig
líquido	flüssigkeit
apoiar	unterstützen
jay	jay
merece	verdient
regente	regent
soviético	sowjetischen
secundário	sekundären
people	people
demo	demo
longitude	längengrad
toca	tippe
cabral	cabral
dispositivos	geräte
surgimento	entstehung
orlando	orlando
descendente	nachkomme
here	here
potter	potter
surgiram	entstanden
cortes	schnitte
cortes	kürzungen
montreal	montreal
vera	vera
módulo	modul
oliver	oliver
geraldo	geraldo
acusações	anschuldigungen
partiu	brach
predefinições	voreinstellungen
british	british
there	there
vilão	bösewicht
botânica	botanik
parecem	scheinen
elétrico	elektrisch
espiral	spirale
considerável	beträchtliche
vegas	vegas
jardins	gärten
jon	jon
cia	cia
hóquei	hockey
albuquerque	albuquerque
manifestações	demonstrationen
entregue	geliefert
experimental	experimentelle
pokémon	pokémon
watson	watson
entrega	lieferung
una	una
classificados	kleinanzeigen
cavalos	pferde
observar	beobachten
atração	attraktion
atração	anziehung
leo	leo
riqueza	reichtum
robin	robin
aparições	auftritte
only	only
adequado	angemessen
remover	entfernen
talento	talent
steven	steven
ross	ross
intensidade	intensität
aprender	lernen
goiânia	goiânia
integrar	integrieren
sério	ernst
angel	angel
eva	eva
provar	beweisen
exércitos	armeen
escultura	skulptur
áudio	audio
quadrados	quadrate
pesado	schwer
rapper	rapper
shift	shift
pio	pio
condenado	verurteilt
fechado	geschlossen
estatísticas	statistiken
limitado	begrenzt
repórter	reporter
mental	psychische
mesquita	moschee
barco	boot
russell	russell
roupa	kleidung
roupa	kleider
rossi	rossi
objectivo	zielsetzung
sozinho	allein
sozinho	alleine
explicação	erläuterung
mostrado	angezeigt
infinito	unendlich
privado	privat
carmo	carmo
seminário	seminar
marrocos	marokko
leitor	leser
harris	harris
penal	strafrechtlichen
luísa	luise
bancos	banken
eds	eds
gado	vieh
thiago	thiago
opcional	optional
filtro	filter
estágio	praktikum
perry	perry
duquesa	herzogin
row	row
guy	guy
organizar	organisieren
teclados	tastaturen
tornado	tornado
biologia	biologie
assassinado	ermordet
creditado	gutgeschrieben
linux	linux
colunas	spalten
diálogo	dialog
toledo	toledo
nasa	nasa
brito	brito
artur	artur
sofre	leidet
cai	fällt
colorado	colorado
pensilvânia	pennsylvania
cooperação	zusammenarbeit
variáveis	variablen
cérebro	gehirn
arquidiocese	erzdiözese
olá	hallo
amante	liebhaber
avaliar	bewerten
benfica	benfica
stanley	stanley
exílio	exil
aumenta	erhöht
conexão	verbindung
documentação	dokumentation
síndrome	syndrom
gene	gene
luciano	luciano
radiação	strahlung
fórum	forum
ultimate	ultimate
anjo	engel
afro	afro
positivo	positiv
holandês	niederländisch
furacão	hurrikan
jun	jun
nba	nba
compreensão	verständnis
carlo	carlo
milton	milton
eddie	eddie
lula	lula
sant	sant
toma	nimmt
cineasta	filmemacher
impostos	steuern
fabricação	herstellung
never	never
god	god
inferno	hölle
abre	öffne
preferência	präferenz
investimentos	investitionen
golden	golden
dario	dario
previsto	vorgesehen
oferta	angebot
confirmou	bestätigte
paisagem	landschaft
stewart	stewart
onu	uno
comprar	kaufen
esquema	schema
forçado	erzwungen
silent	silent
gerar	erzeugen
apresentadora	moderatorin
nogueira	nogueira
prússia	preußen
sock	sock
cálculo	berechnung
créditos	forderungen
sábado	samstag
donald	donald
barreto	barreto
normandia	normandie
rebeldes	rebellen
subespécie	unterart
disposição	anordnung
explosão	explosion
atlas	atlas
laranja	orange
registrado	registriert
quarenta	vierzig
otto	otto
seguro	versicherung
preços	preise
descrever	beschreiben
constantes	konstanten
town	town
delta	delta
kennedy	kennedy
adição	zusatz
figueiredo	figueiredo
sagrado	heilig
amador	amateur
raiz	wurzel
concessão	gewährung
braços	arme
célula	zelle
marcus	marcus
substância	substanz
sétima	siebte
empregados	angestellte
associações	verbände
sofrer	leiden
domínios	domains
domínios	bereichen
segmento	segment
confirmado	bestätigt
henri	henri
otomano	osmanischen
arts	arts
continuidade	kontinuität
mapas	karten
newton	newton
atp	atp
ovos	eier
coutinho	coutinho
corrupção	korruption
praga	prag
inácio	ignatius
monarca	monarch
virgínia	virginia
triângulo	dreieck
embaixador	botschafter
blocos	blöcke
resumo	zusammenfassung
negociações	verhandlungen
pão	brot
roll	roll
marcação	kennzeichnung
vingança	rache
divino	göttlich
fernanda	fernanda
gary	gary
acreditava	glaubte
continuação	fortsetzung
massachusetts	massachusetts
reprodução	wiedergabe
abriga	beherbergt
rap	rap
vazio	leer
jordan	jordan
century	century
box	box
unesco	unesco
contribuir	beitragen
orig	orig
coordenação	koordinierung
viajou	reiste
permissão	erlaubnis
argélia	algerien
prisioneiros	gefangene
artificial	künstliche
claude	claude
placas	platten
marc	marc
infante	infante
câmera	kamera
atualização	aktualisierung
atualização	update
falou	sprach
instruções	anweisungen
interação	interaktion
concepção	gestaltung
horror	horror
lorena	lothringen
take	take
baiano	baiano
lutou	kämpfte
implementação	umsetzung
rosário	rosenkranz
iso	iso
aquisição	erwerb
xbox	xbox
lawrence	lawrence
antecessor	vorgänger
franklin	franklin
viúva	witwe
setores	sektoren
adicionar	hinzufügen
contribuiu	beigetragen
sky	sky
mel	honig
alias	alias
barry	barry
formiga	ameise
cauda	schwanz
leal	loyal
ibérica	iberischen
antiguidade	antike
sentimentos	gefühle
perfeito	perfekt
interpreta	interpretiert
discografia	diskografie
pertencia	gehörte
variedades	sorten
dentes	zähne
trajetória	flugbahn
executado	hingerichtet
diana	diana
franz	franz
adotado	adoptiert
est	est
racing	racing
wright	wright
cirílico	kyrillisch
rogério	rogério
incidente	vorfall
ética	ethik
cura	heilung
alegria	freude
ocupado	beschäftigt
austin	austin
alexandria	alexandria
bros	bros
preocupação	besorgnis
estreito	engem
conversa	gespräch
deixado	gelassen
buscar	abzuholen
freire	freire
conquistas	errungenschaften
passagens	passagen
canta	singt
morreram	starben
entrevistas	interviews
morgan	morgan
sacerdote	priester
vender	verkaufen
essencial	wesentlichen
típico	typisch
vidro	glas
mega	mega
alagoas	alagoas
voluntários	freiwillige
estocolmo	stockholm
pensa	denkt
cita	zitiert
earth	earth
usina	kraftwerk
necessariamente	unbedingt
carter	carter
variante	variante
gregório	gregor
genética	genetische
declínio	rückgang
camadas	schichten
rangers	rangers
camargo	camargo
reta	geraden
esperado	erwartete
esperado	erwartet
basquetebol	basketball
entendi	verstanden
postos	posten
cachoeira	wasserfall
surpresa	überraschung
kid	kid
cabe	paßt
herbert	herbert
moedas	währungen
afluentes	nebenflüsse
coadjuvante	entkräftung
borgonha	burgund
radical	radikalen
roy	roy
luxemburgo	luxemburg
inteligente	intelligent
incluiu	umfasste
beatriz	beatriz
inédita	beispiellose
pontes	brücken
relógio	uhr
mediterrâneo	mittelmeer
monstro	monster
macedo	macedo
law	law
jonas	jonas
executar	ausführen
dean	dean
armando	armando
phil	phil
pernas	beine
fome	hunger
inscrição	eintragung
inscrição	anmeldung
larry	larry
auxílio	beihilfe
diversidade	vielfalt
pura	reine
introduzido	eingegeben
concedido	bewilligt
arcos	bögen
veiga	veiga
usp	usp
milhas	meilen
baptista	baptista
respostas	antworten
ativos	vermögenswerte
bernard	bernard
festivais	festivals
respondeu	antwortete
wars	wars
ken	ken
vladimir	wladimir
anglo	anglo
parâmetros	parameter
teles	teles
quilómetros	kilometer
residências	residenzen
lembrar	erinnern
official	official
milho	mais
agostinho	augustinus
prado	wiese
proteínas	proteine
getúlio	getúlio
massacre	massaker
romances	romane
atlanta	atlanta
bond	bond
apple	apple
guerreiro	krieger
fortuna	vermögen
heroísmo	heldentum
janela	fenster
sonic	sonic
days	days
blood	blood
menezes	menezes
captura	fang
raw	raw
sonhos	träume
nazista	nazi
adulto	erwachsener
russos	russen
corrigir	korrigieren
rodas	räder
reservas	reservierung
substâncias	stoffe
cães	hunde
coral	korallen
uai	isu
sente	spürt
sente	fühlt
marciais	martial
return	return
isaac	isaak
herança	erbe
compositores	komponisten
mauro	mauro
guarani	guarani
regina	regina
márcio	martius
inter	inter
fiel	treu
persa	persisch
observações	bemerkungen
lazer	freizeit
fátima	fatima
ocorrência	vorkommen
jacob	jacob
propôs	vorgeschlagen
wood	wood
representada	vertreten
vistos	visa
recorrente	klägerin
decidiram	beschlossen
adriano	adriano
rob	rob
oportunidades	chancen
oportunidades	möglichkeiten
tecidos	gewebe
diretoria	vorstand
elevação	heben
but	but
recordes	rekorde
futsal	futsal
dominante	beherrschenden
conversão	umwandlung
case	case
selvagens	wilden
adams	adams
again	again
distinção	unterscheidung
nevada	nevada
álcool	alkohol
prince	prince
sobreviventes	überlebende
panamá	panama
ótimo	großartig
ótimo	toll
tipicamente	gewöhnlich
lópez	lópez
tailândia	thailand
sergio	sergio
aguiar	aguiar
praias	strände
literalmente	buchstäblich
non	non
rangel	rangel
esfera	sphäre
esfera	kugel
vivia	lebte
cabeças	köpfe
jornalistas	journalisten
justin	justin
flash	flash
after	after
florença	florenz
precisão	genauigkeit
michigan	michigan
nigéria	nigeria
danny	danny
mora	wohnt
gen	gen
aplicar	anwenden
algoritmo	algorithmus
josh	josh
legião	legion
rey	rey
mortal	tödliche
escuro	dunkel
coreano	koreanisch
afeganistão	afghanistan
sociedades	gesellschaften
integra	integriert
assassino	mörder
entretenimento	unterhaltung
senhores	herren
garcía	garcía
twitter	twitter
evangelho	evangelium
eliminatórias	probetraining
lincoln	lincoln
costumes	sitten
obviamente	offensichtlich
gay	homosexuell
operador	betreiber
bits	bits
marshall	marshall
reinos	königreiche
brigada	brigade
under	under
turco	türkisch
sobrenome	nachname
derivado	abgeleiteten
meninas	mädchen
caracteriza	kennzeichnet
rosaceae	rosaceae
peito	brust
into	into
kansas	kansas
formalmente	formal
matthew	matthew
sicília	sizilien
barbara	barbara
gov	gov
rebelião	rebellion
abu	abu
gráficos	grafiken
arroz	reis
she	she
stuttgart	stuttgart
sentir	fühlen
restaurante	restaurant
planetas	planeten
iron	iron
suspensão	aussetzung
montagem	montage
félix	felix
emergência	notfall
hélio	helium
summer	summer
montenegro	montenegro
sombra	schatten
woman	woman
botão	knopf
matos	matos
baker	baker
escolheu	wählte
vda	vda
beta	beta
permitido	zulässig
anastácio	anastasios
informática	informatik
dinâmica	dynamik
sentimento	gefühl
contagem	zählen
compositora	komponistin
violino	geige
patriarca	patriarch
ambientes	umgebungen
cristal	kristall
granada	granada
cristóvão	christoph
grant	grant
autora	autorin
autora	verfasserin
genebra	genf
sementes	saatgut
sementes	samen
guanabara	guanabara
parker	parker
repertório	repertoire
avisos	warnungen
certificado	zertifikat
shakespeare	shakespeare
parecia	schien
poderosa	mächtig
poderosa	mächtige
bobby	bobby
cantou	sang
perguntas	fragen
fighter	fighter
vereadores	stadträte
has	has
diagnóstico	diagnose
estável	stabil
curva	kurve
feridos	verletzte
edgar	edgar
baltimore	baltimore
descobertas	entdeckungen
ronaldo	ronaldo
seco	trocken
seco	getrocknet
parques	parks
harmonia	harmonie
substituiu	ersetzte
aposentado	pensionierter
versos	verse
taxas	gebühren
dedicar	widmen
externo	extern
alimentar	ernähren
outono	herbst
hamburgo	hamburg
oração	gebet
componente	komponente
irrelevante	irrelevant
divina	göttliche
cronologia	chronik
mma	mma
reputação	ruf
férias	urlaub
júpiter	jupiter
projetado	entworfen
vascular	vaskuläre
isótopo	isotop
paquistão	pakistan
joel	joel
suicídio	selbstmord
adaptado	angepasst
ibn	ibn
jennifer	jennifer
finanças	finanzen
close	close
sergipe	sergipe
pioneiro	pionier
want	want
bottom	bottom
tennessee	tennessee
baden	baden
complexidade	komplexität
sean	sean
voos	flüge
turistas	touristen
plataformas	plattformen
brothers	brothers
condessa	gräfin
mercados	märkte
cat	cat
tia	tante
houston	houston
dennis	dennis
frases	sätze
foguete	rakete
coordenadas	koordinaten
formaram	bildeten
stuart	stuart
kate	kate
corre	läuft
nápoles	neapel
decidido	entschieden
cantão	kanton
pessoalmente	persönlich
francesco	francesco
barroco	barock
declarado	deklariert
uss	uss
itunes	itunes
manda	schick
rivalidade	rivalität
cinemas	kinos
húngaro	ungarisch
gravidade	schwerkraft
pobreza	armut
philip	philip
oitava	achte
anúncio	werbeanzeige
reconstrução	wiederaufbau
tocantins	tocantins
aproximação	annäherung
robô	roboter
aceito	akzeptiere
pink	pink
head	head
harvard	harvard
cheio	voll
ann	ann
orquídea	orchidee
trindade	dreifaltigkeit
probabilidade	wahrscheinlichkeit
volante	lenkrad
engenheiros	ingenieure
évora	évora
bloquear	blockieren
biodiversidade	biodiversität
contraste	kontrast
kiss	kiss
natação	schwimmen
desporto	sport
quantidades	mengen
minissérie	miniserie
polonês	polnisch
years	years
point	point
knight	knight
vendo	verkaufe
vinicius	vinicius
cooper	cooper
chase	chase
celeste	celeste
bryan	bryan
true	true
walker	walker
clínica	klinik
ossos	knochen
vincent	vincent
destruído	zerstört
mendonça	mendonça
seguiram	folgten
expressões	ausdrücke
gonzález	gonzález
protestos	proteste
greg	greg
queiroz	queiroz
legado	vermächtnis
revolucionário	revolutionär
entradas	einträge
ruim	schlecht
croácia	kroatien
variantes	varianten
amy	amy
destro	rechtshänder
modalidades	modalitäten
eficiente	effizient
hierarquia	hierarchie
demonstrar	demonstrieren
premiação	preisverleihung
abadia	abtei
walt	walt
encontraram	fanden
complexos	komplexe
caldas	caldas
spencer	spencer
terry	terry
crescer	wachsen
protocolo	protokoll
cristiano	cristiano
animado	aufgeregt
lema	motto
son	son
ângulo	winkel
beatles	beatles
murray	murray
gonzaga	gonzaga
tommy	tommy
metais	metalle
four	four
abandonado	aufgegeben
carey	carey
broadway	broadway
dick	dick
testemunhas	zeugen
determinação	bestimmung
nicolas	nicolas
fighting	fighting
minerais	mineralien
separado	getrennt
decoração	dekoration
secret	secret
herschel	herschel
diretora	direktorin
analisar	analysieren
moléculas	moleküle
previsão	prognose
julio	julio
acre	acre
melhoria	verbesserung
carmen	carmen
estimado	geschätzt
comendador	commendatore
hab	einw
resolve	löst
censura	zensur
assembléia	versammlung
movido	verschoben
jersey	jersey
hell	hell
chineses	chinesen
renascimento	wiedergeburt
colonos	siedler
campbell	campbell
cultivo	anbau
galo	hahn
reuniões	sitzungen
gerações	generationen
sabendo	wissend
capitais	hauptstädte
minnesota	minnesota
leme	ruder
formatos	formate
aceitação	akzeptanz
evans	evans
bandeiras	flaggen
pegar	abholen
túmulo	grab
leonor	eleonore
graham	graham
publicar	veröffentlichen
imigração	einwanderung
celso	celso
maurice	maurice
controvérsia	kontroverse
roman	roman
coloração	färbung
semelhança	ähnlichkeit
expressa	ausgedrückt
map	map
ava	ava
irlandês	irisch
saiba	erfahre
sonda	sonde
guatemala	guatemala
kent	kent
pleno	volle
ofensiva	offensive
mancha	fleck
quartel	kaserne
mamíferos	säugetiere
fracasso	scheitern
solos	böden
got	got
códigos	codes
thompson	thompson
cidadania	bürgerschaft
acompanhar	begleiten
citados	zitiert
distribuído	verteilt
wolf	wolf
variam	variieren
danilo	danilo
tópicos	themen
rotação	rotation
perfeitamente	tadellos
destruída	zerstört
ciclone	zyklon
magno	magnus
terrenos	grundstücke
our	our
mandatos	mandate
júri	jury
lançamentos	releases
roque	roque
giuseppe	giuseppe
palestina	palästina
taiwan	taiwan
sara	sara
aldeias	dörfer
choque	schock
restrições	einschränkungen
neil	neil
desfile	parade
noronha	noronha
cândido	cândido
pesos	gewichte
douro	douro
fischer	fischer
evil	evil
premiado	preisgekrönte
igualdade	gleichheit
rubens	rubens
visitar	besuchen
they	they
run	run
reno	rhein
oposto	gegenteil
edit	edit
primário	primären
valley	valley
traduções	übersetzungen
neo	neo
defensores	befürworter
heitor	hektor
parabéns	glückwunsch
gases	gase
mecanismos	mechanismen
eleitores	wähler
apartamento	wohnung
august	august
bizantinos	byzantiner
qualificação	qualifikation
luke	luke
deep	deep
robinson	robinson
pátio	hof
western	western
culpa	schuld
holmes	holmes
zool	zool
kurt	kurt
emancipação	emanzipation
mina	mine
pietro	pietro
circunstâncias	umstände
xxi	xxi
abastecimento	versorgung
derrotas	niederlagen
tanque	tank
tito	tito
museus	museen
ferido	verletzt
ferido	verwundet
dallas	dallas
plástico	kunststoff
malásia	malaysia
fort	fort
cargas	lasten
diretores	direktoren
diretores	regisseure
susan	susan
cerâmica	keramik
cinematografia	kinematographie
idéias	ideen
manifestação	demonstration
pianista	pianist
melbourne	melbourne
edwards	edwards
prof	prof
melhorias	verbesserungen
java	java
eficiência	effizienz
rebelde	rebell
proibido	verboten
grace	grace
arizona	arizona
charlotte	charlotte
mito	mythos
deseja	wünscht
uhf	uhf
avó	großmutter
usava	trug
consulta	konsultation
análises	analysen
call	call
dramática	dramatisch
filmado	gefilmt
segmentos	segmente
elias	elias
soberano	souverän
soberano	souveränen
which	which
judeu	jude
bruxelas	brüssel
alimento	nahrung
elétrons	elektronen
observatório	beobachtungsstelle
esboços	skizzen
regresso	rückkehr
cana	zuckerrohr
emma	emma
cinquenta	fünfzig
couto	couto
estética	ästhetik
centre	centre
augusta	augusta
multi	multi
massas	massen
marta	marta
botanical	botanical
compôs	komponierte
lorenzo	lorenzo
lúcia	lucia
gustav	gustav
horta	horta
utilizou	verwendete
madrugada	morgengrauen
amostra	stichprobe
cbs	cbs
medalhista	goldmedaillengewinner
correr	laufen
georges	georges
empregado	angestellter
keith	keith
funk	funk
ronald	ronald
estabilidade	stabilität
guitar	guitar
escultor	bildhauer
horizontal	horizontale
magic	magic
sensação	gefühl
sensação	empfindung
samurai	samurai
ron	ron
espectro	spektrum
catalunha	katalonien
puro	rein
lloyd	lloyd
currículo	lebenslauf
warren	warren
between	between
cuidados	pflege
barras	stäbe
dispõe	verfügt
slam	slam
núcleos	kerne
arsenal	arsenal
antigamente	früher
turcos	türken
farol	leuchtturm
conselhos	ratschläge
bombas	pumpen
equipas	teams
debates	debatten
acusação	anklage
misericórdia	gnade
misericórdia	barmherzigkeit
guiana	guyana
make	make
esquadrão	geschwader
registo	registrierung
piratas	piraten
kids	kids
corredor	flur
kingdom	kingdom
vizinho	nachbar
vestígios	spuren
sandra	sandra
clipes	clips
tanques	panzer
ideologia	ideologie
arnold	arnold
urss	udssr
reconhecer	erkennen
imposto	steuer
prazer	vergnügen
rené	rené
intelectuais	intellektuellen
caridade	nächstenliebe
carvão	kohle
presa	beute
noites	nächte
departamentos	departements
amaro	amaro
barcos	boote
arredores	umgebung
malta	malta
raymond	raymond
dublagem	überspielen
hunter	hunter
forest	forest
episcopal	episcopal
premier	premier
justo	fair
anéis	ringe
humberto	humberto
átomos	atome
vanessa	vanessa
comunistas	kommunisten
joan	joan
absurdo	absurd
frankfurt	frankfurt
lara	lara
inovação	innovation
nbc	nbc
montana	montana
felicidade	glück
performances	aufführungen
triunfo	triumph
telescópio	teleskop
norman	norman
caverna	höhle
promessa	versprechen
liverpool	liverpool
alternativas	alternativen
dourado	goldenen
bebê	baby
harold	harold
comparado	verglichen
portos	häfen
minuto	minute
edge	edge
noiva	braut
emi	emi
spin	spin
proximidade	nähe
inserir	einfügen
car	car
wii	wii
its	its
percepção	wahrnehmung
loire	loire
nov	nov
frequentes	häufig
cinza	grau
corrêa	corrêa
phoenix	phoenix
muralha	mauer
mercedes	mercedes
sargento	sergeant
rachel	rachel
renovação	erneuerung
manchete	schlagzeile
fragmentos	fragmente
exclusivo	exklusiv
geometria	geometrie
telecomunicações	telekommunikation
eficaz	wirkungsvoll
sweet	sweet
hopkins	hopkins
prestígio	prestige
governadores	gouverneure
coletivo	kollektiv
centímetros	zentimeter
leipzig	leipzig
say	say
fenômenos	phänomene
líbia	libyen
issn	issn
confrontos	auseinandersetzungen
criaturas	geschöpfe
euro	euro
colapso	zusammenbruch
parágrafo	absatz
marx	marx
matheus	matheus
pátria	vaterland
tigre	tiger
pescoço	hals
competir	konkurrieren
operar	operieren
semestre	halbjahr
temática	thematische
derivados	derivate
oficina	werkstatt
estêvão	stephan
dinamarquês	dänisch
invenção	erfindung
almas	seelen
timor	timor
hebraico	hebräisch
jurisdição	gerichtsbarkeit
adolfo	adolfo
bactérias	bakterium
progressivo	progressiv
requer	erfordert
alfa	alfa
tentaram	versuchten
reeleito	wiedergewählt
verso	rückseite
harrison	harrison
were	were
potências	mächte
toque	note
toque	tippe
subiu	stieg
turner	turner
cds	cds
mountain	mountain
bombeiros	feuerwehren
observado	beobachtet
pertencem	gehören
pecuária	viehzucht
hills	hills
absoluto	absolute
money	money
crenças	überzeugungen
viseu	viseu
moreno	moreno
compreender	verstehen
lobos	wölfe
denis	denis
airlines	airlines
sobrevivência	überleben
acidentes	unfälle
silvio	silvio
continha	enthielt
paço	paço
parentes	verwandte
verificabilidade	überprüfbarkeit
butterflies	butterflies
aparecida	aparecida
bush	bush
sociologia	soziologie
gótico	gothic
quadrado	quadrat
rodríguez	rodríguez
renânia	rheinland
sin	sin
coragem	mut
medeiros	medeiros
vantagens	vorteile
participado	teilgenommen
eyes	eyes
ilegal	illegal
vítor	vítor
sugeriu	vorgeschlagen
intenso	intensiv
ferrari	ferrari
peixoto	peixoto
gerando	generierung
espelho	spiegel
maracanã	maracanã
expandir	erweitern
fritz	fritz
area	area
allan	allan
boeing	boeing
opa	hoppla
bourbon	bourbon
hardy	hardy
angelo	angelo
sudão	sudan
verbo	verb
móvel	beweglich
abraço	umarmung
vestido	kleid
barragem	damm
informar	informieren
jefferson	jefferson
identificado	identifiziert
bastos	bastos
delegação	delegation
michelle	michelle
simmons	simmons
jstor	jstor
precipitação	niederschlag
khan	khan
produzindo	produzieren
corda	seil
coligação	koalition
ritual	ritual
luna	luna
procurou	suchte
teto	decke
cozinha	küche
mariano	mariano
delgada	delgada
gaspar	gaspar
comer	essen
mísseis	raketen
dívida	schulden
field	field
raças	rassen
albânia	albanien
second	second
quebec	quebec
luigi	luigi
navarra	navarra
amar	lieben
tricolor	tricolor
infecção	infektion
aparelhos	geräte
ideais	ideale
vizinha	nachbarin
águia	adler
antioquia	antiochia
than	than
move	bewegt
soberania	souveränität
biografias	biografien
oklahoma	oklahoma
main	main
naturalidade	natürlichkeit
kentucky	kentucky
negativo	negativ
protestantes	protestanten
inês	agnes
bonita	hübsch
úteis	nützliche
navegador	browser
vaz	vaz
petersburgo	petersburg
remo	remo
iowa	iowa
silver	silver
heaven	heaven
ralph	ralph
responde	antworte
georg	georg
fixo	festen
penas	federn
gardens	gardens
info	info
faro	faro
chipre	zypern
falcão	falken
capturar	erfassen
santarém	santarém
inseto	insekt
expectativa	vorfreude
sultão	sultan
financiamento	finanzierung
protesto	protest
feat	feat
pecado	sünde
craig	craig
fugiu	geflohen
drive	drive
burocratas	bürokraten
wellington	wellington
geográfico	geografischen
full	full
roberts	roberts
pato	ente
concreto	konkreten
ama	liebt
protegido	geschützt
prefixo	präfix
institucional	institutionellen
lendas	legenden
emmy	emmy
prato	teller
reportagem	reportage
difusão	verbreitung
pas	pas
psd	psd
tributo	tribut
medicamentos	arzneimittel
fraco	schwach
dezesseis	sechzehn
bull	bull
salário	gehalt
rodolfo	rodolfo
wallace	wallace
cole	cole
comandos	befehle
recomendação	empfehlung
conspiração	verschwörung
antero	antero
justificar	rechtfertigen
carol	carol
gilbert	gilbert
jake	jake
concorrentes	wettbewerber
bibliotecas	bibliotheken
aníbal	aníbal
detalhe	detail
triste	traurig
doente	krank
aveiro	aveiro
happy	happy
radar	radar
representações	vertretungen
saboia	savoyen
pacto	pakt
escândalo	skandal
rivais	rivalen
lyon	lyon
jessica	jessica
absolutamente	absolut
pacheco	pacheco
tragédia	tragödie
tyler	tyler
brandão	brandão
suspeita	verdacht
diabo	teufel
golpes	schläge
vela	segeln
müller	müller
alexandra	alexandra
hal	hal
feiras	messen
alessandro	alessandro
equações	gleichungen
myspace	myspace
bruto	brutto
lorde	lord
fernández	fernández
linguística	sprachlichen
wikis	wikis
johns	johns
tiros	schüsse
etiópia	äthiopien
dependência	abhängigkeit
compor	komponieren
figueira	garmisch
public	public
adelaide	adelaide
resolvido	gelöst
lane	lane
teodoro	theodor
guarnição	garnison
markku	markku
roland	roland
especializado	spezialisiert
dano	schaden
hesse	hessen
console	konsole
barreira	barriere
protestante	protestantischen
mineral	mineral
concedeu	bewilligte
mind	mind
líbano	libanon
pete	pete
algarve	algarve
sólido	solide
magnético	magnetische
gigantes	riesen
ameaças	bedrohungen
mercadorias	waren
comemoração	feier
precisava	brauchte
índices	indizes
prevenção	prävention
melodia	melodie
junius	junius
pesquisador	forscher
manuscrito	manuskript
boi	bull
württemberg	württemberg
masters	masters
separar	trennen
incapaz	unfähig
interessados	interessiert
deficiência	behinderung
kew	kew
work	work
collins	collins
hospitais	krankenhäuser
tomado	genommen
maomé	mohammed
surgem	entstehen
removido	entfernt
painel	panel
armadura	rüstung
adquirido	erworben
recomendações	empfehlungen
garantia	garantie
greatest	greatest
luxo	luxus
phillips	phillips
boxe	boxen
esculturas	skulpturen
born	born
savela	savela
aurora	aurora
mitchell	mitchell
poço	brunnen
made	made
subdivisões	unterteilungen
claudio	claudio
haveria	gäbe
patrocínio	sponsoring
saxônia	sachsen
setúbal	setúbal
detroit	detroit
hardware	hardware
ouvido	gehört
perdas	verluste
lesões	verletzungen
nervoso	nervös
han	han
soviéticos	sowjets
febre	fieber
adoção	annahme
ltd	ltd
hudson	hudson
maratona	marathon
elvis	elvis
cobra	schlange
monges	mönche
andamento	gange
socialismo	sozialismus
june	june
ice	ice
honorário	ehrenhalber
cine	cine
fotógrafo	fotograf
ruth	ruth
jesse	jesse
romântico	romantisch
gramática	grammatik
tendem	neigen
acer	acer
yes	yes
riscos	risiken
trocar	tauschen
nilo	nil
atribuição	zuteilung
atribuição	namensnennung
ted	ted
hart	hart
mensal	monatlich
virada	wende
favorito	lieblings
veloso	veloso
martín	martín
circo	zirkus
selecionado	ausgewählt
wall	wall
irene	irene
bebidas	getränke
caçador	jäger
monge	mönch
naruto	naruto
atacado	angegriffen
trigo	weizen
vocals	vocals
murphy	murphy
ante	ante
cenários	szenarien
pacote	paket
silêncio	schweigen
nicholas	nicholas
kenneth	kenneth
buraco	loch
nono	neunten
principado	fürstentum
helen	helen
sentiu	spürte
madame	madame
ernest	ernest
voltas	runden
cap	cap
funcional	funktionale
amadores	amateure
jogado	gespielt
pérez	pérez
next	next
conferir	verleihen
montevidéu	montevideo
bico	schnabel
agências	agenturen
margaret	margaret
adolf	adolf
jam	jam
seattle	seattle
aaron	aaron
cruzada	kreuzzug
preparado	vorbereitet
bass	bass
receitas	rezepte
receitas	einnahmen
devil	devil
pioneiros	pioniere
moisés	moses
formações	formationen
atlantic	atlantic
exportação	export
exportação	ausfuhr
simpson	simpson
forever	forever
cratera	krater
hábito	gewohnheit
duff	duff
detetive	detektiv
lagoas	teiche
frederick	frederick
milan	milan
cumprimento	einhaltung
sacramento	sacramento
avançado	erweitert
póvoa	póvoa
interpretações	interpretationen
rotas	routen
inéditas	unveröffentlichte
joinville	joinville
resende	resende
islândia	island
perna	bein
haiti	haiti
mágica	magische
macmillan	macmillan
oitavas	oktaven
queriam	wollten
obs	obs
seul	seoul
repressão	repression
repressão	unterdrückung
trek	trek
folk	folk
einstein	einstein
stade	stade
pimenta	pfeffer
quarteto	quartett
adicionado	hinzugefügt
comandou	befehligte
discovery	discovery
alpha	alpha
chelsea	chelsea
ofício	fertigkeit
irregular	unregelmäßig
uniformes	uniformen
fábricas	fabriken
norueguês	norwegisch
teen	jugendlich
compacto	kompakt
hermann	hermann
sérvio	thailändische
dilma	dilma
lacerda	lacerda
possuíam	besaßen
aquitânia	aquitanien
porquê	warum
claudia	claudia
tendências	tendenzen
bang	bang
relativo	relativ
relativo	relative
julie	julie
pilares	säulen
office	office
designer	designer
chuck	chuck
devidamente	ordnungsgemäß
investigar	untersuchen
senadores	senatoren
voar	fliegen
doação	spende
dieta	diät
mercury	mercury
ninja	ninja
gabriela	gabriela
match	match
logística	logistik
bósnia	bosnien
atrair	anzuziehen
diplomata	diplomat
depósitos	einlagen
ataca	greift
juventus	juventus
túnel	tunnel
salomão	salomo
mármore	marmor
mortais	tödlichen
lituânia	litauen
dezoito	achtzehn
fazendas	farmen
terço	drittel
child	child
advogados	rechtsanwälte
palatinado	pfalz
simone	simone
elena	elena
competência	zuständigkeit
competência	kompetenz
talentos	talente
júlia	julia
traduzir	übersetzen
grey	grey
igor	igor
agrostis	agrostis
noel	noel
bizantina	byzantinische
cúpula	kuppel
cruzamento	kreuzung
camilo	camilo
sorocaba	pratteln
sono	schlaf
spears	spears
hughes	hughes
sts	sts
algodão	baumwolle
narrador	erzähler
aprovou	billigte
alabama	alabama
lucro	gewinn
cama	bett
nona	neunte
beat	beat
criatura	kreatur
terapia	therapie
betty	betty
desafios	herausforderungen
sri	sri
abel	abel
provisório	vorläufigen
diesel	diesel
htm	htm
cameron	cameron
treinar	trainieren
determina	bestimmt
cartoon	cartoon
aurélio	aurelius
inscrições	aufdruck
most	most
filmografia	filmografie
alejandro	alejandro
cerveja	bier
bravo	bravo
orchid	orchid
italia	italia
pes	pes
aposentadoria	ruhestand
wisconsin	wisconsin
padroeiro	schutzpatron
guadalajara	guadalajara
ref	ref
campina	campina
cleveland	cleveland
inventor	erfinder
manifesto	manifest
lapa	lapa
originou	entstand
manuscritos	manuskripte
manuscritos	handschriftlich
republic	republic
aquecimento	heizung
friends	friends
severi	severi
demônio	dämon
traição	verrat
fictício	fiktiven
combinado	kombiniert
holstein	holstein
nomeados	nominiert
diploma	diplom
livraria	buchhandlung
projeção	projektion
meridiano	meridian
catherine	catherine
excelência	exzellenz
gazeta	gazette
derivada	ableitung
ódio	hass
paramount	paramount
deslocamento	verschiebung
léo	léo
turim	turin
nancy	nancy
incrível	unglaublich
porcentagem	prozentsatz
aquático	aquatische
almada	almada
chocolate	schokolade
edson	edson
ródano	rhône
acompanhou	begleitete
balada	ballade
too	too
falada	gesprochene
terminais	terminals
schmidt	schmidt
minho	minho
fechar	schließen
sindicato	gewerkschaft
jurista	jurist
apollo	apollo
morris	morris
beautiful	beautiful
lunar	lunar
rito	ritus
oferecido	angeboten
another	another
urso	bär
chá	tee
reynolds	reynolds
curiosidade	neugier
piscina	pool
andreas	andreas
chapéu	hut
moto	motorrad
procurador	staatsanwalt
pega	nimm
flauta	flöte
circuitos	schaltungen
esqui	skifahren
punição	strafe
nomenclatura	nomenklatur
trilogia	trilogie
jenkins	jenkins
gibson	gibson
enrique	enrique
bater	schlagen
caos	chaos
lins	lins
influente	einflussreichen
colo	schoß
partindo	ausgehend
extração	extraktion
varsóvia	warschau
through	through
galvão	galvão
lance	lance
script	skript
cairo	kairo
antoine	antoine
estágios	praktika
various	various
proteína	protein
swift	swift
leslie	leslie
nuvens	wolken
distâncias	entfernungen
correção	korrektur
processador	prozessor
semanal	wöchentliche
semanal	wöchentlich
ávila	ávila
petrópolis	petrópolis
bach	bach
economista	ökonom
sega	sega
cola	cola
proibição	verbot
sobreviveu	überlebte
emily	emily
coordenador	koordinator
timber	timber
without	without
obrigatório	obligatorisch
preservar	bewahren
preservar	konservieren
cook	cook
henriques	henriques
entregar	abzugeben
equipado	ausgestattet
sódio	natrium
caixas	kisten
contínuo	kontinuierlichen
early	early
early	frühe
permaneceram	blieben
explicou	erklärte
impulso	impuls
randy	randy
bebida	getränk
máscara	maske
dublin	dublin
unir	vereinen
protagonistas	protagonisten
mineração	bergbau
random	random
ten	ten
shadow	shadow
fatal	tödlich
marcel	marcel
phylogenetics	phylogenetics
agr	agr
vilões	bösewichte
obrigada	danke
essência	wesen
maryland	maryland
lealdade	loyalität
exemplar	exemplar
concorrência	wettbewerb
lava	lava
exclusão	ausschluss
leiria	leiria
hardcore	hardcore
five	five
armado	bewaffnet
valle	valle
alba	alba
feijão	bohnen
eletricidade	strom
mason	mason
alonso	alonso
ira	ira
obrigação	pflicht
obrigação	verpflichtung
reconheceu	erkannte
contratos	verträge
future	future
vira	dreh
kane	kane
destaques	highlights
express	express
rosas	rosen
polar	polar
fenton	fenton
bateu	schlug
convencer	überzeugen
budismo	buddhismus
antropologia	anthropologie
nicole	nicole
arnaldo	arnaldo
kiev	kiew
vancouver	vancouver
meneses	meneses
plural	plural
powell	powell
teólogo	theologe
painéis	panels
bueno	bueno
estuda	studiert
miles	miles
cresce	wächst
correspondência	korrespondenz
istambul	istanbul
orientado	orientiert
need	need
filadélfia	philadelphia
sessenta	sechzig
folclore	folklore
conus	conus
francisca	franziska
antunes	antunes
patricia	patricia
colombo	colombo
tracy	tracy
rituais	rituale
manhattan	manhattan
chan	chan
louise	louise
estátuas	statuen
amanda	amanda
guardas	wachen
beijo	kuss
tubo	rohr
finlandês	finnisch
vulcão	vulkan
álvares	álvares
hemisfério	hemisphäre
dramaturgo	dramatiker
consideravelmente	beträchtlich
gravidez	schwangerschaft
bayer	bayer
boletim	bulletin
philippe	philippe
beisebol	baseball
pastoral	pastoralen
neutro	neutral
promove	fördert
maceió	maceió
acústica	akustik
nathan	nathan
paiva	paiva
stand	stand
sinfonia	symphonie
paolo	paolo
uberlândia	uberlândia
christina	christina
barroso	barroso
radicais	radikale
estimativa	schätzung
intenções	absichten
bowl	bowl
generais	generäle
dog	dog
restaurar	wiederherstellen
marfim	elfenbein
palmas	palmas
protótipo	prototyp
continentes	kontinente
carregar	laden
anton	anton
rain	rain
acompanha	begleitet
qualidades	qualitäten
ultra	ultra
ghost	ghost
superar	überwinden
jin	jin
severo	streng
rondônia	rondônia
lento	langsam
missionários	missionare
adriana	adriana
alumínio	aluminium
alentejo	alentejo
quebrar	brechen
ligas	legierungen
karen	karen
rex	rex
pontas	spitzen
inspirou	inspirierte
governantes	herrscher
soyuz	sojus
mundos	welten
havaí	hawaii
been	been
hope	hope
gota	gicht
ilustrações	illustrationen
fibras	fasern
duelo	duell
demissão	rücktritt
nativo	native
sintra	sintra
coleções	sammlungen
pontifícia	päpstliche
goa	goa
nina	nina
lang	lang
blanco	blanco
daily	daily
escravidão	sklaverei
madison	madison
mutantes	mutanten
azerbaijão	aserbaidschan
clero	klerus
orgulho	stolz
houten	houten
consegui	geschafft
operado	operiert
chagas	chagas
membrana	membran
quadra	quadra
zeus	zeus
todd	todd
poluição	verschmutzung
nazaré	nazareth
citações	zitate
nassau	nassau
ditador	diktator
romero	romero
nacionalista	nationalistischen
camp	camp
cadeiras	stühle
juliana	juliana
rogers	rogers
cuiabá	balsthal
olga	olga
marrom	braun
isolamento	isolierung
amostras	proben
harvey	harvey
passeio	fahrt
búlgaro	bulgarisch
emerson	emerson
palestra	vortrag
velocidades	geschwindigkeiten
third	third
panorama	panorama
omar	omar
cry	cry
deportivo	deportivo
olha	schau
pago	bezahlt
queijo	käse
rpg	rpg
colin	colin
gaga	gaga
chanceler	kanzler
lucy	lucy
ain	ain
ídolo	idol
migração	migration
bate	schlägt
levantar	aufstehen
grade	grade
bit	bit
validade	gültigkeit
retratos	abbildungen
pat	pat
glenn	glenn
acústico	akustische
envolver	einzubeziehen
simões	simões
destinos	reiseziele
pânico	panik
paciência	geduld
brad	brad
intercontinental	intercontinental
consumidores	verbraucher
depósito	anzahlung
depósito	einzahlung
electric	electric
claire	claire
supervisão	aufsicht
enfrenta	gesichter
prisioneiro	gefangener
juliano	julien
copacabana	copacabana
oregon	oregon
certificação	zertifizierung
tubarão	hai
macaco	affe
escritórios	büros
sabedoria	weisheit
adotar	adoptieren
cribb	cribb
paulinho	paulinho
heroes	heroes
funeral	beerdigung
medina	medina
desapareceu	verschwunden
obama	obama
midi	midi
weekly	weekly
honda	honda
drake	drake
bartolomeu	bartholomäus
batizado	getauft
renault	renault
canhão	kanone
utah	utah
rca	rca
ptb	ptb
mayer	mayer
hábitos	gewohnheiten
lembro	erinnere
brilho	helligkeit
experiente	erfahrene
crazy	crazy
living	living
heavyweight	heavyweight
temporal	zeitliche
auxiliares	hilfskräfte
sidney	sidney
beto	beto
arqueologia	archäologie
martínez	martínez
jeremy	jeremy
botanic	botanic
