joey	joey
repetir	wiederholen
mississippi	mississippi
ginasta	turnerin
erik	erik
roubar	stehlen
cícero	cicero
blake	blake
sullivan	sullivan
daniela	daniela
estratégias	strategien
terrível	schrecklich
dueto	duett
ellen	ellen
estádios	stadien
convencional	konventionellen
conferências	konferenzen
yang	yang
tanzânia	tansania
votou	stimmte
before	before
mozart	mozart
sequências	sequenzen
ferdinand	ferdinand
espectral	spektrale
brooklyn	brooklyn
apelo	appell
brinquedos	spielzeug
flandres	flandern
palestras	vorträge
southern	southern
alcântara	alcantara
kyle	kyle
brincadeira	witz
disciplinas	disziplinen
brother	brother
bonaparte	bonaparte
especialização	spezialisierung
bates	bates
aeroportos	flughäfen
kings	kings
lopez	lopez
tna	tna
classificar	sortieren
short	short
dante	dante
porco	schwein
ramal	ramal
mecânico	mechaniker
gregory	gregory
laser	laser
declarações	erklärungen
regulamento	verordnung
senna	senna
jamie	jamie
still	still
mortalidade	mortalität
bella	bella
tejo	tejo
med	med
owen	owen
fausto	fausto
dunning	dunning
inserido	eingefügt
salgado	gesalzen
cannes	cannes
sánchez	sánchez
layout	layout
berkeley	berkeley
julgar	beurteilen
trabalhista	labour
liechtenstein	liechtenstein
gloria	gloria
poaceae	poaceae
despesas	ausgaben
aleixo	aleixo
variar	variieren
gaia	gaia
pseudo	pseudo
hugh	hugh
liberado	freigegeben
sustentável	nachhaltig
sustentável	nachhaltige
presbiteriana	presbyterianischen
luanda	luanda
break	break
numeração	nummerierung
paisagens	landschaften
fao	fao
agregado	aggregierten
criminosos	kriminelle
envia	sendet
croata	kroatisch
storm	storm
cardeais	kardinäle
ward	ward
photo	photo
demitido	entlassen
expressar	ausdrücken
vinil	vinyl
greve	streik
profeta	prophet
monumental	monumental
geographic	geographic
beyoncé	beyoncé
cunhado	schwager
oswaldo	oswaldo
reflete	reflektiert
reflete	spiegelt
nfl	nfl
emoções	emotionen
rebaixado	degradiert
vales	täler
confirmar	bestätigen
velas	kerzen
evangélica	evangelische
act	act
reforço	stärkung
teresina	teresina
dylan	dylan
ibm	ibm
pirata	pirat
rato	maus
luzes	leuchten
luzes	lichter
raiva	zorn
nomeações	ernennungen
mediawiki	mediawiki
arms	arms
gran	gran
corporação	corporation
antena	antenne
refugiados	flüchtlinge
cancelado	abgesagt
cancelado	abgebrochen
cordeiro	lamm
selva	dschungel
invasões	invasionen
quartos	zimmer
nickelodeon	nickelodeon
poética	poetische
unificação	vereinigung
adesão	beitritt
osaka	osaka
avisar	warnen
roraima	roraima
renúncia	verzicht
parma	parma
acessível	zugänglich
turbo	turbo
saltos	fersen
simpsons	simpsons
amorim	amorim
vasos	töpfe
birdlife	birdlife
algas	algen
dakota	dakota
neta	enkelin
patos	enten
páscoa	ostern
fado	fado
wolfgang	wolfgang
nariz	nase
restrito	eingeschränkt
razoável	angemessenen
salários	löhne
denominações	bezeichnungen
autobiografia	autobiografie
dell	dell
separa	trennt
capitalismo	kapitalismus
northern	northern
jamaica	jamaika
devoção	hingabe
martha	martha
ashley	ashley
honduras	honduras
had	had
visões	visionen
catorze	vierzehn
ram	ram
oficinas	werkstätten
praticar	üben
salazar	salazar
cantos	ecken
funchal	funchal
bonifácio	bonifacio
morning	morning
advento	aufkommen
expulsão	ausweisung
march	march
mad	mad
oswald	oswald
jantar	abendessen
dawn	dawn
dinossauros	dinosaurier
candidata	kandidatin
sacrifício	opfer
creta	kreta
gear	gear
prosa	prosa
abade	abt
pour	pour
today	today
luiza	jule
pos	pos
louco	verrückt
sevilha	sevilla
eslováquia	slowakei
disseram	sagten
modificado	geändert
smackdown	smackdown
câmeras	kameras
wta	wta
javier	javier
anuncia	kündigt
nielsen	nielsen
hulk	hulk
comediante	komiker
redirecionamento	umleitung
tons	töne
auditório	auditorium
definiu	definierte
exigência	anforderung
emocional	emotionale
rudolf	rudolf
limited	limited
secretária	schreibtisch
emanuel	emanuel
budapeste	budapest
six	six
nature	nature
extenso	umfangreiche
pardo	pardo
artesanato	handwerk
justice	justice
brás	brás
arruda	arruda
hello	hello
couro	leder
gone	gone
give	give
controla	kontrolliert
adrian	adrian
diamante	diamant
homer	homer
mrs	mrs
sofrimento	leiden
refúgio	zuflucht
fabricado	hergestellt
luzia	luzia
sandy	sandy
mercúrio	quecksilber
anarquista	anarchist
spirit	spirit
edu	edu
rev	rev
telespectadores	zuschauer
orchard	orchard
modernização	modernisierung
grafo	graph
heather	heather
adaptações	anpassungen
lombardia	lombardei
cometa	komet
segredos	geheimnisse
camponeses	bauern
resíduos	abfälle
átomo	atom
cancelada	abgebrochen
chamas	flammen
farinha	mehl
logotipo	logo
nord	nord
elogiou	lobte
vaidade	eitelkeit
grávida	schwanger
anarquistas	anarchisten
jeová	jehova
biológica	biologische
price	price
cascais	cascais
soprano	soprano
rider	rider
jules	jules
bennett	bennett
schleswig	schleswig
córdoba	córdoba
lido	gelesen
look	look
geologia	geologie
iniciativas	initiativen
apostólica	apostolische
divórcio	scheidung
deh	deh
ramón	ramón
pearl	pearl
steel	steel
connecticut	connecticut
ingrid	ingrid
tradutor	übersetzer
virar	umdrehen
falência	bankrott
comportamentos	verhaltensweisen
wang	wang
gómez	gómez
tales	tales
aborto	abtreibung
calma	ruhig
escravo	sklave
crystal	crystal
colónia	köln
emília	emilia
exercícios	übungen
blogs	blogs
sinônimo	synonym
divindade	gottheit
curtis	curtis
percy	percy
umidade	feuchtigkeit
boris	boris
mira	mira
refrão	refrain
thing	thing
reggae	reggae
andrés	andrés
prático	praktisch
article	article
earl	earl
indie	indie
paróquias	pfarreien
conservatório	konservatorium
palmeira	palme
padroeira	schutzpatronin
bruxa	hexe
paga	zahlt
cristais	kristalle
around	around
disponibilidade	verfügbarkeit
ligar	verbinden
ligar	anrufen
dutra	dutra
meyer	meyer
alasca	alaska
angels	angels
henderson	henderson
absorção	absorption
absorção	resorption
hannah	hannah
ceder	nachgeben
trees	trees
laboratórios	laboratorien
aristóteles	aristoteles
alain	alain
patrulha	patrouille
solidariedade	solidarität
decadência	verfall
teórico	theoretischen
francos	francs
francos	franken
mickey	mickey
sensibilidade	empfindlichkeit
mao	mao
declarada	deklariert
politicamente	politisch
anatomia	anatomie
raros	selten
braz	braz
batismo	taufe
capturados	gefangen
paródia	parodie
inútil	nutzlos
coco	coco
telas	bildschirme
pensamentos	gedanken
confiável	zuverlässig
underground	underground
ceo	ceo
ácidos	säuren
remake	remake
muros	mauern
fictícia	fiktive
rich	rich
plata	plata
roosevelt	roosevelt
pimentel	pimentel
irmandade	bruderschaft
ausente	abwesend
ativista	aktivist
lama	schlamm
judaísmo	judentum
sistemática	systematisch
sistemática	systematische
relatórios	berichte
buarque	buarque
ovo	ei
definições	begriffsbestimmungen
diretório	verzeichnis
bissau	bissau
goulart	goulart
derek	derek
licenciado	lizenziert
licenciado	lizenznehmer
dragões	drachen
laguna	laguna
palazzo	palazzo
ranger	ranger
suplente	stellvertreter
angela	angela
turing	turing
schltr	schltr
orleans	orleans
duncan	duncan
ciclos	zyklen
escape	auspuff
stefan	stefan
dreams	dreams
pompeu	pompejus
gerado	erzeugt
manipulação	manipulation
clarke	clarke
casamentos	hochzeiten
foster	foster
princeton	princeton
deva	deva
usavam	trugen
círculos	kreise
conduzir	führen
agenda	agenda
hunt	hunt
french	french
beja	beja
tonight	tonight
kill	kill
republicanos	republikaner
fabio	fabio
hotéis	hotels
borracha	kautschuk
argumentar	argumentieren
sobrinha	nichte
unforgettable	unforgettable
excessivo	übermäßigen
exerce	übt
werner	werner
significando	bedeutend
bart	bart
vampiro	vampir
minoria	minderheit
vênus	venus
catalão	katalanisch
late	late
gramado	rasen
furtado	furtado
bando	bande
gasolina	benzin
portela	portela
ontário	ontario
executivos	führungskräfte
acidentalmente	versehentlich
registos	aufzeichnungen
lons	lons
olinda	olinda
medição	messung
mccartney	mccartney
botelho	botelho
palace	palace
rotten	rotten
prevenir	verhindern
instalar	installieren
restrição	beschränkung
nuvem	wolke
dignidade	würde
testar	testen
cinzas	asche
pacific	pacific
atribui	beimisst
comunismo	kommunismus
medley	medley
estatutos	satzung
diamond	diamond
bolonha	bologna
ace	ace
armstrong	armstrong
current	current
far	far
subcategorias	unterkategorien
recompensa	belohnung
zurique	zürich
guido	guido
gana	ghana
molécula	molekül
mia	mia
reed	reed
assentos	sitze
sino	glocke
preconceito	vorurteil
enterprise	enterprise
criminoso	kriminell
proclamação	proklamation
delgado	delgado
terça	dienstag
pacotes	pakete
cold	cold
carex	hallers
mostraram	zeigten
fly	fly
bienal	biennale
desnecessário	unnötig
pdt	pdt
antologia	anthology
duke	duke
cruzados	gekreuzt
saudade	sehnsucht
idem	idem
educado	höflich
visibilidade	sichtbarkeit
jogaram	spielten
tina	tina
cesar	cesar
amanhã	morgen
sorteio	gewinnspiel
harper	harper
realismo	realismus
hermes	hermes
bolas	bälle
clinton	clinton
kirk	kirk
feriado	feiertag
tunísia	tunesien
duo	duo
saraiva	saraiva
ryu	ryu
caroline	caroline
estelar	stellar
demônios	dämonen
proporções	ausmaßes
unanimidade	einstimmigkeit
receptores	rezeptoren
celebridades	prominente
ruiz	ruiz
maravilha	wunder
estimativas	schätzungen
notação	rating
outrora	einst
informado	informiert
eficácia	wirksamkeit
cavalcanti	cavalcanti
cid	cid
asiáticos	asiaten
beth	beth
tortura	folter
sobral	sobral
casais	paare
belgrado	belgrad
grato	dankbar
desvio	abweichung
vogais	vokale
metacritic	metacritic
amigas	freundinnen
músculos	muskeln
anexos	anhänge
corta	schneidet
selos	briefmarken
ratos	mäuse
ampliar	vergrößern
stanford	stanford
américo	américo
stan	stan
cravo	nelke
handebol	handball
califa	kalif
mediação	vermittlung
ótima	tolle
rgb	rgb
banana	banane
obstáculos	hindernisse
setenta	siebzig
locomotivas	lokomotiven
grãos	körner
desejos	wünsche
expedições	expeditionen
esquecer	vergessen
cálcio	kalzium
lex	lex
motorista	fahrer
pica	pica
uganda	uganda
perigoso	gefährlich
confundir	verwirren
democratas	demokraten
creek	creek
motta	motta
imparcial	unparteiische
filósofos	philosophen
weber	weber
estrutural	strukturelle
jogabilidade	gameplay
goes	goes
eixos	achsen
cage	cage
osvaldo	osvaldo
moscovo	moskau
naturalista	naturforscher
fraude	betrug
minor	minor
luca	luca
cerro	cerro
libertar	befreien
led	led
escalada	klettern
herman	herman
alive	alive
liturgia	liturgie
domésticos	inländische
guardian	guardian
aclamado	gefeierten
astronautas	astronauten
clique	klicken
suspenso	ausgesetzt
juniors	juniors
veterano	veteran
melhora	verbessert
funcionou	funktionierte
systematics	systematics
equatorial	äquatorial
pirâmide	pyramide
julian	julian
cerrado	geballte
eterno	ewige
philips	philips
intel	intel
jardín	jardín
tensões	spannungen
maine	maine
why	why
jackie	jackie
prefiro	lieber
prioridade	priorität
paradise	paradise
litros	liter
aceleração	beschleunigung
traçado	trasse
várzea	várzea
hipóteses	hypothesen
tarzan	tarzan
votaram	stimmten
hércules	herkules
partícula	teilchen
ícone	symbol
wells	wells
ordenação	sortierung
racional	rational
annie	annie
desenhado	gezeichnet
estacionamento	parkplatz
caracas	caracas
nero	nero
core	core
ninho	nest
ensinou	gelehrt
ensinou	lehrte
humanista	humanistische
metodologia	methodik
edimburgo	edinburgh
incorporado	eingebautem
incentivo	anreiz
doentes	patienten
oslo	oslo
pelé	pelé
suporta	unterstützt
territoriais	territorialen
tell	tell
impressionante	beeindruckend
lógico	logisch
atributos	attribute
muhammad	muhammad
slogan	slogan
missionário	missionar
eugene	eugene
traças	motten
militante	militanten
dumont	dumont
tripulantes	besatzungsmitglieder
ucraniano	ukrainisch
gália	gallien
lida	gelesene
intervalos	abständen
plate	plate
marília	marília
saxofone	saxophon
kepler	kepler
speedy	speedy
playoffs	playoffs
díaz	díaz
morrison	morrison
superfícies	oberflächen
aguilera	aguilera
saco	tasche
confirmação	bestätigung
sysop	sysop
privilégios	privilegien
marino	marino
better	better
yuri	juri
challenge	challenge
seda	seide
doações	spenden
consolidação	konsolidierung
jiu	jiu
marinheiros	seeleute
praticado	geübt
linnaeus	linné
fibra	faser
lotus	lotus
mother	mother
ilustração	illustration
gouveia	gouveia
barcelos	barcelos
tinta	tinte
raquel	raquel
dallwitz	dallwitz
ecologia	ökologie
diminui	verringert
stevens	stevens
telhado	dach
arcade	arcade
remixes	remixe
arquitetos	architekten
gatos	katzen
vinícius	vinícius
contabilidade	buchführung
ferraz	ferraz
especialidade	spezialität
wesley	wesley
demografia	demografie
yellow	yellow
violenta	gewaltsame
fundamentos	grundlagen
bayern	bayern
saldo	saldo
comunicar	kommunizieren
facção	fraktion
lennon	lennon
pronúncia	aussprache
terroristas	terroristen
plus	plus
significados	bedeutungen
dormir	schlafen
pay	pay
intervenções	interventionen
usual	üblichen
sancho	sancho
calais	calais
ciudad	ciudad
homepage	homepage
piemonte	piemont
shaw	shaw
rpm	rpm
viaja	reist
britney	britney
sardenha	sardinien
virgin	virgin
bird	bird
ronda	runde
discriminação	diskriminierung
avenidas	alleen
posicionamento	positionierung
silvestre	silvestre
cohen	cohen
pole	pole
paes	paes
comboio	zug
músculo	muskel
transportar	transportieren
espessura	dicke
convertido	umgewandelt
something	something
rigor	strenge
repetição	wiederholung
manto	mantel
verbandsgemeinde	verbandsgemeinde
once	once
edwin	edwin
restaurado	wiederhergestellt
vit	vit
crânio	schädel
fígado	leber
contatos	kontakte
procissão	prozession
tração	traktion
triple	triple
eliminatória	achtelfinale
melissa	melissa
finalistas	finalisten
busto	büste
vogal	vokal
turn	turn
sacra	sacra
peruano	peruanischen
biólogo	biologe
complicações	komplikationen
apocalipse	apokalypse
plaza	plaza
liz	liz
bastidores	backstage
fidelidade	treue
fisiologia	physiologie
preocupado	besorgt
suspeito	verdächtig
woods	woods
pascal	pascal
unida	vereinigt
unida	vereinten
socialistas	sozialisten
cálculos	berechnungen
self	self
semelhanças	ähnlichkeiten
cruel	grausam
ivo	ivo
travessia	überfahrt
alfonso	alfonso
spermatophyta	spermatophyta
decolagem	abheben
levante	levante
boom	boom
primos	cousins
pasta	ordner
candidatas	kandidatinnen
sapo	frosch
escondido	versteckt
ontem	gestern
judas	judas
rivera	rivera
timezone	timezone
portais	portale
resgatar	einlösen
jitsu	jitsu
rise	rise
doces	süßigkeiten
desembarque	anlandung
assentamento	siedlung
pétalas	blütenblätter
nepal	nepal
very	very
spring	spring
alone	alone
herdeira	erbin
heat	heat
casino	kasino
phylogeny	phylogenese
converter	umwandeln
abundante	reichlich
íris	iris
julius	julius
floyd	floyd
quatorze	vierzehn
juniores	junioren
justificação	begründung
willy	willy
valério	valerius
españa	españa
provou	bewies
sonata	sonata
sonoridade	klingende
finalista	finalist
comentar	kommentieren
palmer	palmer
circle	circle
incidência	inzidenz
negado	verweigert
saldanha	saldanha
balanço	bilanz
bauru	rathenow
espadas	schwerter
avós	großeltern
montgomery	montgomery
contribuíram	trugen
malcolm	malcolm
vampiros	vampire
compatível	kompatibel
ouviu	hörte
vega	vega
descrições	beschreibungen
consultar	konsultieren
credibilidade	glaubwürdigkeit
governar	anordnen
raciocínio	argumentation
contorno	umriss
calcular	berechnen
said	said
testemunha	zeuge
interrupção	unterbrechung
banks	banks
crash	crash
obrigações	pflichten
obrigações	verpflichtungen
renata	renata
truth	truth
impact	impact
reinaldo	reinaldo
monroe	monroe
prometeu	versprach
versus	versus
incomum	ungewöhnlich
capelas	kapellen
expectativas	erwartungen
armamento	bewaffnung
bitola	spurweite
extremos	extremen
comissário	kommissar
kenny	kenny
ariel	ariel
cotidiano	alltag
hms	hms
instância	instanz
inflação	inflation
beyond	beyond
referendo	referendum
comprado	gekauft
gêmeos	zwillinge
homossexualidade	homosexualität
pittsburgh	pittsburgh
navarro	navarro
bat	bat
comercialização	vermarktung
puderam	konnten
farmácia	apotheke
integridade	integrität
ángel	ángel
brigadeiro	brigadier
agradável	angenehm
sanção	sanktion
emérito	emeritus
burocrata	bürokrat
motion	motion
fisicamente	körperlich
genera	genera
warriors	warriors
matilde	mathilde
forçar	erzwingen
foot	foot
abs	abs
nicarágua	nicaragua
mentira	lüge
small	small
amália	amalie
cativeiro	gefangenschaft
gênio	genie
galaxy	galaxy
furacões	hurrikane
preocupações	bedenken
diretrizes	richtlinien
violento	gewalttätig
picardia	picardie
ocultar	ausblenden
complicado	kompliziert
ortografia	rechtschreibung
papua	papua
richards	richards
beija	küss
brooks	brooks
criticou	kritisierte
extreme	extreme
metric	metric
manobra	manöver
atrizes	schauspielerinnen
adeus	tschüss
astro	astro
equivalentes	äquivalente
vhf	vhf
pia	pia
maya	maya
oceania	ozeanien
abolição	abschaffung
veneno	gift
complete	complete
conservadores	konservative
vidal	vidal
consistente	konsequent
dee	dee
ulmer	ulmer
montado	montiert
pensou	dachte
consultor	berater
curvas	kurven
rush	rush
bacon	speck
tel	tel
piazza	piazza
utc+	utc+
dedo	finger
prosperidade	wohlstand
fisher	fisher
toyota	toyota
split	split
coritiba	coritiba
burton	burton
train	train
substitui	ersetzt
pombal	pombal
provença	provence
adão	adam
castelos	burgen
vetor	vektor
transmite	überträgt
exigir	erfordern
exigir	verlangen
eusébio	eusebius
mouros	mauren
joelho	knie
conexões	verbindungen
czar	zar
perfect	perfect
portaria	verordnung
urbanização	urbanisierung
isolado	isoliert
atraso	verzögerung
tolerância	toleranz
newman	newman
acreditavam	glaubten
comunhão	kommunion
quest	quest
reabilitação	rehabilitation
manchas	flecken
util	util
mikhail	michail
ídolos	idole
reportagens	reportagen
federico	federico
everything	everything
agricultores	landwirte
saturno	saturn
denise	denise
escada	leiter
cpu	cpu
fiat	fiat
borboleta	schmetterling
indian	indian
emissões	emissionen
algoritmos	algorithmen
coroado	gekrönt
reeleição	wiederwahl
voluntário	freiwilliger
voluntário	freiwillig
diálogos	dialoge
pano	tuch
wwf	wwf
giorgio	giorgio
mascote	maskottchen
judô	judo
leitão	ferkel
fitas	bänder
ritmos	rhythmen
rítmica	rhythmische
justa	gerechte
springs	springs
primitivo	primitiv
comissões	ausschüsse
gala	gala
roxo	lila
lucros	gewinne
correu	lief
camões	camões
duques	herzöge
itálico	kursiv
intermediário	vermittler
moldávia	moldau
beck	beck
pantanal	pantanal
ressurreição	auferstehung
fuzileiros	marines
emitido	ausgestellt
chumbo	blei
germânica	germanischen
anita	anita
skate	skateboard
laurent	laurent
walk	walk
dino	dino
coca	coca
bicicleta	fahrrad
ministra	ministerin
cazaquistão	kasachstan
mitos	mythen
guillermo	guillermo
palácios	paläste
liberty	liberty
mônaco	monaco
terrorista	terrorist
latinos	latinos
trans	trans
garagem	garage
args	args
aldo	aldo
herzegovina	herzegowina
valencia	valencia
tba	tba
maré	flut
pegou	hob
oitenta	achtzig
bois	bois
cooperativa	genossenschaft
critica	kritisiert
freedom	freedom
consórcio	konsortium
caps	caps
low	low
regatas	regatten
vândalos	vandalen
klaus	klaus
maritime	maritime
consciente	bewusst
colisão	kollision
vita	vita
toscana	toskana
imaginação	phantasie
dresden	dresden
simulação	simulation
guerrilha	guerilla
janet	janet
dale	dale
baterias	batterien
picture	picture
kai	kai
roubo	diebstahl
heroína	heroin
bradley	bradley
dose	dosis
renomeado	umbenannt
rotina	routine
ardenas	ardennen
celta	keltischen
jeffrey	jeffrey
pneus	reifen
enzima	enzym
nomear	ernennen
motivação	motivation
fantasmas	geister
nacionalismo	nationalismus
maçonaria	freimaurerei
emilio	emilio
birmingham	birmingham
andes	anden
socks	socks
pérsia	persien
veteranos	veteranen
havana	havanna
pintado	gemalt
ressonância	resonanz
nebraska	nebraska
maldição	fluch
email	email
implementar	implementieren
vaca	kuh
cartago	karthago
produtividade	produktivität
instabilidade	instabilität
vergonha	schande
wanna	wanna
distingue	unterscheidet
dorothy	dorothy
labelo	labellum
novidade	neuheit
observando	beobachten
adoração	anbetung
ortiz	ortiz
perdão	vergebung
exato	genau
audição	anhörung
comparar	vergleichen
copiar	kopieren
peste	pest
étnicos	ethnischen
joy	joy
ffff	ffff
otomanos	osmanen
zeppelin	zeppelin
coburgo	coburg
misteriosa	geheimnisvolle
trazido	gebracht
andrews	andrews
granito	granit
murder	murder
negociar	verhandeln
candomblé	candomblé
doug	doug
coroação	krönung
astronauta	astronaut
mick	mick
demonstrando	demonstrieren
pamplona	pamplona
votantes	abstimmenden
could	could
falls	falls
oceanos	ozeane
barriga	bauch
platão	plato
maximiliano	maximilian
haute	haute
marne	marne
garganta	kehle
blumenau	blumenau
apaixonada	verliebt
word	word
gulbenkian	gulbenkian
salles	salles
burns	burns
conhecia	kannte
superficial	oberflächlich
realista	realistisch
objetiva	objektiv
condutor	treiber
logan	logan
alicia	alicia
calibre	kaliber
faraó	pharao
calçada	bürgersteig
beber	trinken
shin	shin
jacinto	jacinto
cego	blind
guadalupe	guadeloupe
bowie	bowie
salt	salt
relíquias	reliquien
raúl	raúl
guns	guns
óculos	brille
precursor	vorläufer
perspectivas	ausblick
plantações	plantagen
agrupamento	gruppierung
blu	blu
bossa	bossa
prefácio	vorwort
kosovo	kosovo
anônimo	anonym
vocabulário	vokabular
doom	doom
espiritismo	spiritismus
marion	marion
many	many
wide	wide
pelourinho	pranger
fórmulas	formeln
wrestlemania	wrestlemania
escolhe	wählt
cox	cox
araguaia	araguaia
arménia	armenien
khz	khz
belle	belle
botões	knöpfe
toulouse	toulouse
graduado	absolvent
conrad	conrad
cercado	umgeben
klein	klein
dependentes	abhängige
orquídeas	orchideen
fadas	feen
avril	avril
soja	soja
gnu	gnu
beethoven	beethoven
bosco	bosco
monarcas	monarchen
cruzes	kreuze
falhou	fehlgeschlagen
anatólia	anatolien
correa	correa
ash	ash
mendoza	mendoza
mártir	märtyrer
mattos	mattos
senegal	senegal
metrópole	metropole
introduzir	einführen
shane	shane
maciel	maciel
aprendiz	lehrling
sinto	fühle
arkansas	arkansas
luciana	luciana
somália	somalia
perez	perez
blair	blair
telefonia	telefonie
ever	ever
processadores	prozessoren
weimar	weimar
juramento	eid
sucessivas	aufeinanderfolgenden
amazon	amazon
lauro	lauro
cyrus	cyrus
proporcional	proportional
ajudaram	halfen
parcerias	partnerschaften
alfabetização	alphabetisierung
diversão	spaß
vilar	vilar
relatou	berichtete
relatou	berichtet
ciclones	wirbelstürme
riaa	riaa
shawn	shawn
hold	hold
sobreviveram	überlebten
mali	mali
maturidade	reife
lionel	lionel
bertrand	bertrand
blackwell	blackwell
orações	gebete
dependências	abhängigkeiten
ocean	ocean
westminster	westminster
guerrero	guerrero
any	any
chen	chen
jogadora	spielerin
praticantes	praktiker
tampa	deckel
incêndios	brände
mackenzie	mackenzie
moderado	moderaten
portland	portland
puc	puc
subsequente	anschließende
musa	muse
marilyn	marilyn
tocado	berührt
camboja	kambodscha
clay	clay
eclipse	sonnenfinsternis
módulos	module
unix	unix
helmut	helmut
criatividade	kreativität
afeta	beeinflußt
impresso	gedruckt
borba	borba
abrangente	umfassenden
conclusões	schlussfolgerungen
legítimo	legitim
midnight	midnight
traje	kostüm
satisfação	zufriedenheit
tempestades	stürme
guardião	hüter
corvo	krähe
imparcialidade	unparteilichkeit
mobilidade	mobilität
liu	liu
quedas	stürze
plínio	plinius
chip	chip
considerações	erwägungen
rali	rallye
lourdes	lourdes
won	won
filtros	filtern
volkswagen	vw
volkswagen	volkswagen
públio	publius
dai	dai
alteza	hoheit
monica	monica
lou	lou
dominação	herrschaft
dominação	dominanz
vhs	vhs
grove	grove
baleia	wal
athletic	athletic
rendição	kapitulation
tecladista	keyboarder
lois	lois
ronnie	ronnie
idosos	senioren
genéricos	generika
vácuo	vakuum
griffin	griffin
dana	dana
corredores	korridore
glasgow	glasgow
casca	schale
compras	einkaufen
stones	stones
pádua	padua
gerald	gerald
maggie	maggie
rocky	rocky
frances	frances
olivier	olivier
mentor	mentor
ártico	arktis
eve	eve
mate	mate
regulação	regulierung
sophie	sophie
respeitar	respektieren
convenceu	überzeugte
óptica	optische
carrega	lädt
pastores	hirten
raphael	raphael
invisível	unsichtbar
trinidad	trinidad
comunicado	mitgeteilt
comunicado	pressemitteilung
anselmo	anselmo
jump	jump
govaerts	govaerts
sus	sus
che	che
renascença	renaissance
excepção	ausnahme
ego	ego
insistência	beharren
bundesliga	bundesliga
jordânia	jordanien
moniz	moniz
bernardino	bernardino
windsor	windsor
feriados	feiertage
friburgo	freiburg
redondo	rund
holocausto	holocaust
milênio	jahrtausend
sexualidade	sexualität
porter	porter
simpatia	sympathie
mvp	mvp
gwen	gwen
cheiro	geruch
council	council
compressão	kompression
plasma	plasma
submarinos	unterseeboote
fios	garne
donna	donna
yale	yale
cartaz	plakat
revelada	enthüllt
wonder	wonder
sds	sds
alinhamento	ausrichtung
railway	railway
erva	gras
expulsos	vertrieben
álgebra	algebra
diamantes	diamanten
pertenciam	gehörten
nine	nine
sócrates	sokrates
serrano	serrano
think	think
schneider	schneider
kung	kung
nashville	nashville
discute	diskutiert
majestade	majestät
apóstolo	apostel
trailer	trailer
aceitável	annehmbar
berry	berry
android	android
tamanhos	größen
johan	johan
mandioca	maniok
culminou	gipfelte
bangladesh	bangladesch
lynn	lynn
fertilidade	fruchtbarkeit
enzimas	enzyme
plana	flach
propulsão	antrieb
propagação	ausbreitung
ingredientes	zutaten
muçulmano	moslem
subúrbio	vorort
varzim	tiengen
arca	arche
admite	räumt
arbitragem	schiedsverfahren
fixação	festsetzung
balão	ballon
poeira	staub
minerva	minerva
subdivisão	unterteilung
carreiras	karrieren
moldes	schablonen
rebecca	rebecca
protege	schützt
califado	kalifat
gripe	grippe
leopoldina	leopoldine
buda	buddha
susana	susana
argentinos	argentinier
ride	ride
castillo	castillo
sandro	sandro
surpreendente	erstaunlich
osório	osório
draper	draper
reduz	reduziert
infobox	infobox
lâmina	klinge
lil	lil
vértices	eckpunkte
privacidade	privatsphäre
zâmbia	sambia
suzuki	suzuki
seqüência	sequenz
fraternidade	brüderlichkeit
