head	head
harvard	harvard
tomando	tomando
citada	citada
cheio	lleno
ann	ann
orquídea	orquídea
trindade	trinidad
sacro	sacro
probabilidade	probabilidades
probabilidade	probabilidad
volante	volante
engenheiros	ingenieros
suíço	suizo
estivesse	estuviera
évora	évora
bloquear	bloquear
biodiversidade	biodiversidad
contraste	contraste
kiss	kiss
natação	natación
cheia	llena
desporto	deporte
quantidades	cantidades
minissérie	miniserie
utilidade	utilidad
sessões	sesiones
poderão	podrán
templos	templos
polonês	polaco
oitavo	octavo
fair	fair
point	point
passava	pasaba
knight	knight
vendo	vendo
vendo	viendo
vinicius	vinicio
trabalhava	trabajaba
cooper	cooper
chase	chase
celeste	celeste
levam	llevan
bryan	bryan
devemos	debemos
devemos	deberíamos
true	true
modern	modern
walker	walker
clínica	clínica
ossos	huesos
vincent	vincent
review	review
ordenado	ordenado
tantos	tantos
destruído	destruido
mendonça	mendonça
influenciado	influido
influenciado	influenciado
exercer	ejercer
english	english
seguiram	siguieron
prestes	prestes
expressões	expresiones
gonzález	gonzález
protestos	protestas
guerreiros	guerreros
acabam	terminan
acabam	acaban
servidores	servidores
atende	atiende
greg	greg
queiroz	queiroz
mistério	misterio
legado	legado
revolucionário	revolucionario
excesso	exceso
excesso	excedente
ruim	malo
coloquei	coloqué
coloquei	puse
croácia	croacia
variantes	variantes
amy	amy
destro	diestro
modalidades	modalidades
eficiente	eficiente
eficiente	eficaz
hierarquia	jerarquías
hierarquia	jerarquía
demonstrar	demostrar
premiação	premiación
abadia	abbey
abadia	abadía
walt	walt
encontraram	encontraron
complexos	complejos
destacando	destacando
caldas	caldas
spencer	spencer
terry	terry
duma	duma
polêmica	polémica
crescer	crecer
organizou	organizó
mágico	mágico
mágico	mago
protocolo	protocolo
animado	animado
animado	entusiasmados
animado	emocionado
britânicas	británicas
lema	lema
stars	stars
clemente	clemente
localizados	localizados
localizados	situados
localizados	ubicados
germânico	germánico
order	order
ângulo	ángulo
ângulo	angulo
procedimentos	procedimientos
noção	noción
típica	tipica
típica	típica
johannes	johannes
destinada	destinada
vivendo	viviendo
beatles	beatles
murray	murray
famosas	famosas
gonzaga	gonzaga
fantasy	fantasy
tommy	tommy
metais	metales
four	four
abandonado	abandonado
carey	carey
existiam	existían
capita	cápita
obtendo	obteniendo
broadway	broadway
dick	dick
africanos	africanos
testemunhas	testigos
determinação	determinación
falam	hablan
nicolas	nicolas
fighting	fighting
minerais	minerales
dictionary	dictionary
separado	separado
decoração	decoración
secret	secret
herschel	herschel
azuis	azules
diretora	directora
analisar	analizar
moléculas	moléculas
previsão	previsión
previsão	predicción
comentou	comentó
tentam	intentan
acre	acre
oral	oral
carmen	carmen
estimado	estimado
comendador	comendador
modernas	modernas
hab	hab
resolve	soluciona
resolve	resuelve
censura	censura
velhos	viejos
assembléia	asamblea
movido	movido
jersey	jersey
atlântica	atlántica
hell	hell
chineses	chinos
supervisor	supervisor
lançadas	lanzadas
viviam	vivían
colonos	colonos
campbell	campbell
galo	gallo
namorado	novio
determinados	determinados
reuniões	reuniones
gerações	generaciones
sabendo	sabiendo
capitais	capitales
capitais	capital
minnesota	minnesota
pagina	pagina
leme	timón
liberais	liberales
selvagem	silvestre
selvagem	salvaje
transmitida	transmitida
formatos	formatos
aceitação	aceptación
recebem	reciben
evans	evans
bandeiras	banderas
pegar	coger
túmulo	tumba
leonor	leonor
causada	causada
acampamento	campamento
graham	graham
fabaceae	fabaceae
vencido	vencido
gera	genera
pedindo	solicitando
pedindo	pidiendo
atribuída	asignada
imigração	inmigración
celso	celso
maurice	maurice
controvérsia	controversia
roman	roman
aumentando	aumentando
coloração	tinción
coloração	coloración
semelhança	similitud
semelhança	parecido
semelhança	semejanza
expressa	expresa
expressa	expresada
mars	mars
map	map
proprietários	propietarios
proprietários	dueños
ava	ava
polaco	polaco
rapaz	muchacho
rapaz	chico
irlandês	irlandés
enviados	enviados
enviados	enviadas
possuindo	poseyendo
saiba	sepa
célebre	célebre
reunir	reunir
sonda	sonda
committee	committee
longd	longd
fiscal	fiscal
guatemala	guatemala
kent	kent
terrestres	terrestres
contínua	contínua
contínua	continua
pleno	pleno
ofensiva	ofensiva
mancha	mancha
quartel	cuartel
mamíferos	mamíferos
fracasso	fracaso
solos	suelos
armazenamento	almacenaje
armazenamento	almacenamiento
got	got
códigos	códigos
thompson	thompson
cidadania	ciudadanía
acompanhar	acompañar
latd	latd
plena	plena
citados	citados
distribuído	distribuido
wolf	wolf
variam	varían
danilo	danilo
ricos	ricos
tópicos	temas
colaboradores	colaboradores
colaboradores	reveladores
rotação	rotación
catolicismo	catolicismo
perfeitamente	perfectamente
envolveu	involucró
envolveu	implicó
ciclone	ciclón
magno	magno
terrenos	terrenos
propriamente	propiamente
our	our
mandatos	mandatos
júri	jurado
compostas	compuestas
lançamentos	lanzamientos
roque	roque
giuseppe	giuseppe
avançou	avanzó
matérias	asignaturas
matérias	materias
dita	dicta
internos	internos
palestina	palestina
taiwan	taiwán
taiwan	taiwan
sara	sara
aldeias	aldeas
choque	shock
restrições	restricciones
mistas	mixtas
neil	neil
desfile	desfile
noronha	noronha
cândido	cándido
regularmente	regularmente
pesos	pesos
douro	douro
douro	duero
inserção	inserción
diminuir	disminuir
fischer	fischer
atingindo	alcanzando
evil	evil
premiado	premiado
premiado	galardonado
igualdade	igualdad
where	where
aonde	adonde
aonde	adónde
coleópteros	coleópteros
reações	reacciones
rubens	rubens
visitar	visite
visitar	visitar
visitar	visita
xuxa	xuxa
they	they
run	run
capturado	capturado
reno	rin
reno	reno
ficaria	quedaría
oposto	opuesto
edit	edit
conseguido	conseguido
conseguido	logrado
primário	primario
primário	primaria
coberta	cubierta
valley	valley
traduções	traducciones
neo	neo
defensores	defensores
heitor	héctor
completou	completó
facilidade	facilidad
vasta	vasta
parabéns	felicitaciones
parabéns	enhorabuena
gases	gases
mecanismos	mecanismos
acreditar	creer
concluída	terminada
eleitores	votantes
eleitores	electores
apartamento	apartamento
apartamento	apartamentos
august	august
bizantinos	bizantinos
qualificação	cualificación
qualificação	calificación
luke	luke
deep	deep
concluído	concluido
concluído	finalizado
concluído	terminado
concluído	completado
robinson	robinson
pátio	patio
fortificações	fortificaciones
western	western
tumnus	tumnus
culpa	culpa
culpa	culpabilidad
holmes	holmes
zool	zool
kurt	kurt
falado	hablado
emancipação	emancipación
scope	scope
mina	mina
pietro	pietro
circunstâncias	circunstancias
orange	orange
xxi	xxi
abastecimento	abastecimiento
abastecimento	suministro
derrotas	derrotas
mundialmente	mundialmente
tanque	tanque
tito	tito
museus	museos
ferido	herido
dallas	dallas
plástico	plástico
malásia	malasia
card	card
cartão	tarjeta
violação	violacion
violação	violación
fort	fort
diretores	directores
susan	susan
sex	sex
start	start
cerâmica	alfarería
cerâmica	cerámica
falsa	falsa
cinematografia	cinematografía
idéias	ideas
manifestação	manifestación
pianista	concertista
pianista	pianista
postura	postura
melbourne	melbourne
edwards	edwards
prof	prof
exige	exige
java	java
controlo	control
eficiência	eficiencia
eficiência	eficacia
rebelde	rebelde
proibido	prohibida
proibido	prohibido
vêm	vienen
voivodia	voivodato
auge	ojeada
grace	grace
culinária	culinaria
criaram	crearon
criaram	criaron
arizona	arizona
charlotte	charlotte
mito	mito
químicos	químicos
deseja	desea
uhf	uhf
gravadas	grabadas
ênfase	insistencia
ênfase	énfasis
usava	utilizaba
usava	usaba
consulta	consulta
reverter	revertir
call	call
verlag	verlag
dramática	dramática
filmado	filmado
matando	asesinando
matando	matando
giro	giro
padres	sacerdotes
estiveram	estuvieron
segmentos	segmentos
aplica	aplica
elias	elías
elias	elias
arábia	arabia
traços	trazos
traços	rasgos
soberano	soberano
colocadas	colocadas
colocadas	puestas
study	study
judeu	judio
judeu	judío
bruxelas	bruselas
bank	bank
divulgar	divulgar
divulgar	difundir
vegetais	vegetales
alimento	alimento
elétrons	electrones
observatório	observatorio
esboços	esbozos
esboços	bosquejos
esboços	bocetos
automóvel	automóviles
automóvel	automóvil
cana	caña
emma	emma
cinquenta	cincuenta
couto	couto
profundamente	profundamente
estética	estética
gradualmente	gradualmente
dores	dolores
centre	centre
augusta	augusta
multi	multi
repercussão	repercusión
repercussão	repercusiones
massas	masas
marta	marta
botanical	botanical
reduzido	reducido
gospel	gospel
compôs	compuso
provocou	provocó
legais	legales
lúcia	lúcia
lúcia	lucía
naturalmente	naturalmente
gustav	gustav
horta	huerto
horta	huerta
horta	horta
utilizou	utilizó
madrugada	madrugada
madrugada	amanecer
amostra	muestra
cbs	cbs
vegetal	vegetal
estabelecimentos	establecimientos
medalhista	medallista
exibidos	exhibidos
correr	correr
georges	georges
empregado	empleado
sexuais	sexuales
reduzida	reducida
keith	keith
funk	funk
entrando	entrando
costume	costumbre
ronald	ronald
estabilidade	estabilidad
guitar	guitar
escultor	escultor
horizontal	horizontal
magic	magic
sensação	sensación
convidada	invitada
permanecendo	permaneciendo
poetas	poetas
efetivamente	efectivamente
ludwig	ludwig
samurai	samurái
samurai	samurai
pretendia	pretendía
espectro	espectro
anunciada	anunciada
considero	considero
fósseis	fósiles
catalunha	cataluña
puro	puro
lloyd	lloyd
currículo	curriculum
currículo	currículo
currículo	currículum
visuais	visuales
warren	warren
conquistado	conquistado
cuidados	cuidados
barras	barras
dispõe	dispone
ganharam	ganaron
slam	slam
tive	tuve
núcleos	núcleos
mudando	cambiando
arsenal	arsenal
arsenal	armería
respectivos	respectivos
mirim	mirim
antigamente	antaño
antigamente	antiguamente
turcos	turcos
colina	colina
farol	faro
marítima	maritima
marítima	marítima
parou	detuvo
parou	paró
bombas	bombas
nascidos	nacidos
visa	visa
escocês	escocés
debates	debates
debates	debate
acusação	acusación
productions	productions
investigações	investigaciones
adequada	adecuada
cerebral	cerebral
misericórdia	misericordia
misericórdia	piedad
mínimos	mínimos
válidos	válidos
assumindo	asumiendo
assumindo	suponiendo
guiana	guyana
guiana	guayana
make	make
esquadrão	escuadrón
esquadrão	escuadra
registo	registro
governante	gobernante
piratas	piratas
kids	kids
corredor	corredor
corredor	pasillo
kingdom	kingdom
vizinho	vecino
vestígios	vestigios
vestígios	trazas
privadas	privadas
sandra	sandra
profundo	profundo
clipes	clips
tanques	tanques
ideologia	ideología
arnold	arnold
implica	implica
gerente	gerente
urss	urss
reconhecer	reconocer
atrações	atracciones
adotou	adoptó
imposto	impuesto
prazer	placer
avisado	advertido
avisado	avisado
rené	rené
assinar	firmar
ofereceu	ofreció
intelectuais	intelectuales
caridade	beneficencia
caridade	caridad
integrada	integrada
goals	goals
carvão	carbón
cordilheira	cordillera
presa	arrestada
presa	atrapada
presa	presa
internacionalmente	internacionalmente
mudaram	cambiaron
view	view
amaro	amaro
barcos	botes
barcos	barcos
arredores	alrededores
malta	malta
oponente	opositor
básicos	básicos
raymond	raymond
vinda	venida
hunter	hunter
iniciando	iniciando
forest	forest
consideração	consideración
episcopal	episcopal
visitou	visitó
salva	salvia
salva	salvada
turístico	turistico
premier	premier
extensa	extensa
determinadas	determinadas
her	her
justo	justo
anéis	anillos
humberto	humberto
átomos	átomos
ernst	ernst
vanessa	vanessa
vanessa	vanesa
comunistas	comunistas
transmitir	transmitir
inspirada	inspirada
joan	joan
absurdo	absurdo
frankfurt	frankfurt
frankfurt	fráncfort
frankfurt	francfort
lara	lara
inovação	innovación
falhas	fallas
nbc	nbc
meridional	meridional
montana	montana
dum	dum
felicidade	felicidad
suficientes	suficientes
telescópio	telescopio
canada	canada
tenista	tenista
norman	norman
perderam	perdieron
tronco	tronco
tronco	torso
caverna	cueva
caverna	caverna
promessa	promesa
historicamente	históricamente
liverpool	liverpool
alternativas	alternativas
dourado	dorado
bebê	bebé
harold	harold
chamava	llamaba
comparado	comparado
afirmam	afirman
terão	tendrán
terão	habrán
propõe	propone
abertas	abiertas
resultante	resultante
portos	puertos
fixa	fija
women	women
adversários	adversarios
adversários	oponentes
adversários	opositores
minuto	minuto
reitor	decano
reitor	rector
edge	edge
contemporâneo	contemporáneo
noiva	prometida
emi	emi
associadas	asociadas
coletiva	colectiva
pavilhão	pabellón
spin	spin
proximidade	cercanía
proximidade	proximidad
inserir	insertar
insiste	insiste
car	car
wii	wii
sabem	sabéis
sabem	saben
its	its
borda	borde
funcionário	funcionario
percepção	percepción
ganho	ganancia
ganho	gano
loire	loira
loire	loire
nov	nov
acadêmica	académica
frequentes	frecuentes
fechada	cerrada
compõem	componen
cinza	ceniza
cinza	gris
cinza	grises
oxigênio	oxigeno
oxigênio	oxígeno
corrêa	corrêa
frequente	frecuente
phoenix	phoenix
enviada	enviada
muralha	muralla
linguagens	lenguajes
mercedes	mercedes
importa	importa
machos	machos
difíceis	difíciles
sargento	sargento
indicando	indicando
rachel	rachel
renovação	renovación
manchete	titular
consorte	consorte
fragmentos	fragmentos
exclusivo	exclusivo
geometria	geometría
crônica	crónico
crônica	crónica
telecomunicações	telecomunicación
telecomunicações	telecomunicaciones
apoiado	apoyado
eficaz	eficaz
sweet	sweet
hopkins	hopkins
prestígio	prestigio
governadores	gobernadores
coletivo	colectivo
coletivo	colectiva
centímetros	centímetros
leipzig	leipzig
say	say
secundárias	secundarias
fenômenos	fenómenos
enterrado	enterrado
líbia	libia
embarcações	embarcaciones
issn	issn
nascente	naciente
confrontos	enfrentamientos
criaturas	criaturas
chegado	llegado
euro	euro
colapso	colapso
parágrafo	párrafo
marx	marx
matheus	matheus
voltado	vuelto
pátria	patria
tigre	tigre
pescoço	cuello
competir	competir
number	number
operar	operar
semestre	semestre
provenientes	procedentes
provenientes	procedan
ring	ring
temática	temática
derivados	derivados
oficina	taller
estêvão	esteban
dinamarquês	danés
invenção	invento
invenção	invención
hidrogênio	hidrógeno
perdida	perdida
almas	almas
timor	timor
hebraico	hebreo
jurisdição	jurisdicción
adolfo	adolfo
bactérias	bacterias
progressivo	progresivo
colaborou	colaborado
colaborou	colaboró
colaborou	cooperó
requer	requiere
alfa	alfa
tentaram	intentaron
tentaram	trataron
reeleito	reelegido
reeleito	reelecto
registrados	registrados
verso	verso
verso	reverso
harrison	harrison
ligeiramente	ligeramente
ligeiramente	levemente
futuros	futuros
were	were
impróprio	impropio
inferiores	inferiores
fiéis	fieles
universitária	universitaria
potências	potencias
toque	tacto
toque	toca
toque	toque
encontros	encuentros
subiu	subió
votado	votado
viajar	viajar
turner	turner
cds	cds
incorporada	empotrada
incorporada	incorporada
mountain	mountain
primárias	primarias
bombeiros	bomberos
observado	observado
pertencem	pertenecen
pecuária	ganadería
maneiras	maneras
notar	notar
hills	hills
absoluto	absoluto
supercopa	supercopa
money	money
crenças	creencias
viseu	viseu
moreno	moreno
compreender	comprender
compreender	entender
lobos	lobos
denis	denis
airlines	airlines
monstros	monstruos
sobrevivência	supervivencia
acidentes	accidentes
silvio	silvio
continha	contenía
negativa	negativa
parentes	parientes
verificabilidade	verificabilidad
orgânica	orgánica
realizando	realizando
inteira	entera
significativamente	significativamente
significativamente	perceptiblemente
caracterizado	caracterizado
butterflies	butterflies
aparecida	aparecida
mariposa	polilla
perfeita	perfecta
bush	bush
redonda	redonda
sociologia	sociología
gótico	gótica
gótico	gótico
quadrado	cuadrado
rodríguez	rodríguez
renânia	renania
atacou	atacó
atacou	ataco
normais	normales
amistoso	amistoso
coragem	coraje
coragem	valentía
coragem	agallas
coragem	valor
atitudes	actitudes
obtidos	obtenidos
medeiros	medeiros
vantagens	ventajas
participado	participado
eyes	eyes
interpretando	interpretando
ilegal	ilegal
mansão	mansión
vítor	vítor
sugeriu	sugirió
submarino	submarino
submarino	submarinos
mudado	cambiado
intenso	intenso
adquirir	adquirir
ferrari	ferrari
trilhas	senderos
teu	tu
voltaram	volvieron
voltaram	regresaron
gerando	generando
assistir	asistir
espelho	espejo
maracanã	maracaná
expandir	expandir
existiu	existió
fritz	fritz
area	area
impede	impide
allan	allan
boeing	boeing
assalto	atraco
assalto	asalto
opa	opa
bourbon	borbón
bourbon	bourbon
hardy	hardy
fêmeas	hembras
sudão	sudán
sudão	sudan
apareceram	aparecieron
verbo	verbo
móvel	móvil
ampliação	ampliación
abraço	abrazo
vestido	vestido
muralhas	murallas
muralhas	muros
barragem	presa
informar	informar
jefferson	jefferson
simão	simón
identificado	identificado
residencial	residencial
bastos	bastos
delegação	delegación
michelle	michelle
simmons	simmons
expresso	espresso
expresso	expreso
expresso	expresado
human	human
jstor	jstor
precipitação	precipitación
precipitação	precipitaciones
khan	khan
khan	kan
produzindo	produciendo
corda	cuerda
corda	soga
coligação	coalición
espíritos	espíritus
ritual	ritual
procurou	buscó
concluir	finalizar
concluir	concluir
teto	techo
possibilidades	posibilidades
restaurantes	restaurantes
cozinha	cocina
mariano	mariano
introduziu	introdujo
explorar	explorar
explorar	explotar
gaspar	gaspar
comer	comer
mísseis	misiles
dívida	deuda
field	field
complementar	complementar
complementar	complementario
definidos	definidos
raças	razas
albânia	albania
second	second
únicas	únicas
quebec	québec
quebec	quebec
médias	medianas
médias	promedios
luigi	luigi
navarra	navarra
estejam	estén
amar	amar
tricolor	tricolor
infecção	infección
aparelhos	captadores
aparelhos	aparatos
also	also
ideais	ideales
vizinha	vecina
fame	fame
águia	águila
águia	aguila
antioquia	antioquía
than	than
move	move
move	mueve
soberania	soberanía
biografias	biografías
oklahoma	oklahoma
main	main
sabor	sabor
naturalidade	naturalidad
kentucky	kentucky
negativo	negativa
negativo	negativo
causado	causado
protestantes	protestantes
cantada	cantada
inês	inés
bonita	bonita
bonita	guapa
vindos	venidos
úteis	útiles
navegador	navegante
navegador	navegador
vaz	faz
vaz	vaz
passe	pase
anfíbio	anfibio
petersburgo	petersburgo
realizaram	realizaron
remo	remo
juízes	jueces
iowa	iowa
heaven	heaven
corretamente	correctamente
ralph	ralph
pudessem	pudieran
entende	entiende
responde	responde
responde	contesta
georg	georg
fixo	fijo
gardens	gardens
segura	segura
info	info
introduzida	introducida
contam	cuentan
apoiou	apoyó
jesuítas	jesuitas
chipre	chipre
falcão	falcon
falcão	halcón
capturar	capturar
santarém	santarém
saudita	saudita
marítimo	marítimo
pen	pen
inseto	insecto
expectativa	expectación
expectativa	expectativa
sultão	sultán
estrangeiras	extranjeras
formados	formados
financiamento	financiación
financiamento	financiamiento
protesto	protesta
pecado	pecado
taxonomic	taxonomic
craig	craig
fugiu	huyó
drive	drive
burocratas	burócratas
pensando	pensando
wellington	wellington
pilar	pilar
geográfico	geográfico
full	full
roberts	roberts
pato	pato
classificadas	clasificadas
participante	participante
concreto	concreto
ama	ama
protegido	protegido
prefixo	prefijo
institucional	institucional
square	square
assist	assist
lendas	leyendas
emmy	emmy
prato	plato
reportagem	reportaje
anuais	anual
anuais	anuales
pas	pas
psd	psd
tributo	tributo
uruguaio	uruguayo
medicamentos	medicamentos
demonstrou	demostró
demonstração	demostración
faculdades	facultades
bull	bull
salário	salario
salário	sueldo
rodolfo	rodolfo
wallace	wallace
localizadas	localizadas
cole	cole
comandos	comandos
comandos	mandos
recomendação	recomendación
coberto	cubierto
conspiração	conspirar
conspiração	complot
conspiração	conspiración
antero	antero
justificar	justificar
carol	carol
fall	fall
gilbert	gilbert
jake	jake
concorrentes	concursantes
concorrentes	competidores
concorrentes	competidoras
bibliotecas	bibliotecas
aníbal	aníbal
sagrada	sagrada
detalhe	detalle
triste	triste
doente	enfermo
doente	enferma
aveiro	aveiro
happy	happy
radar	radar
variados	variados
representações	representaciones
bonito	bonito
bonito	guapo
saboia	saboya
trabalham	trabajan
pacto	pacto
cabelos	pelos
cabelos	cabellos
business	business
escândalo	escándalo
rivais	rivales
lyon	lyon
jessica	jessica
absolutamente	absolutamente
pacheco	pacheco
tragédia	tragedia
tyler	tyler
brandão	brandão
suspeita	sospechosa
suspeita	sospecha
interessado	interesado
diabo	diablo
golpes	golpes
vela	vela
vigilância	vigilancia
óbvio	obvio
müller	müller
alexandra	alexandra
hal	hal
function	function
agg	agg
pesada	pesada
feiras	ferias
prefeitos	prefectos
alessandro	alessandro
equações	ecuaciones
myspace	myspace
bruto	bruto
interino	interino
lorde	lord
fernández	fernández
trabalhado	trabajado
trabalhado	trabajada
linguística	lingüística
wikis	wikis
johns	johns
tiros	tiros
tantas	tantas
etiópia	etiopía
dependência	dependencia
compor	componer
figueira	higuera
public	public
church	church
aprendeu	aprendió
adelaide	adelaida
adelaide	adelaide
amado	amado
alcançado	alcanzado
multidão	muchedumbre
multidão	multitud
resolvido	resuelto
resolvido	solucionado
resolvido	resuelta
lane	lane
polegadas	pulgadas
teodoro	teodoro
guarnição	guarnición
markku	markku
roland	roland
permanência	permanencia
completos	completos
especializado	especializado
tira	quita
tira	saca
dano	daño
hesse	hessen
hesse	hesse
reconhece	reconoce
reconhece	reconoces
console	consola
barreira	barrera
protestante	protestante
prevista	prevista
mineral	mineral
fina	fina
concedeu	concedió
esperava	esperaba
adolescência	adolescencia
mind	mind
líbano	líbano
pete	pete
algarve	algarve
sólido	sólido
dirigentes	dirigentes
magnético	magnético
gigantes	gigantes
navais	navales
licenciatura	licenciatura
ameaças	amenazas
múltiplos	múltiplos
múltiplos	múltiples
mercadorias	mercancías
agradeço	agradezco
patrícia	patricia
comemoração	celebración
comemoração	conmemoración
sentença	sentencia
precisava	necesitaba
índices	indices
índices	índices
prevenção	prevención
melodia	melodía
obtenção	obtención
junius	junius
eliminados	eliminados
pesquisador	buscador
pesquisador	investigador
manuscrito	manuscrito
participam	participan
crônicas	crónicas
boi	buey
boi	bol
boi	boi
württemberg	wurtemberg
caçadores	cazadores
masters	masters
separar	separarse
separar	separar
incapaz	incapaz
interessados	interesados
deficiência	discapacidad
deficiência	deficiencia
kew	kew
work	work
collins	collins
hospitais	hospitales
briga	pelea
tomado	tomado
maomé	mohammed
maomé	mahoma
surgem	surgen
removido	quitado
removido	eliminado
painel	panel
chi	chi
armadura	armadura
micro	micro
cartões	tarjetas
adquirido	adquirido
recomendações	recomendaciones
garantia	garantía
greatest	greatest
predominantemente	predominantemente
criminal	criminal
criminal	penal
luxo	lujo
luxo	lujos
phillips	phillips
boxe	boxeo
esculturas	esculturas
born	born
novatos	novatos
aurora	aurora
mitchell	mitchell
mitchell	mitchel
poço	pozo
made	made
subida	subida
subdivisões	subdivisiones
patrocínio	patrocinio
macho	macho
setúbal	setúbal
detroit	detroit
querendo	queriendo
hardware	hardware
tivessem	hubieran
tivessem	tuvieran
ouvido	oído
ouvido	escuchado
perdas	pérdidas
perdas	perdidas
urbanas	urbanas
lesões	lesiones
alencar	alencar
visitas	visitas
nervoso	nervioso
han	han
soviéticos	soviéticos
febre	fiebre
transformando	transformando
adoção	adopción
ltd	ltd
tanta	tanta
separadas	separadas
hudson	hudson
liderados	liderados
maratona	maratón
elvis	elvis
cobra	culebra
cobra	cobra
monges	monjes
menciona	menciona
escolhidos	escogidos
socialismo	socialismo
june	june
ice	ice
colecção	colección
honorário	honorario
fotógrafo	fotógrafo
ruth	ruth
jesse	jesse
romântico	romántico
gramática	gramática
laços	lazos
date	date
tendem	tienden
divididas	divididas
acer	acer
yes	yes
riscos	riesgos
trocar	intercambiar
nilo	nilo
vital	vital
atribuição	atribución
atribuição	asignación
ted	ted
haverá	habrá
mônica	mónica
regência	regencia
consistia	consistía
hart	hart
novato	novato
mensal	mensual
virada	girada
criei	creé
favorito	favorito
conservador	conservador
veloso	veloso
espetáculos	espectáculos
martín	martín
circo	circo
circo	circos
selecionado	seleccionado
selecionado	seleccionada
wall	wall
irene	irene
bebidas	bebidas
caçador	cazador
monge	monje
naruto	naruto
pôr	poner
atacado	atacado
atacado	mayorista
double	double
trigo	trigo
quentes	calientes
quentes	cálidas
murphy	murphy
ante	ante
separada	separada
cenários	escenarios
pacote	paquete
silêncio	silencio
nicholas	nicholas
kenneth	kenneth
buraco	agujero
buraco	hoyo
gaúcha	gaucha
definitiva	definitiva
nono	noveno
pernambucano	pernambucano
principado	principado
disputadas	disputadas
helen	helen
ascendência	ascendencia
sentiu	sintió
children	children
esperando	esperando
madame	madam
madame	madama
madame	madame
ernest	ernest
voltas	giros
voltas	vueltas
cap	cap
delegado	delegado
funcional	funcional
amadores	amateurs
amadores	amateur
amadores	aficionados
londrina	londres
londrina	londinense
jogado	desempeñado
jogado	jugado
viram	vieron
transferida	transferida
stop	stop
pérez	pérez
next	next
conferir	conferir
ajudando	ayudando
montevidéu	montevideo
bico	boquilla
agências	agencias
margaret	margaret
standard	standard
respectivas	respectivas
adolf	adolf
jam	jam
seattle	seattle
aaron	aaron
aaron	aarón
cruzada	cruzada
cruzada	cruzadas
preparado	listo
preparado	preparado
chamando	llamando
servido	servido
bass	bass
receitas	ingresos
receitas	recetas
devil	devil
pioneiros	pioneros
produzem	producen
complexa	compleja
moisés	moisés
formações	formaciones
atlantic	atlantic
exportação	exportación
incluídos	incluidos
simpson	simpson
constituinte	constituyente
forever	forever
cratera	cráter
hábito	hábito
duff	duff
location	location
detetive	detective
lagoas	charcas
lagoas	estanques
lagoas	lagunas
entram	entran
publicamente	públicamente
frederick	frederick
milan	milan
levantamento	levantamiento
defendendo	defendiendo
ocupando	ocupando
cumprimento	cumplimiento
sacramento	sacramento
linhagem	linaje
temporariamente	temporalmente
backing	backing
avançado	avanzado
avançado	avanzada
póvoa	póvoa
interpretações	interpretaciones
alerta	alerta
greco	greco
rotas	rutas
inéditas	inéditas
joinville	joinville
resende	resende
islândia	islandia
perna	pierna
haiti	haití
mágica	mágico
mágica	mágica
macmillan	macmillan
queriam	querían
obs	obs
seul	seúl
costumam	acostumbran
costumam	suelen
dever	deber
repressão	represión
trek	trek
folk	folk
einstein	einstein
stade	stade
pimenta	pimienta
quarteto	cuarteto
adicionado	añadido
adicionado	agregado
comandou	comandó
discovery	discovery
lutando	peleando
lutando	luchando
model	model
alpha	alpha
alpha	alfa
chelsea	chelsea
hero	hero
proveniente	procedente
irregular	irregular
uniformes	uniformes
junção	empalme
fábricas	fábricas
fábricas	fabricas
lipe	lipe
norueguês	noruego
teen	teen
compacto	compacto
hermann	hermann
sérvio	serbio
reich	reich
dilma	dilma
lacerda	lacerda
possuíam	poseían
vendida	vendida
aquitânia	aquitania
porquê	porqué
espírita	espiritista
tendências	tendencias
bang	bang
relativo	relativo
julie	julie
planície	llanura
planície	llano
pilares	pilares
caracterizada	caracterizada
atravessa	atraviesa
atravessa	cruza
office	office
designer	diseñador
chuck	chuck
devidamente	debidamente
senadores	senadores
canhões	cañones
praças	plazas
barreiras	vallas
barreiras	barreras
voar	volar
empire	empire
doação	donación
doação	donativo
dieta	dieta
mercury	mercury
european	european
ninja	ninja
euro+med	euro+med
gabriela	gabriela
match	match
governou	gobernó
logística	logística
bósnia	bosnio
bósnia	bosnia
garantiu	aseguró
garantiu	garantizó
holandesa	holandesa
atrair	atraer
diplomata	diplomática
diplomata	diplomático
mandar	mandar
depósitos	depósitos
ataca	ataca
coleta	colecta
operacionais	operativas
operacionais	operativos
operacionais	operacionales
juventus	juventus
túnel	túnel
túnel	tunel
liceu	liceo
salomão	solomon
salomão	salomón
piedade	piedad
mármore	mármol
mortais	mortales
lituânia	lituania
apaixonado	apasionado
apaixonado	enamorado
romântica	romántica
dezoito	dieciocho
terço	tercio
child	child
substituto	suplente
substituto	sustituto
advogados	abogados
palatinado	palatinado
holland	holland
escura	oscura
simone	simone
ficado	quedado
talentos	talentos
júlia	julia
traduzir	traducir
grey	grey
iriam	irían
igor	igor
agrostis	agrostis
noel	noel
retornando	regresando
bizantina	bizantina
cúpula	cúpula
cúpula	domo
parceiros	asociados
parceiros	socios
acordos	acuerdos
cruzamento	cruce
camilo	camilo
futebolistas	futbolistas
spears	spears
revelar	revelar
hughes	hughes
sts	sts
algodão	algodón
obtida	obtenida
narrador	narrador
sets	sets
duro	duro
subtropical	subtropical
alabama	alabama
desenvolvidas	desarrolladas
parlamentares	parlamentarias
lucro	beneficio
cama	cama
nona	novena
nona	nona
governamental	gubernamental
beat	beat
estabeleceram	establecieron
criatura	criatura
terapia	terapia
betty	betty
desafios	desafíos
desafios	retos
neerlandês	neerlandés
films	films
estrangeira	extranjera
sri	sri
abel	abel
provisório	provisional
percebeu	percibió
diesel	diésel
diesel	diesel
condes	condes
htm	htm
cameron	cameron
treinar	entrenar
determina	determina
cartoon	cartoon
aurélio	aurelio
inscrições	inscripciones
most	most
filmografia	filmografía
cerveja	cerveza
bravo	bravo
pes	pes
aposentadoria	jubilación
aposentadoria	retiro
wisconsin	wisconsin
guadalajara	guadalajara
ref	ref
campina	campina
cleveland	cleveland
inventor	inventor
manifesto	manifiesto
observa	observa
lapa	lapa
originou	originó
adotada	adoptada
dadas	dadas
