que	que
uma	una
com	com
com	con
para	para
por	por
foi	fue
como	cómo
como	como
não	no
mais	más
sua	tuya
sua	su
utc	utc
são	son
seu	tu
seu	suyo
seu	tuyo
seu	su
min	min
também	también
the	the
ser	ser
ele	él
mas	pero
discussão	hilo
discussão	discusión
entre	entre
anos	años
era	era
tem	tiene
nos	nos
até	hasta
cidade	ciudad
cidade	céntrico
quando	cuándo
quando	cuando
seus	sus
seus	suyos
foram	fueron
janeiro	enero
mesmo	mismo
mesmo	incluso
onde	donde
onde	dónde
#redirecionamento	#redirección
grande	grande
grande	gran
brasil	brasil
rio	río
está	está
depois	luego
depois	después
estado	estado
ano	año
nas	nas
primeiro	primer
primeiro	primero
pode	puede
durante	durante
ligações	vínculos
ligações	enlaces
ligações	conexiones
ligações	acoplamientos
parte	parte
este	este
este	éste
primeira	primera
nome	nombre
externas	externos
externas	externas
sendo	siendo
ainda	aún
ainda	todavía
outros	otros
esta	ésta
esta	esta
sem	sem
sem	sin
ela	ella
dia	día
dia	dia
dois	dos
muito	muy
muito	mucho
região	region
região	región
suas	sus
segundo	segundo
artigo	artículo
apenas	solo
apenas	sólo
ter	tener
msg	msg
julho	julio
área	zona
área	area
área	área
agosto	agosto
lista	lista
maio	mayo
março	marzo
norte	norte
família	familiares
família	familia
abril	abril
sul	sur
grupo	grupo
setembro	septiembre
paulo	paulo
paulo	pablo
ver	ver
ver	véase
outubro	octubre
isso	eso
maior	mayor
todos	todos
nova	nova
nova	nueva
álbum	álbum
álbum	album
junho	junio
contra	contra
tempo	tiempo
dezembro	diciembre
fevereiro	febrero
forma	forma
forma	manera
vez	vez
novembro	noviembre
assim	así
então	entonces
principal	principal
três	tres
série	serie
além	además
align	align
final	final
desde	desde
história	historia
filme	película
antes	antes
melhor	mejor
guerra	guerra
população	poblacion
população	población
estados	estados
bem	bien
mundo	mundo
banda	banda
outras	otras
km²	km²
gols	goles
nacional	nacional
jogos	juegos
qual	cual
qual	cuál
brasileiro	brasileño
brasileiro	brasilero
alguns	algunos
center	center
vida	vida
possui	posee
país	país
cada	cada
eles	ellos
música	música
página	página
pelos	vello
dias	días
dias	dias
campeonato	campeonato
josé	josé
município	municipio
futebol	balompié
futebol	fútbol
futebol	futbol
espécie	especie
portugal	portugal
joão	juan
tinha	tenía
tinha	tenia
clube	club
unidos	unidos
novo	nuevo
partir	partir
teve	tuvo
tendo	teniendo
tendo	habiendo
segunda	lunes
segunda	segunda
pessoas	personas
habitantes	habitantes
presidente	presidenta
presidente	presidente
caso	caso
jogo	juego
sistema	sistema
americano	americano
americano	norteamericano
americano	estadounidense
período	periodo
período	período
século	siglo
título	título
casa	casa
casa	cásate
enquanto	mientras
seja	sea
oficial	oficial
vezes	veces
filho	hijo
governo	gobierno
pois	pues
artigos	artículos
distrito	distrito
fazer	hacer
local	local
trabalho	trabajo
outro	otro
fez	hizo
fez	fez
acordo	acuerdo
acordo	despierto
número	número
estava	estaba
maria	maría
maria	maria
estão	están
estão	estan
vários	varios
terra	tierra
gênero	genero
gênero	género
igreja	iglesia
universidade	universidad
qualquer	cualquiera
qualquer	cualquier
podem	pueden
centro	centro
início	inicio
essa	esa
tipo	tipo
santa	santa
conhecido	conocido
esse	ese
canção	cancion
canção	canción
edição	edición
mundial	mundial
todas	todas
português	portugués
lançado	lanzado
rei	rey
rei	rei
algumas	algunas
quem	quiénes
quem	quién
quem	quien
água	agua
quatro	cuatro
época	época
exemplo	ejemplo
morte	fallecimiento
morte	muerte
devido	debido
eram	eran
brasileira	brasilera
brasileira	brasileña
produção	producción
temporada	temporada
for	for
muitos	muchos
muitos	demasiados
wikipédia	wikipedia
time	time
faz	hace
geral	generales
geral	general
aqui	aquí
style	style
versão	versión
fim	fin
fim	final
carlos	carlos
menos	menos
programa	programa
porto	puerto
porto	oporto
fontes	fuentes
deve	debe
seria	sería
sempre	siempre
site	sitio
livro	libro
lado	lado
atualmente	actualmente
equipe	equipo
havia	había
escola	escuela
várias	varias
outra	otra
dados	dados
dados	datos
quais	cuáles
quais	cuales
apesar	apesar
copa	copa
posição	posición
internacional	internacional
hoje	hoy
província	provincia
team	team
países	paises
países	países
embora	aunque
inglês	inglés
pouco	poco
porque	porque
projeto	diseñar
projeto	proyecto
projeto	diseño
você	usted
atual	actual
john	john
ordem	orden
pai	padre
localizada	ubicada
localizada	localizada
estádio	estadio
partido	partido
começou	empezó
começou	comenzó
passou	pasó
mesma	misma
ilha	isla
campo	campo
placar	marcador
uso	uso
linha	línea
poder	poder
reino	reino
muitas	muchas
grandes	grandes
principais	principales
conta	cuenta
tarde	tarde
volta	regresa
volta	vuelve
volta	vuelta
política	politica
política	política
comuna	comuna
base	base
frança	francia
direito	derecho
nem	ni
real	real
rede	red
obra	obra
jpg	jpg
chamado	llamado
público	público
fase	fase
pedro	pedro
lisboa	lisboa
isbn	isbn
ponto	punto
empresa	empresa
single	single
corpo	cuerpo
década	decenio
década	década
divisão	división
república	republica
república	república
votação	votación
américa	américa
data	fecha
data	data
agora	ahora
condado	condado
desenvolvimento	desarrollo
mil	mil
logo	pronto
logo	logotipo
logo	logo
diretor	director
toda	toda
categoria	categoría
cintura	cintura
mar	mar
militar	militar
campeão	campeón
campeão	campeon
new	new
diz	dice
sucesso	exito
sucesso	éxito
francisco	francisco
original	original
fora	fuera
comunidade	comunidad
idade	edad
portuguesa	portuguesa
cinco	cinco
maioria	mayoría
maioria	mayoria
alemanha	alemania
tudo	todo
recebeu	recibió
média	promedio
média	media
tal	tal
vai	va
vai	vete
quase	casi
boa	buena
dentro	adentro
dentro	dentro
processo	proceso
último	ultimo
último	último
bom	bueno
bom	buen
milhões	millones
rock	rock
arte	arte
total	total
lei	ley
importante	importante
obras	obras
obras	manufacturas
presente	presente
presente	regalo
censo	censo
ficou	quedó
feito	hecho
central	central
língua	lengua
língua	idioma
sede	sede
tanto	tanto
pontos	puntos
costa	costa
origem	procedencia
origem	origen
exército	ejército
exército	ejercito
santo	santo
incluindo	incluyendo
ouro	oro
federal	federal
quanto	cuanto
quanto	cuánto
texto	texto
membros	miembros
altura	altura
nada	nada
longo	largo
cor	color
cor	cor
têm	tienen
isto	esto
próprio	propio
nível	nivel
imagem	imagen
usuário	usuario
diferentes	distintos
diferentes	diferentes
diferentes	distintas
homem	hombre
junto	junto
conhecida	conocida
criação	creación
border	border
silva	silva
construção	construcción
construção	construccion
jogador	jugador
televisão	televisor
televisão	televisión
social	social
revista	revista
vitória	triunfo
união	union
união	unión
cultura	cultura
político	político
canal	canal
http	http
papel	papel
força	fuerza
principalmente	principalmente
lançamento	lanzamiento
personagem	personaje
estilo	estilo
prêmio	premio
território	territorio
world	world
text	text
será	será
mãe	madre
primeiros	primeros
europa	europa
existe	existe
nunca	nunca
movimento	movimiento
santos	santos
you	you
pessoa	persona
fato	traje
cruz	cruz
espanha	españa
possível	posible
fonte	fuente
localidades	localidades
bairro	vecindario
bairro	barrio
filha	hija
liga	liga
liga	aleación
vice	vicepresidente
vice	vice
diversos	diversos
from	from
sim	sí
sociedade	society
sociedade	sociedad
império	imperio
episódio	episodio
batalha	batalla
seleção	selección
metros	metros
seed	seed
cidades	ciudades
americana	americana
encontra	encuentra
espaço	espacio
único	único
conjunto	conjunto
baixo	bajo
municipal	municipal
deus	dios
paris	paris
paris	parís
clubes	clubs
clubes	clubes
filmes	películas
professor	profesor
modelo	plantilla
modelo	modelo
diversas	diversas
alemão	alemán
administrativa	administrativa
musical	musical
meu	mío
meu	mi
somente	solamente
localizado	localizado
localizado	ubicado
localizado	situado
páginas	páginas
oeste	oeste
informações	información
informações	informaciones
chamada	llamada
ator	actor
popular	popular
novamente	nuevamente
estação	estación
última	última
luta	pelea
luta	lucha
disco	disco
estes	éstos
estes	estes
estes	estos
criado	creado
criado	criado
estende	extiende
francês	francés
especial	especial
algum	alguno
algum	algún
maiores	mayores
teatro	teatro
seis	seis
seis	seises
minha	mía
problemas	problemas
superior	superior
serviço	servicio
cinema	cine
deu	dio
disse	dijo
disse	dijiste
disse	dije
nossa	nuestra
participação	participación
membro	miembro
filhos	hijos
grupos	grupos
usado	usado
antigo	antiguo
resultado	resultado
atriz	actriz
existem	existen
estar	estar
estar	estarlo
meses	meses
momento	momento
iii	iii
antiga	antigua
instituto	instituto
autor	autor
chegou	llegó
forte	fuerte
única	única
amor	amor
terceiro	tercer
terceiro	tercero
espécies	especies
descoberto	descubierto
descoberto	destapado
alto	alto
termo	término
geralmente	generalmente
san	san
mulher	esposa
mulher	mujer
parece	parece
densidade	densidad
fica	queda
fica	quédate
fica	quedate
edições	ediciones
itália	italia
irmão	hermano
conteúdo	contenido
conteúdo	contenidos
causa	causa
elenco	reparto
elenco	casting
elenco	elenco
japão	japón
terceira	tercera
terceira	terceira
própria	propia
personagens	personajes
vista	vista
formação	formación
rua	calle
rua	callejero
apoio	apoyo
rádio	radio
favor	favor
frente	frente
torneio	torneo
organização	organizacion
organização	organización
museu	museo
educação	educación
tão	tan
histórico	histórico
histórico	historial
comum	común
peso	peso
alta	alta
informação	información
participou	participó
áreas	zonas
áreas	áreas
áreas	areas
homens	hombres
valor	valor
velocidade	velocidad
profissional	profesional
problema	problema
jovem	jovencito
forças	fuerzas
livre	libre
novos	nuevos
vivo	vivo
minas	minas
natural	natural
sete	siete
tenha	tenga
estudos	estudios
cantora	cantante
consenso	consenso
votos	votos
ganhou	ganó
criar	crear
parque	parque
castelo	castillo
representa	representa
tais	tales
próximo	próximo
próximo	siguiente
sentido	sentido
função	función
função	rol
editora	editora
etc	etc
etc	etcétera
nenhum	ningún
nenhum	ninguno
algo	algo
ambos	ambos
jorge	jorge
jornal	periódico
manuel	manuel
poderia	podria
poderia	podría
james	james
estadual	estatal
show	show
inglaterra	inglaterra
life	life
branco	blanco
acesso	acceso
fernando	fernando
posteriormente	posteriormente
york	york
conselho	consejo
guitarra	guitarra
roma	roma
verão	verano
manter	mantener
interior	interior
cargo	cargo
dar	dar
livros	libros
love	love
asteróide	asteroide
olímpicos	olímpicos
londres	londres
anterior	anterior
acho	supongo
acho	creo
fazendo	haciendo
importantes	importantes
evento	acontecimiento
evento	evento
companhia	compañia
companhia	compañía
united	united
capacidade	capacidad
novas	nuevas
governador	gobernador
noite	noche
energia	energía
casos	casos
contém	contiene
senhora	señora
aproximadamente	aproximadamente
aproximadamente	alrededor
nomes	nombres
ministro	ministro
simples	simple
simples	sencilla
simples	sencillo
fala	habla
luz	luz
horas	horas
unido	unido
imperador	tennō
imperador	emperador
competição	competición
príncipe	principe
príncipe	príncipe
william	william
civil	civil
serviços	servicios
vale	valle
vale	vale
ação	acción
ação	accion
nasceu	nació
escreveu	escribió
bastante	bastante
futebolista	futbolista
apresenta	presenta
paul	paul
michael	michael
escrito	escrito
controle	control
eleito	electo
vídeo	vídeo
vídeo	video
estavam	estaban
saúde	sanidad
saúde	salud
teria	tendría
teria	habría
produtor	productor
conseguiu	consiguió
conseguiu	logró
feita	hecha
atividade	actividad
fundação	fundación
faixa	franja
faixa	carril
faixa	pista
list	list
group	group
verdade	cierto
verdade	verdad
estas	estas
alguma	alguna
alguma	algo
criada	criada
criada	creada
melhores	mejores
menor	menor
internet	internet
decisão	decision
decisão	decisión
elas	ellas
estrutura	estructura
abaixo	debajo
abaixo	abajo
der	der
conde	conde
ajuda	ayuda
bandeira	bandera
ensino	enseño
ensino	enseñanza
report	report
inclinação	inclinación
inclinação	descentrado
coisa	cosa
music	music
escritor	escritor
falta	falta
entretanto	entretanto
ngc	ngc
pedido	petición
pedido	solicitud
morreu	murió
morreu	murio
semana	semana
pesquisa	investigación
pesquisa	búsqueda
excentricidade	excentricidad
teoria	teoría
méxico	méjico
méxico	méxico
méxico	mexico
jesus	jesús
jesus	jesus
robert	robert
locais	lugares
locais	locales
bloqueio	bloqueo
acabou	terminó
acabou	acabó
oliveira	oliveira
oliveira	olivo
black	black
top	top
madeira	madera
madeira	madeira
medalha	medalla
paulista	paulista
solo	suelo
trabalhos	trabajos
músicas	canciones
passa	pasa
mulheres	mujeres
questão	cuestión
campos	campos
esposa	esposa
demais	demasiados
demais	demasiado
cultural	cultural
alguém	alguien
wiki	wiki
verde	verde
luiz	luiz
destaque	destacados
destaque	destacar
destaque	destacado
eua	eeuu
pessoal	personal
sub	sub
técnico	técnico
nenhuma	ninguna
pequena	pequeña
direitos	derechos
with	with
eventos	eventos
eventos	acontecimientos
editor	redactor
editor	editor
usar	usar
usar	utilizar
houve	hubo
áfrica	africa
áfrica	áfrica
chefe	jefe
flora	flora
set	set
palácio	palacio
quer	quiere
quer	quieres
qualidade	calidad
referências	referencias
solid	solid
regras	normas
regras	reglas
metal	metal
orbital	orbital
regiões	regiones
proposta	propuesta
dizer	decir
mercado	mercado
aparece	aparece
referência	referencia
via	via
via	vía
ocupação	ocupación
voz	voz
títulos	títulos
canções	canciones
bateria	batería
empresas	empresas
records	records
letras	letras
george	george
feminino	femenino
padrão	estándar
padrão	patrón
padrão	predeterminado
dez	diez
dez	dez
miguel	miguel
resultados	resultados
responsável	responsable
tinham	hubieron
tinham	tenían
defesa	defensa
episódios	episodios
bar	bar
líder	lider
líder	líder
von	von
ilhas	islas
minutos	minutos
administração	administración
pequeno	pequeño
campanha	campaña
atividades	actividades
prefeito	prefecto
prefeito	alcalde
duque	duque
bgcolor	bgcolor
escrita	escrita
escrita	escritura
gravadora	discográfica
povo	pueblo
material	material
imagens	imagenes
imagens	imágenes
segurança	seguridad
especialmente	especialmente
situação	situacion
situação	situación
presença	presencia
jogadores	jugadores
nomeado	designado
nomeado	nominado
nomeado	nombrado
realizado	desembolsado
realizado	realizado
realizado	realizada
artista	artista
classificação	clasificación
cantor	cantor
cantor	cantante
essas	esas
pop	pop
global	global
eliminação	eliminación
seguida	seguida
ataque	ataque
papa	papa
missão	mision
missão	misión
elementos	elementos
emissora	emisora
visto	visado
visto	visto
visto	visa
raio	rayo
devem	deben
termos	términos
antónio	antonio
palavra	palabra
artes	artes
hora	hora
henrique	enrique
henrique	henrique
compositor	compositor
utilizado	utilizado
juntamente	juntamente
significa	significa
plano	plano
plano	plan
cabo	cabo
cabo	cable
left	left
voto	voto
economia	economía
curso	curso
baixa	baja
programas	programas
ferro	plancha
ferro	hierro
des	des
masculino	varón
masculino	masculino
armas	armas
deixar	dejar
deixar	dejarlo
álbuns	álbumes
comando	mando
comando	comando
produtos	productos
coisas	cosas
usa	utiliza
usa	usa
inicialmente	inicialmente
dado	dado
sistemas	sistemas
website	website
perto	cerca
marca	marca
deixou	dejó
nacionalidade	nacionalidad
volume	volumen
italiano	italiano
médio	medium
médio	mediano
estudo	estudio
faixas	pistas
faixas	vendas
fronteira	frontera
vem	ven
vem	viene
super	super
super	súper
ali	alí
ali	ali
relatório	reporte
relatório	informe
predefinição	predeterminada
predefinição	predefinido
predefinição	predeterminado
estrada	carretera
caminho	sendero
caminho	ruta
caminho	camino
serra	sierra
dirigido	dirigido
rainha	reina
faculdade	facultad
características	características
casamento	boda
casamento	casamiento
casamento	matrimonio
primeiras	primeras
usando	usando
usando	utilizando
formato	formato
relevância	relevancia
relevância	pertinencia
localiza	localiza
lima	lima
polícia	policía
unidade	unidad
levou	llevó
nascimento	natalidad
nascimento	nacimiento
nascimento	nacimientos
estreia	debut
estreia	estreno
romano	romano
states	states
assunto	asunto
assunto	tema
mês	mes
charles	charles
opinião	opinion
opinião	opinión
van	van
crianças	niños
claro	claro
quarto	cuarto
quarto	habitación
espírito	espíritu
saber	saber
jean	jean
sexo	sexo
baseado	basada
baseado	basado
artistas	artistas
carvalho	carvalho
carvalho	roble
espanhol	español
oito	ocho
lançou	lanzó
azul	azul
ocidental	occidental
diferente	diferente
diferente	distinta
diferente	distinto
species	species
ficar	quedarse
ficar	quedarnos
ficar	quedarte
ficar	quedarme
palavras	palabras
fundada	fundada
conhecimento	conocimientos
conhecimento	conocimiento
prata	plata
prata	plateado
academia	academia
digital	digital
city	city
usada	utilizada
usada	usada
paz	paz
animais	animales
animais	mascotas
voltou	regresó
voltou	volvió
eduardo	eduardo
ficheiro	fichero
amigo	amigo
alegre	alegres
alegre	alegre
iniciou	inició
ideia	idea
nascido	nacido
monte	monte
praia	playa
necessário	necesario
importância	importancia
rússia	rusia
natal	navidad
natal	navidades
pereira	pereira
últimos	últimos
eleições	elecciones
provavelmente	probablemente
romance	romance
romance	novela
entrou	entró
deveria	debería
deveria	deberías
deveria	debiera
britânico	británico
atenção	atención
atenção	atencion
começa	empieza
razão	razón
razão	razon
disputa	disputa
amigos	amigos
press	press
influência	influencia
distribuição	distribución
velho	viejo
municípios	municipios
políticas	políticas
senhor	señor
crítica	crítica
roberto	roberto
aumento	incremento
aumento	aumento
católica	católica
condições	condiciones
nice	niza
comunicação	comunicación
cabeça	cabeza
jardim	jardín
sabe	sabes
sabe	sabe
lançada	lanzada
estimada	estimada
web	web
ciências	ciencias
entrada	entrada
realizada	celebrada
tempos	tiempos
terras	tierras
tom	tono
tom	tom
independente	independiente
técnica	técnica
comercial	comercial
#aaa	#aaa
sol	sol
mestre	maestro
mestre	mestre
online	online
tipos	tipos
abertura	apertura
andré	andre
andré	andrés
andré	andré
critérios	criterios
bispo	alfil
bispo	obispo
all	all
prática	práctica
ministério	ministerio
inclusive	inclusive
ana	ana
contrário	contrario
contrário	revés
capitão	capitán
capitão	capitan
ambiente	medioambiente
ambiente	ambiente
futuro	futuro
unidades	unidades
física	física
aeroporto	aeropuerto
peter	peter
quantidade	cantidad
originalmente	originalmente
mandato	mandato
diagrama	diagrama
militares	militares
tamanho	talla
tamanho	tamaño
link	link
inclui	incluye
encontrar	encontrar
praça	plaza
conquistou	conquistó
normalmente	normalmente
terminou	terminó
bahia	bahía
bahia	bahia
estrela	estrella
finalmente	finalmente
richard	richard
justiça	justicia
cuja	cuya
atrás	detrás
americanos	estadounidenses
americanos	norteamericanos
americanos	americanos
produzido	producido
produzido	producida
indústria	industria
sociais	sociales
thomas	thomas
existência	existencia
xix	xix
mapa	mapa
conforme	conforme
mudou	cambió
italiana	italiana
possuem	poseen
massa	pasta
massa	pastas
massa	masa
domínio	dominio
recursos	recursos
tecnologia	tecnología
austrália	australia
som	sonido
som	som
talvez	quizás
talvez	quizá
man	man
nota	nota
comércio	comercio
comércio	comercios
autoridade	autoridad
estou	estoy
natureza	naturaleza
respeito	respeto
linhas	líneas
califórnia	california
prazo	plazo
deputado	diputado
ponte	puente
fundo	fondo
international	international
combate	combate
humanos	humanos
roteiro	guión
altitude	altitud
bureau	bureau
bureau	buró
cujo	cujo
passado	pasado
pais	padres
saint	saint
vizinhança	vecindad
literatura	literatura
treinador	entrenador
salvador	salvador
vermelho	rojo
nós	nudos
nós	nosotros
org	org
vol	vol
brasileiros	brasileños
brasileiros	brasileros
escolas	escuelas
seguir	seguir
estreou	debutó
https	https
tropas	tropas
trabalhar	trabajar
homenagem	homenaje
canadá	canadá
ciência	ciencia
revolução	revolución
engenharia	ingenieria
engenharia	ingeniería
fogo	fuego
naturais	naturales
oficiais	oficiales
daniel	daniel
ferreira	ferreira
funções	funciones
live	live
catarina	catalina
colocar	poner
comentários	comentarios
notoriedade	notoriedad
distância	distancia
tratado	tratado
ninguém	nadie
comissão	comisión
poucos	pocos
composta	compuesta
corte	corte
irmãos	hermanos
preto	negro
contrato	contrato
prêmios	premios
passar	pasar
realmente	realmente
transporte	transporte
transporte	transportación
one	one
dom	dom
motivo	motivo
tradução	traducción
federação	federacion
federação	federación
administrador	administrador
permite	permite
banco	banco
rosa	rosado
rosa	rosa
faço	hago
irmã	hermana
longa	larga
mudança	mudanza
mudança	cambio
regional	regional
crescimento	crecimiento
criou	creó
metade	mitad
religião	religión
trabalhou	trabajó
paraná	paraná
cristo	cristo
jornalista	periodista
análise	análisis
editores	editores
mensagem	mensaje
festa	fiesta
cena	escena
capela	capilla
médico	médico
ligação	acoplamiento
ligação	enlace
mim	mí
resposta	respuesta
comandante	comandante
categorias	categorías
edifício	edificio
pedra	piedra
planeta	planeta
comprimento	eslora
comprimento	longitud
índia	india
tiveram	tuvieron
jovens	jovenes
jovens	jóvenes
leão	león
projetos	proyectos
projetos	diseños
disc	disc
nordeste	noreste
nordeste	nordeste
versões	versiones
independência	independencia
tenho	tengo
operação	operación
tentativa	tentativa
tentativa	intento
esteve	estuvo
sei	sé
totalmente	totalmente
avenida	avenida
avenida	avda
avenida	bulevar
augusto	augusto
fazem	hacen
formado	formado
russo	ruso
veja	vea
liberdade	libertad
conceito	concepto
anteriores	anteriores
torre	torre
localização	ubicación
localização	emplazamiento
localização	localización
alexandre	alejandro
musicais	musicales
feira	feria
rodada	ronda
chegar	llegar
times	times
marinha	marina
marinha	armada
composto	compuesto
princesa	princesa
açores	azores
partidas	rotas
simplesmente	sencillamente
simplesmente	simplemente
ribeiro	ribeiro
ribeiro	arroyo
hospital	hospital
don	don
nações	naciones
histórias	historias
mão	mano
filosofia	filosofía
pertence	pertenece
efeito	efecto
www	www
antigos	antiguos
viagem	viaje
sousa	sousa
construído	construido
esquerda	izquierda
leandro	leandro
martin	martin
peças	partes
peças	piezas
peças	repuestos
castro	castro
seção	sección
europeia	europea
coração	corazón
ricardo	ricardo
tradicional	tradicional
sou	soy
ffffff	ffffff
american	american
colégio	colegio
guarda	guardia
motor	motor
desempenho	desempeño
desempenho	rendimiento
línguas	idiomas
línguas	lenguajes
línguas	lenguas
efeitos	efectos
reis	reyes
colspan	colspan
visão	visión
especiais	especiales
cores	colores
guilherme	guillermo
ajudar	ayudar
humano	humano
conflito	conflicto
dinheiro	dinero
dinheiro	efectivo
imprensa	prensa
dvd	dvd
tour	tour
finais	finales
inicial	inicial
rapidamente	rápidamente
fundado	fundado
porta	puerta
relacionados	relacionados
marco	marco
marco	hito
leva	lleva
oficialmente	oficialmente
that	that
superfície	superficie
ações	acciones
comentário	comentario
medida	medida
branca	blanca
jack	jack
national	national
oriental	oriental
decidiu	decidió
constituição	constitución
memória	memoria
biblioteca	biblioteca
medicina	medicina
precisa	precisa
precisa	necesitas
precisa	necesita
peça	pida
peça	pieza
vão	vayan
vão	vano
semanas	semanas
propriedade	propiedad
fundador	fundador
regra	regla
britânica	británica
tratamento	tratamiento
europeu	europeo
google	google
passando	pasando
rodrigues	rodrigues
obteve	obtuvo
perdeu	perdió
aberto	abierto
passagem	pasaje
passagem	pasadizo
novela	culebrón
novela	novela
falar	hablar
carta	carta
notas	billetes
notas	notas
dando	regalando
dando	dando
proteção	protección
alemã	alemana
sonora	sonora
carro	coche
carro	carro
carro	auto
max	máx
max	max
japonês	japonés
geração	generación
frequentemente	frecuentemente
necessidade	necesidad
fortaleza	fortaleza
solicitação	solicitación
solicitação	solicitud
internacionais	internacionales
conheço	conozco
bronze	bronce
romana	romana
áustria	austria
incluem	incluyen
descoberta	descubierta
descoberta	descubrimiento
rowspan	rowspan
satélite	satélite
satélite	satelite
satélite	satélites
svg	svg
participar	participar
botânico	botánico
miss	miss
nacionais	nacionales
mata	mata
imperial	imperial
vou	voy
gestão	gestión
marcos	hitos
marcos	marcos
luis	luis
lago	lago
dupla	dúo
dupla	doble
henry	henry
comédia	comedia
relevante	pertinente
relevante	relevante
pequenas	pequeñas
sala	sala
extensão	extensión
smith	smith
números	cifras
números	números
direita	derecha
isabel	isabel
formada	formada
anteriormente	previamente
anteriormente	anteriormente
completamente	completamente
candidato	candidato
morto	muerto
evitar	evitar
rocha	rocha
rocha	roca
objeto	objeto
king	king
madrid	madrid
alberto	alberto
continuou	continuó
difícil	difícil
césar	cesar
césar	césar
utilizada	utilizada
portugueses	portugueses
gomes	gomes
mudanças	mudanzas
mudanças	cambios
afonso	alfonso
fórmula	fórmula
experiência	experiencia
experiência	experimento
awards	awards
curta	corta
composição	composición
método	método
publicada	publicada
capaz	capaz
obrigado	gracias
semelhante	similar
expressão	expresión
templo	templo
tribunal	tribunal
escrever	escribir
escrever	escritura
encontram	encuentran
conhecidos	conocidos
famoso	famoso
lee	lee
soldados	soldados
quarta	miércoles
quarta	miercoles
quarta	cuarta
prefeitura	municipalidad
prefeitura	alcaldía
prefeitura	ayuntamiento
prefeitura	prefectura
continua	continúa
soviética	soviética
vencedor	ganador
estrelas	estrellas
famílias	familias
políticos	políticos
disponível	disponible
desenvolvido	desarrollado
programação	programación
bandas	bandas
eleição	elección
letra	letra
software	software
white	white
refere	refiere
database	database
tradição	tradición
pequenos	pequeños
grego	griego
decreto	decreto
flores	flores
star	star
encontrada	encontrada
autores	autores
rios	rios
rios	ríos
taxa	tasa
taxa	honorario
clara	clara
doença	enfermedad
entrar	entrar
valores	valores
quinta	jueves
quinta	quinta
navio	nave
navio	buque
navio	barco
nove	nueve
alex	álex
alex	alex
singles	singles
águas	aguas
passaram	pasaron
princípio	principio
suficiente	suficiente
washington	washington
comportamento	comportamiento
comportamento	comportamientos
comportamento	conducta
perfil	perfil
universo	universo
secretário	secretario
humana	humana
piloto	piloto
mãos	manos
descrita	descrita
meia	media
meia	calcetín
horizonte	horizonte
till	till
feitas	hechas
completo	completo
tentar	intentarlo
tentar	intentar
aconteceu	ocurrió
aconteceu	sucedió
próxima	próxima
tropical	tropical
tropical	tropicales
anunciou	anunció
contexto	contexto
corrida	carrera
linguagem	lenguaje
sangue	sangre
lucas	lucas
pena	lástima
pena	pena
image	image
park	park
matemática	matemáticas
matemática	matemática
regime	regimen
regime	régimen
universal	universal
particular	particular
diretamente	directamente
les	les
conquista	conquista
almeida	almeida
die	die
apareceu	apareció
integrantes	integrantes
caixa	cajero
caixa	caja
caixa	recuadro
caixa	casilla
moderna	moderna
alunos	alumnos
produto	producto
gol	gol
começaram	empezaron
começaram	comenzaron
atlético	atlético
marido	marido
marido	esposo
temos	tenemos
operações	operaciones
cópias	copias
temperatura	temperatura
bruno	bruno
plantas	plantas
plantas	planos
publicação	publicación
quadro	cuadro
quadro	pizarra
joseph	joseph
transmissão	transmisión
transmissão	transmision
acaba	termina
acaba	acaba
mínimo	mínima
mínimo	mínimo
suécia	suecia
sequência	secuencia
máximo	máximo
night	night
ataques	ataques
poeta	poeta
instituição	institución
participantes	participantes
reúne	reúne
individual	individual
inverno	invierno
walter	walter
desenho	dibujo
desenho	diseño
portal	portal
can	can
ambas	ambas
técnicas	técnicas
exposição	exposicion
exposição	exhibición
exposição	exposición
perda	pérdida
perda	decomiso
declaro	declaro
pintura	pintura
enciclopédia	enciclopedia
carioca	carioca
congresso	congreso
bibliografia	bibliografía
drama	drama
apresentou	presentó
this	this
brasília	brasilia
criança	niño
recentemente	recientemente
receber	recibir
modelos	modelos
modelos	plantillas
espacial	espaciales
espacial	espacial
séculos	siglos
fizeram	hicieron
apresentação	presentación
linear	lineal
comuns	comunes
bairros	barrios
links	links
mark	mark
marcelo	marcelo
prisão	cárcel
prisão	prisión
art	art
igual	igual
derrota	derrota
evolução	evolución
concurso	concurso
concurso	licitación
planta	planta
suíça	suiza
realidade	realidad
piano	piano
colocado	colocado
clima	clima
entrevista	entrevista
jones	jones
renda	encaje
renda	renta
normal	normal
administradores	administradores
construída	construida
gravação	grabación
file	file
segue	sigue
version	version
ascensão	subida
ascensão	ascensión
ascensão	ascenso
martins	martins
reinado	reinado
engenheiro	ingeniero
resto	resto
vandalismo	vandalismo
campeões	campeones
dizendo	diciendo
israel	israel
alves	alves
big	big
exemplos	ejemplos
baixos	bajos
júnior	júnior
júnior	junior
shows	shows
iria	iría
figura	figura
pressão	presión
aérea	aérea
escala	escala
cursos	cursos
chris	chris
mato	mato
poderes	poderes
grau	grado
erro	error
stadium	stadium
publicou	publicó
fifa	fifa
chega	suficiente
chega	llega
chega	basta
consiste	consiste
mudar	cambiar
billboard	billboard
library	library
your	your
house	house
tabela	tabla
complexo	complejo
textos	textos
arquitetura	arquitectura
chave	clave
chave	llave
muita	mucha
vinte	veintiuno
vinte	veinte
ponta	punta
iucn	iucn
marcou	marcó
barra	barra
barra	deslizador
manutenção	mantenimiento
louis	louis
começo	comienzo
frank	frank
joaquim	joaquim
joaquim	joaquín
fusão	fusión
out	out
und	und
saída	salida
gente	gente
realizou	realizó
realizou	celebró
mortos	muertos
duração	duración
samba	samba
parceria	asociación
mário	mario
best	best
assumiu	asumió
meados	mediados
navios	buques
ásia	asia
animal	animal
olímpico	olímpico
usados	usados
diferença	diferencia
aqueles	aquellos
aqueles	ésos
aqueles	esos
harry	harry
deixa	déjalo
deixa	deja
filipe	festival
filipe	filipo
profissionais	profesionales
encontro	encuentro
permaneceu	permaneció
coronel	coronel
velha	vieja
estudou	estudió
galáxia	galaxia
dança	baile
dança	baila
dança	danza
deixando	dejando
completa	completa
movimentos	movimientos
sinal	signo
sinal	señal
olhos	ojos
reforma	reforma
voltar	volver
voltar	regresar
solução	solución
processos	procesos
inferior	inferior
apresentado	presentado
contato	contacto
contato	contactar
escolha	elección
escolha	elija
escolha	escoja
críticas	críticas
diocese	diócesis
reais	reales
disney	disney
setor	sector
gabriel	gabriel
tenta	intenta
presentes	presentes
presentes	regalos
trono	trono
ben	ben
queda	caída
santiago	santiago
braga	braga
crise	crisis
obter	obtener
royal	royal
encontrado	encontrado
quinto	quinto
wilson	wilson
terá	tendrá
latina	latina
hall	hall
nosso	nuestro
record	record
biografia	bio
biografia	biografía
apagar	borrar
apagar	eliminar
apagar	borrado
química	química
casal	pareja
núcleo	núcleo
grécia	grecia
neto	neto
neto	nieto
podemos	podemos
espanhola	española
fazenda	granja
fazenda	hacienda
band	band
dólares	dólares
sérvia	serbia
ato	ato
ato	acto
serviu	sirvió
queria	quería
queria	querías
resistência	resistencia
acidente	accidente
debate	debate
indivíduos	individuos
conclusão	conclusión
próprios	propios
instituições	instituciones
torres	torres
haviam	habían
menores	menores
recife	recife
recife	arrecife
dada	dada
leis	leyes
décadas	decadas
décadas	décadas
barcelona	barcelona
surgiu	surgió
facto	facto
células	células
antigas	antiguas
game	game
apresentar	presentar
oscar	oscar
tenham	tengan
tenham	hayan
respectivamente	respectivamente
crime	crimen
crime	delito
hot	hot
possibilidade	posibilidad
grand	grand
infantaria	infantería
retorno	retorno
retorno	regreso
scott	scott
us$	us$
afirmou	afirmó
seriam	serian
seriam	serían
estudantes	estudiantes
pesquisas	búsquedas
ramos	ramos
ramos	ramas
machado	machado
machado	hachazo
machado	hacha
brown	brown
rodrigo	rodrigo
definição	definición
músico	músico
xvi	xvi
realização	realización
aquele	aquel
aquele	ése
rótulo	etiqueta
solar	solar
expansão	expansión
praticamente	prácticamente
praticamente	practicamente
ufc	ufc
fundamental	fundamental
serão	seran
serão	serán
chegada	llegada
chegada	arribo
segundos	segundos
estatuto	estatus
estatuto	estatuto
yanguas	yanguas
chile	chile
medalhas	medallas
sudeste	sureste
sudeste	sudeste
jackson	jackson
assuntos	asuntos
berlim	berlin
berlim	berlín
agricultura	agricultura
utilização	uso
utilização	utilización
souza	souza
questões	cuestiones
fotografia	fotografía
mesmos	mismos
concordo	coincido
concordo	concuerdo
dinastia	dinastía
gelo	hielo
coimbra	coimbra
fauna	fauna
materiais	materiales
franco	franco
atuais	actuales
alcançou	alcanzó
xviii	xviii
texas	texas
cenas	escenas
atuação	actuación
chamados	llamados
disputou	disputó
west	west
vendas	ventas
martinez	martinez
martinez	martínez
símbolo	símbolo
tony	tony
fãs	fans
fãs	fanáticos
fãs	admiradores
rafael	rafael
oceano	océano
negócios	negocios
joe	joe
posse	posesion
posse	posesión
destino	destino
destino	destinación
publico	publico
produzida	producida
coroa	coronas
coroa	corona
formou	formó
introdução	introducción
motivos	motivos
artística	artística
artística	artistica
consultado	consultado
aldeia	aldea
coleção	colección
terem	hubieren
day	day
localidade	localidad
turno	turno
ceará	ceará
catedral	catedral
exterior	exterior
infantil	infantil
acontece	ocurre
acontece	sucede
mídia	multimedia
mídia	medios
grosso	grueso
grosso	grosso
flor	flor
lopes	lopes
christian	christian
troca	trueque
troca	intercambio
ficção	ficción
mike	mike
risco	riesgo
juntos	juntos
jogar	jugar
reconhecimento	reconocimiento
afirma	afirma
oposição	oposición
heritage	heritage
clássico	clásica
clássico	clásico
fácil	fácil
passo	paso
fortes	fuertes
fortes	fortalezas
felipe	felipe
noroeste	noroeste
vontade	voluntad
honra	honor
honra	honra
romanos	romanos
vicente	vicente
orchidaceae	orchidaceae
oriente	oriente
avaliação	valoración
avaliação	evaluación
barão	barón
chicago	chicago
zero	cero
zero	zero
tentou	intentó
tentou	tentó
tentou	trató
conhecer	conocer
níveis	niveles
topo	cima
topo	arriba
manteve	mantuvo
pernambuco	pernambuco
populares	populares
advogado	abogado
orquestra	orquesta
america	america
ruas	calles
histórica	histórica
threatened	threatened
viver	vivir
faleceu	falleció
anti	anti
carnaval	carnaval
estações	estaciones
veículos	vehículos
are	are
ganhar	ganar
erros	errores
condição	condición
gama	gama
gama	gamma
chama	llama
sérgio	sergio
egito	egipto
continental	continental
vocalista	vocalista
brian	brian
indicado	indicado
saiu	salió
saiu	salio
executivo	ejecutiva
executivo	ejecutivo
argumento	argumento
argumento	guión
enviado	enviado
comerciais	comerciales
editar	editar
capa	portada
capa	carátula
atacante	agresor
atacante	atacante
atacante	delantero
arquipélago	archipiélago
públicos	públicos
peru	perú
peru	pavo
peru	peru
steve	steve
prorrogada	prorrogada
competições	competiciones
procura	busca
procura	demanda
podendo	pudiendo
cavaleiro	caballero
cavaleiro	jinete
quilômetros	kilómetros
quilômetros	kilometros
diário	diario
voo	vuelo
horário	horario
chegando	llegando
plataforma	andén
plataforma	plataforma
ciclo	ciclo
ciclo	bucle
séries	series
cumpre	cumple
serve	sirve
sobretudo	sobretodo
etapa	etapa
ncbi	ncbi
árabe	árabe
aplicação	aplicación
senado	senado
golpe	estafa
parlamento	parlamento
povos	pueblos
indicações	indicaciones
dito	dicho
constante	constante
atingir	alcances
notícias	noticias
jogou	jugó
igrejas	iglesias
turismo	turismo
cobertura	cobertura
enorme	enorme
pierre	pierre
geografia	geografía
mtv	mtv
continuar	continuar
continuar	seguir
europaea	europaea
trabalhadores	trabajadores
pintor	pintor
poesia	poesía
floresta	bosque
gostaria	quisiera
eric	eric
lua	luna
referir	referir
referir	referirse
arthur	arthur
disciplina	disciplina
recorde	récord
facility	facility
utilizados	utilizados
young	young
vitórias	triunfos
vitórias	victorias
árvore	árbol
árvore	arbol
invasão	invasión
invasão	allanamiento
mary	mary
fox	fox
computador	ordenador
computador	computadora
socorro	socorro
socorro	auxilio
casado	casado
preciso	necesito
preciso	preciso
intitulado	titulado
pinto	pinto
sofreu	sufrió
fotos	fotos
vermelha	roja
relativamente	relativamente
construir	construir
bento	benedicto
bento	bento
península	península
aspectos	aspectos
fazia	hacía
poucas	pocas
juventude	juventud
propriedades	propiedades
café	cafetería
café	cafe
café	café
físico	físico
irlanda	irlanda
elemento	elemento
metropolitana	metropolitana
pro	pro
deputados	diputados
deputados	parlamentarios
imediatamente	inmediatamente
territórios	territorios
acredita	cree
venda	venda
venda	venta
juiz	juez
vejo	veo
matéria	materia
asteróides	asteroides
face	face
planos	planos
planos	planes
presidência	presidencia
infância	niñez
infância	infancia
williams	williams
per	per
arquivo	archivo
corrente	cadena
corrente	corriente
curitiba	curitiba
edward	edward
title	title
melhorar	mejorar
determinado	determinado
residência	residencia
fabiano	fabiano
sair	salir
cristã	cristiana
imdb	imdb
aparentemente	aparentemente
posições	posiciones
discos	discos
verdadeiro	verdadero
victor	victor
boca	boca
independentes	independientes
teste	prueba
teste	test
designação	designación
santana	santana
not	not
bola	bola
bola	balón
bola	pelota
line	line
seguindo	siguiendo
seguindo	partidarias
culturais	culturales
levando	llevando
bob	bob
organizações	organizaciones
extremamente	extremadamente
extremamente	grandemente
reserva	reservación
reserva	reserva
alexander	alexander
ideias	ideas
arco	arco
interpretação	interpretacion
interpretação	interpretación
autoria	autoría
blue	blue
preso	atascado
preso	arrestado
distritos	distritos
entertainment	entertainment
limite	limite
limite	límite
órgão	organo
órgão	órgano
alemães	alemanes
matriz	matriz
colocação	colocación
empresário	empresario
viu	viste
viu	vio
viu	vió
frase	frase
urbana	urbana
anual	anual
carolina	carolina
sexta	sexta
sexta	viernes
detalhes	detalles
oxford	oxford
ocasião	ocasión
produzir	producir
london	london
eliminado	eliminado
girl	girl
críticos	críticos
princípios	principios
vasco	vasco
passageiros	pasajeros
performance	performance
par	par
guitarrista	guitarrista
bélgica	bélgica
bélgica	belgica
agência	agencia
back	back
pico	pico
equipamentos	equipos
famosa	famosa
desenvolver	desarrollar
latim	latin
latim	latín
leite	leche
recente	reciente
what	what
sucessor	sucesor
senador	senador
angola	angola
alterações	enmiendas
dinamarca	dinamarca
divulgação	difusión
divulgação	divulgación
will	will
bill	bill
uns	unos
doze	doze
doze	doce
arma	arma
servidor	servidor
viveu	vivió
south	south
custo	coste
custo	costo
intenção	intención
peixe	pescado
peixe	pez
peixe	pescados
substituído	sustituido
substituído	substituido
substituído	reemplazado
russa	rusa
temporadas	temporadas
existentes	existentes
margem	margen
exceto	excepto
meias	medias
meias	calcetines
execução	ejecución
fluminense	fluminense
representante	representante
sudoeste	sudoeste
sudoeste	suroeste
palco	escenario
religiosa	religiosa
estruturas	estructuras
estruturas	armazones
apresentam	presentan
músicos	músicos
doce	dulce
paraíba	paraíba
ferramentas	herramientas
gonçalves	gonçalves
florestas	bosques
alvo	objetivo
guerras	guerras
aliança	alianza
fernandes	fernandes
céu	cielo
mendes	mendes
hotel	hotel
contou	contó
breve	breve
right	right
milhares	miles
milhares	millares
descrição	descripción
especificamente	específicamente
documentos	documentos
folhas	hojas
soares	soares
embaixada	embajada
declarou	declaró
nuclear	nuclear
nuclear	nucleares
frederico	federico
bretanha	bretaña
nação	nación
agente	oficial
agente	agente
domingo	domingo
sexual	sexual
escolhido	escogido
escolhido	elegido
considerados	considerados
tivesse	hubiese
tivesse	tuviera
tivesse	hubiera
rápido	rápido
rápido	rapido
rápido	rápida
posso	puedo
warp	warp
índice	índice
campeã	campeona
tradicionais	tradicionales
constelação	constelación
poderiam	podrían
poderiam	podrian
nelson	nelson
criador	creador
naval	naval
service	service
argumentos	alegaciones
argumentos	argumentos
similar	similar
high	high
promoção	promocion
promoção	promoción
chegaram	llegaron
alpes	alpes
identidade	identidad
artístico	artístico
europeus	europeos
johnson	johnson
anexo	anexo
característica	característica
linecolor	linecolor
rica	rica
representação	representación
insetos	insectos
insetos	bichos
judeus	judios
judeus	judíos
atlântico	atlántico
ficaram	quedaron
caráter	carácter
conhecidas	conocidas
testes	pruebas
variedade	variedad
realizadas	realizadas
state	state
propaganda	propaganda
contas	cuentas
cruzeiro	crucero
sport	sport
taylor	taylor
possivelmente	posiblemente
votar	votar
próprias	propias
descobre	descubre
descobre	averigua
anunciado	anunciado
medidas	medidas
mantém	mantiene
suporte	soporte
cartas	cartas
cartas	naipes
gás	gas
fundou	fundó
vieira	vieira
leitura	lectura
leitura	lecturas
recebido	recibida
recebido	recibido
possuía	poseía
recém	recien
recém	recién
galeria	galería
colônia	colonia
nobre	noble
vamos	vámonos
vamos	vamos
encontrados	encontrados
decide	decide
long	long
expedição	expedición
expedição	envío
vindo	venido
vindo	viniendo
esperança	esperanza
indica	indica
circuito	circuito
audiência	audiencia
astronomia	astronomía
missões	misiones
semi	semi
alma	alma
particularmente	particularmente
opção	opción
opção	opcion
titular	titular
melo	melo
revolta	revuelta
pará	pará
significado	significación
significado	significado
sam	sam
leonardo	leonardo
discussões	discusiones
flávio	flavio
street	street
arquivos	archivos
máquina	máquina
aberta	abierta
fossem	fuesen
fossem	fueran
mosteiro	monasterio
profissão	oficio
profissão	profesión
atletas	deportistas
atletas	atletas
órbita	órbita
órbita	orbita
limites	límites
cara	costosa
cara	cara
critério	criterio
exploração	exploración
exploração	explotación
desenvolveu	desarrolló
atores	actores
unidas	unidas
jornais	diarios
jornais	periódicos
kim	kim
telenovela	telenovela
telenovela	culebrón
perder	perder
potencial	potencial
legal	legal
canto	canto
canto	rincón
canto	esquina
roger	roger
diâmetro	diámetro
entra	entra
andrade	andrade
econômico	económicos
econômico	económico
econômico	económica
rui	rui
capítulo	capitulo
capítulo	capítulo
mineiro	minero
dúvida	duda
métodos	métodos
elétrica	eléctrica
defender	defender
goiás	goiás
entidade	entidad
dicionário	diccionario
originais	documentos
originais	original
originais	originales
php	php
líderes	dirigentes
líderes	líderes
pessoais	personales
jazz	jazz
little	little
batista	bautista
batista	batista
png	png
trecho	tramo
trecho	fragmento
seres	seres
urbano	urbano
pele	piel
podia	podía
reunião	reunión
colômbia	colombia
was	was
joga	juega
miranda	miranda
society	society
dividida	dividida
estando	estando
frequência	frecuencia
quadrinhos	historietas
quadrinhos	historieta
quadrinhos	cómic
quadrinhos	comics
quadrinhos	cómics
pensamento	pensamiento
mail	mail
revistas	revistas
tenente	teniente
paróquia	parroquia
noruega	noruega
indicação	indicación
parada	parada
power	power
paula	paula
montanha	montaña
escócia	escocia
historiador	historiador
war	war
quero	quiero
aparição	aparición
montanhas	montañas
chico	chico
aumentar	aumentar
colaboração	colaboración
adaptação	adaptarse
adaptação	adaptación
comunidades	comunidades
transformada	transformado
transformada	transformada
denominação	denominación
ordens	órdenes
ordens	ordenes
major	major
fiz	hice
conflitos	conflictos
ácido	acido
ácido	ácido
hugo	hugo
impacto	impacto
carros	coches
carros	autos
acacia	acacia
sebastião	sebastian
sebastião	sebastián
gêneros	géneros
extra	extra
máxima	máxima
mistura	mezcla
usadas	usadas
posterior	posterior
herói	heroe
herói	héroe
recentes	recientes
exibida	exhibida
igualmente	igualmente
províncias	provincias
frota	flota
possuir	poseer
inimigos	enemigos
home	home
xvii	xvii
diga	diga
continente	continente
punk	punky
punk	punk
anthony	anthony
centros	centros
lógica	lógica
dona	dona
dona	dueña
dona	doña
anderson	anderson
personalidade	personalidad
representantes	representantes
notável	notable
aniversário	cumpleaños
aniversário	aniversario
hungria	hungría
campeonatos	campeonatos
começar	comenzar
começar	empezar
edifícios	edificios
doutor	doctor
pedir	pedir
matar	matar
moderno	moderno
grega	griega
liderança	liderazgo
lança	lanza
troféu	trofeo
faria	haría
convidado	invitado
convidado	huésped
hill	hill
mesa	mesa
revisão	revisión
revisão	repaso
inimigo	enemigo
aquela	aquella
aquela	ésa
citação	cita
citação	citación
elevado	elevado
conceição	concepción
simon	simon
cristãos	cristianos
aves	aves
fábrica	fábrica
stone	stone
escritos	escritos
flag	flag
assistente	asistente
assistente	ayudante
existir	existir
flamengo	flamenco
silveira	silveira
contendo	conteniendo
âmbito	ámbito
boy	boy
litoral	litoral
litoral	costa
green	green
chinês	chino
proprietário	propietario
trabalha	trabaja
cunha	cuña
cunha	cunha
razões	razones
acredito	creo
facilmente	fácilmente
aviso	aviso
doenças	enfermedades
competiu	compitió
ray	ray
participações	participaciones
bloqueado	bloqueado
remix	remix
visual	visual
fama	fama
conferência	conferencia
oferece	ofrece
autoridades	autoridades
seguido	seguido
útil	útil
coluna	columna
teixeira	teixeira
disputada	disputada
indo	yendo
aliados	aliados
exatamente	exactamente
vii	vii
dificuldades	dificultades
comunista	comunista
reação	reacción
protagonista	protagonista
fatos	trajes
fatos	hechos
regular	regular
disponíveis	disponibles
tempestade	tormenta
tempestade	tempestad
pedidos	peticiones
pedidos	solicitudes
interna	interna
estrangeiros	extranjeros
oportunidade	oportunidad
folha	hoja
bernardo	bernardo
series	series
gravou	grabó
atleta	deportista
atleta	atleta
criados	criados
criados	creados
teresa	teresa
terminal	terminal
medo	temor
medo	miedo
domingos	domingos
latino	latino
alice	alicia
alice	alice
classificado	clasificado
hollywood	hollywood
uruguai	uruguay
anime	anime
veículo	vehículo
veículo	vehiculo
desejo	deseo
livres	libres
assinou	firmó
eventualmente	eventualmente
eventualmente	eventual
onda	ola
onda	onda
inaugurado	inaugurado
derrotado	derrotado
professores	profesores
professores	maestros
tentando	intentándolo
tentando	intentando
tentando	tratando
seguiu	siguió
who	who
documentário	documental
ciclista	ciclista
garcia	garcia
garcia	garcía
canadense	canadiense
pediu	pidió
terreno	terrenos
terreno	terreno
animação	animación
guia	guía
estaduais	estatales
caça	caza
arcebispo	arzobispo
violência	violencia
dan	dan
contribuições	contribuciones
verdadeira	verdadera
órgãos	órganos
venezuela	venezuela
curto	corto
corinthians	corinthians
estudar	estudiar
moradores	residentes
loja	tienda
formando	formando
formando	formándose
sbt	sbt
resolução	resolución
diferenças	diferencias
eurovisão	eurovisión
eurovisão	eurovision
apelido	apellidos
apelido	apodo
duplas	dobles
ave	ave
responsabilidade	responsabilidad
avião	avion
avião	avión
brasileiras	brasileñas
sinais	señales
sinais	signos
equivalente	equivalente
conhece	conoces
conhece	conoce
comigo	conmigo
licença	licencia
aparecem	aparecen
mix	mix
cardoso	cardoso
dividido	dividida
dividido	dividido
beleza	belleza
pictures	pictures
pés	pies
air	air
pacífico	pacífico
pacífico	pacifico
relacionamento	relación
tópico	tópico
name	name
part	part
encontrou	encontró
alan	alan
bizantino	bizantino
festas	fiestas
rtp	rtp
barbosa	barbosa
lojas	tiendas
figuras	figuras
like	like
albert	albert
tio	tio
tio	tío
atualizado	actualizado
belém	belén
belém	belém
foto	foto
tocar	tocar
coelho	conejos
coelho	conejo
proteger	proteger
possam	podáis
criando	creando
errado	erróneo
errado	equivocado
errado	mal
errado	incorrecto
cardeal	cardenal
bens	bienes
braço	brazo
bloco	bloque
reconhecido	reconocido
beira	beira
junta	ensambla
junta	junta
religioso	religioso
use	use
way	way
notáveis	notables
viena	viena
first	first
clássica	clásica
ópera	ópera
possíveis	posibles
marie	marie
salão	salón
bragança	braganza
vaga	vacante
vaga	vaga
situações	situaciones
volumes	volúmenes
france	france
voleibol	voleibol
legislação	legislación
unânime	unánime
semelhantes	similares
chaves	llaves
chaves	claves
peço	pido
peço	solicito
exceção	excepción
direto	directo
darwin	darwin
end	end
mateus	mateo
bela	bela
consumo	consumición
consumo	consumo
listas	listas
tim	tim
motores	motores
portas	puertas
magnitude	magnitud
canais	canales
campinas	campinas
propósito	proposito
camisa	remera
camisa	camisa
iniciativa	iniciativa
north	north
últimas	últimas
redução	reducción
funcionamento	funcionamiento
helena	helena
helena	elena
enredo	trama
cônjuge	cónyuge
cavalo	caballo
tiro	quito
tiro	tiro
tiro	disparo
guimarães	guimarães
chamou	llamó
pior	peor
goleiro	portero
prima	prima
contos	cuentos
trinta	treinta
trinta	trinta
mensagens	mensajes
mensagens	mensajería
atos	actos
last	last
hans	hans
rita	rita
jim	jim
mesmas	mismas
death	death
maranhão	maranhão
trabalhando	trabajando
marquês	marqués
publicações	publicaciones
ranking	ranking
índios	indios
catálogo	catálogo
civis	civiles
proponente	proponente
playstation	playstation
barros	barros
tribo	tribu
alimentos	alimentos
escravos	esclavos
castela	castilla
sites	sitios
corpos	cadáveres
corpos	cuerpos
candidatos	candidatos
esteja	esté
dono	dueño
milhão	millón
milhão	millon
finalização	finalización
concerto	concierto
existente	existente
vento	viento
skin	skin
resolver	resolver
resolver	solucionar
viria	vendría
turquia	turquía
ferramenta	herramienta
ferramenta	instrumento
momentos	momentos
menino	niño
promovido	ascendido
promovido	promocionado
promovido	promovido
assassinato	asesinato
altos	altos
vendeu	vendió
grave	grave
lewis	lewis
traz	trae
fatores	factores
convento	convento
permanente	permanente
instalação	instalación
karl	karl
socialista	socialista
argentino	argentino
estamos	estamos
exclusivamente	exclusivamente
anna	anna
carl	cari
carl	carl
estabeleceu	estableció
status	status
status	estatus
retirada	retirada
interessante	interesante
mor	mor
davis	davis
lagoa	estanque
lagoa	lagoa
lagoa	laguna
zonas	zonas
relacionadas	relacionadas
contratado	contratado
lados	lados
association	association
padrões	estándares
padrões	predeterminados
padrões	patrones
galáxias	galaxias
secção	sección
moths	moths
representou	representó
crítico	crítico
enciclopédico	enciclopédico
marques	marques
brasão	blasón
rugby	rugby
preta	negra
representando	representando
ajudou	ayudó
regionais	regionales
responsáveis	responsables
jan	jan
college	college
amarelo	amarillo
metro	metro
guiné	guinea
considerando	considerando
mister	mister
interpretada	interpretada
nascida	nacida
aux	aux
descendentes	descendientes
inc	inc
cidadãos	ciudadanos
salvar	salvar
gravações	grabaciones
árbitro	arbitro
árbitro	árbitro
árbitro	referí
duarte	duarte
cadeia	cadena
orientação	orientación
nuno	nuno
adam	adam
hits	hits
opções	opciones
gustavo	gustavo
sir	sir
funcionários	funcionarios
checa	checa
pib	pib
trouxe	trajo
documento	documento
comitê	comité
bacia	cuenca
produziu	produjo
paraguai	paraguay
margens	márgenes
ausência	ausencia
destruição	destrucción
douglas	douglas
colocou	colocó
permitindo	permitiendo
ativo	activo
country	country
usam	usan
casada	casada
abreu	abreu
descrito	descripto
descrito	descrito
próximos	próximos
cria	crea
salto	salto
tela	pantalla
tela	lienzo
raça	raza
interpretou	interpretó
bilhões	billones
habilidades	habilidades
contar	contar
papéis	papeles
papéis	roles
cambridge	cambridge
carne	carne
propostas	propuestas
baixas	bajas
direta	directa
lord	lord
marcada	marcada
tag	tag
medieval	medieval
perdido	perdido
participaram	participaron
servir	servir
lutar	luchar
indígenas	indígenas
palmeiras	palmeras
potência	potencia
imigrantes	inmigrantes
espada	espada
lançados	lanzados
funciona	funciona
opera	opera
vertical	vertical
árvores	arboles
árvores	árboles
usou	usó
sonho	sueño
tido	tenido
assinatura	firma
certeza	certeza
organizado	organizado
metrô	metro
alternativa	alternativo
alternativa	alternativas
alternativa	alternativa
xavier	xavier
exibição	exhibición
two	two
men	men
habitats	hábitats
treinamento	entrenamiento
treinamento	capacitación
wwe	wwe
lateral	lateral
mitologia	mitología
renato	renato
publicados	publicados
necessária	necesaria
kevin	kevin
deveriam	deberian
deveriam	deberían
deveriam	debieran
individuais	individuales
elite	élite
elite	elite
jong	jong
emprego	empleo
mostrou	mostró
mostrou	demostró
maia	maia
maia	maya
maia	mayas
vendido	vendido
divisões	divisiones
recepção	recepción
ambiental	medioambiental
ambiental	ambiental
open	open
aviões	aviones
zelândia	zelandia
zelândia	zelanda
largura	anchura
largura	ancho
bruce	bruce
componentes	componentes
cemitério	cementerio
gonçalo	gonzalo
consequência	consecuencia
inicia	inicia
centenas	cientos
centenas	centenares
monteiro	monteiro
petróleo	petróleo
permitir	permitir
paixão	pasión
juvenil	juvenil
humanidade	humanidad
song	song
lady	lady
aeronaves	aeronaves
atuar	actuar
basta	basta
assumir	asumir
gosto	gusto
island	island
citado	citado
correio	correo
superiores	superiores
orçamento	presupuesto
específico	específico
concentração	concentración
cup	cup
salas	salas
campus	campus
pinheiro	pinheiro
pinheiro	pino
caiu	cayó
mente	miente
mente	mente
botafogo	botafogo
artilharia	artillería
transferência	transferencia
transferência	traslado
viva	viva
associado	asociado
boston	boston
externa	externa
permitiu	permitió
abrir	abrir
extinta	extinta
extinta	extinguida
intervenção	intervención
heart	heart
missouri	misuri
missouri	missouri
incluir	incluir
altas	altas
famosos	famosos
mecânica	mecánica
arquiteto	arquitecto
fluxo	flujo
kelly	kelly
esforço	esfuerzo
vocês	ustedes
vocês	vosotros
termina	finaliza
indivíduo	individuo
passos	pasos
sexto	sexto
produtores	productores
influências	influencias
vizinhos	vecinos
atenas	atenas
integração	integración
names	names
vargas	vargas
transportes	transportes
crimes	crímenes
crimes	crimenes
crimes	delitos
nocaute	nocaut
cresceu	creció
alcançar	alcanzar
confederação	confederación
décimo	décima
décimo	décimo
pouca	poca
mundiais	mundiales
gil	gil
down	down
discurso	discurso
colonial	colonial
telefone	teléfono
paredes	paredes
latm	latm
conservação	conservación
conheceu	conoció
ameaça	amenaza
bíblia	biblia
pergunta	pregunta
tese	tesis
declaração	declaración
primo	primo
holanda	holanda
lenda	leyenda
vítimas	victimas
vítimas	víctimas
ideal	ideal
chamadas	llamadas
gravada	grabada
aventura	aventura
pedras	piedras
araújo	araújo
plant	plant
desenhos	dibujos
disputado	disputado
sucessão	sucesión
download	descarga
download	descargar
aparência	aspecto
aparência	apariencia
comunas	comunas
apresentações	presentaciones
garden	garden
observação	observación
enfrentar	enfrentar
excelente	excelente
descobrir	descubrir
descobrir	averiguar
descobrir	averiguarlo
deuses	dioses
lagos	lagos
grão	grano
valign	valign
johnny	jhonny
johnny	johny
johnny	johnny
nick	nick
definido	definido
confiança	confianza
habilidade	habilidades
habilidade	habilidad
habilidade	destreza
árabes	arabes
árabes	árabes
elevada	elevada
bot	bot
sai	sai
sai	sale
constituem	constituyen
ginástica	gimnasia
sugestões	sugerencias
his	his
blog	blog
açúcar	azúcar
angra	angra
laboratório	laboratorio
enviou	envió
fases	etapas
fases	fases
jerusalém	jerusalén
moda	moda
lançar	lanzar
doutrina	doctrina
samuel	samuel
determinada	determinada
eixo	eje
inteligência	inteligencia
space	space
escritores	escritores
carregado	cargado
notícia	noticia
ford	ford
claramente	claramente
good	good
olho	ojo
ocorrido	acaecido
ocorrido	ocurrido
jacques	jacques
blues	blues
dificuldade	dificultad
costas	espalda
costas	dorso
costas	costas
opiniões	opiniones
lats	lats
instalações	instalaciones
objetivos	metas
objetivos	objetivos
ligado	encendido
ligado	conectado
alfredo	alfredo
passam	pasan
apresentada	presentada
parcial	parcial
aplicações	aplicaciones
graça	gracia
inteiro	entero
descreve	describe
descobriu	descubrió
protegida	protegida
stephen	stephen
marcas	marcas
cuba	cuba
tarefa	tarea
corresponde	corresponde
belas	bellas
círculo	circunferencia
círculo	círculo
círculo	redondo
círculo	circulo
restantes	restantes
alcance	alcance
utilizadas	utilizadas
universitário	universitario
consciência	consciencia
consciência	conciencia
participa	participa
preço	precio
viii	viii
caminhos	caminos
dedicado	dedicado
universidades	universidades
shopping	shopping
news	news
tavares	tavares
constitucional	constitucional
bases	bases
andrew	andrew
story	story
vivem	viven
empate	empate
ginásio	gimnasio
font	font
facebook	facebook
areia	arena
períodos	periodos
períodos	períodos
jason	jason
aprovação	aprobación
inaugurada	inaugurada
estrelado	estrellado
teclado	teclado
cavalaria	caballería
tomada	tomada
tomada	enchufe
aceita	acepta
aceita	aceptada
extinção	extinción
lobo	lobo
patrick	patrick
abriu	abrió
dead	dead
vídeos	vídeos
vídeos	videos
armadas	armadas
convenção	convención
colocada	colocada
regimento	regimiento
perdendo	perdiendo
espaços	espacios
editorial	editorial
garota	chica
xiii	xiii
culto	culto
democracia	democracia
billy	billy
moral	moral
microrregião	microrregión
legislativa	legislativa
organizada	organizada
retirar	retirarse
retirar	retirar
flórida	florida
get	get
calor	calor
provável	probable
atletismo	atletismo
irmãs	hermanas
fiáveis	fiables
constantinopla	constantinopla
vítima	víctima
vítima	victima
pede	pide
mantido	mantenido
dirigiu	dirigió
nunes	nunes
studios	studios
polónia	polonia
liberal	liberal
lourenço	lorenzo
mérito	merito
mérito	mérito
rival	rival
interno	interno
práticas	prácticas
depressão	depresión
americanas	americanas
caetano	caetano
moreira	moreira
produzidos	producidos
compra	compra
computadores	informática
computadores	computadoras
computadores	ordenadores
leve	ligera
leve	ligero
conceitos	conceptos
dark	dark
alteração	enmienda
alteração	modificación
designada	designada
nintendo	nintendo
shortsummary	shortsummary
artilheiro	artillero
raimundo	raimundo
representar	representar
rota	rota
elizabeth	elizabeth
certos	ciertos
microsoft	microsoft
sun	sun
cristianismo	cristiandad
cristianismo	cristianismo
aparecer	aparecer
desambiguação	desambiguación
uefa	uefa
revela	revela
revela	desvela
ruy	ruy
pensar	pensar
revelou	reveló
foco	centrarse
foco	enfoque
foco	foco
sucessos	exitos
sucessos	éxitos
molecular	moleculares
molecular	molecular
dimensões	dimensiones
warner	warner
year	year
auxiliar	auxiliar
estudante	estudiante
amizade	amistad
gaúcho	gaucho
amiga	amiga
giovanni	giovanni
mostrando	mostrando
descendência	descendencia
descendência	progenie
vantagem	ventaja
peixes	piscis
peixes	peces
cláudio	claudio
goethe	goethe
médicos	médicos
médicos	doctores
médicos	médico
sanderson	sanderson
disputar	disputar
modalidade	modalidad
modalidade	modo
transição	transición
muda	cambia
terror	terror
cri	cri
durou	duró
eleitos	electos
eleitos	elegidos
poemas	poemas
baterista	baterista
jimmy	jimmy
religiosas	religiosas
bad	bad
net	net
river	river
fundadores	fundadores
clark	clark
conquistar	conquistar
fui	fui
experiências	experimentos
experiências	experiencias
apresentando	presentando
privada	privada
moeda	moneda
moeda	divisa
visconde	vizconde
interpretado	interpretado
rose	rose
dependendo	dependiendo
cavaleiros	caballeros
cavaleiros	jinetes
envolvendo	implicando
envolvendo	involucrando
envolvendo	envolviendo
paranaense	paranaense
posteriores	posteriores
crescente	creciente
conseguiram	lograron
conseguiram	consiguieron
conseguiram	obtuvieron
atitude	actitud
feliz	feliz
síria	siria
roupas	ropas
primavera	primavera
surge	surge
vitor	víctor
vitor	viktor
popularidade	renombre
popularidade	popularidad
dave	dave
xii	xii
variação	variación
porte	porte
ribeirão	ribeirão
azevedo	azevedo
meus	mis
meus	míos
assistência	asistencia
democrática	democrática
dúvidas	dudas
altamente	altamente
book	book
spam	spam
calendário	calendario
origens	orígenes
esforços	esfuerzos
contribuição	contribución
decisões	decisiones
aulas	clases
baby	baby
juntou	unió
charlie	charlie
marvel	marvel
definir	definir
definir	establecer
ocorrem	ocurren
jogando	jugando
equador	ecuador
olímpica	olímpica
network	network
chance	chance
subsp	subsp
terrestre	terrícola
terrestre	terrestre
contemporânea	contemporánea
técnicos	técnicos
encontradas	encontradas
page	page
miller	miller
libertadores	libertadores
libertadores	liberadores
teorias	teorías
julgamento	juicio
games	games
sessão	sesión
toronto	toronto
assis	asís
cristão	cristiano
manoel	manoel
mantendo	manteniendo
columbia	columbia
falando	hablando
heróis	héroes
onze	onze
onze	once
off	off
estratégia	estrategia
aceitar	aceptar
britânicos	británicos
campanhas	campañas
modernos	modernos
kong	kong
idéia	idea
eletrônica	electrónica
fortemente	fuertemente
light	light
religiosos	religiosos
morrer	morir
grêmio	gremio
viagens	viajes
journal	journal
computação	computación
integrante	integrante
magalhães	magallanes
subtropicais	subtropicales
virtual	virtual
neves	neves
neves	nieves
máquinas	maquinaria
máquinas	máquinas
poderoso	poderoso
agentes	agentes
vidas	vidas
anualmente	anualmente
pilotos	pilotos
geórgia	georgia
impedir	impedir
verificar	verificar
verificar	comprobar
produz	produce
quente	cálido
quente	caliente
danos	daños
ampla	amplia
sony	sony
michel	michel
junior	junior
argumentação	argumentación
ibge	ibge
matt	matt
freitas	freitas
superman	superhombre
superman	superman
agrícola	agrícola
agrícola	agrario
torcida	hinchada
torcida	retorcida
torcida	torcida
professora	maestra
professora	profesora
aquilo	aquello
comparação	comparación
correto	correcta
correto	correcto
cujos	cuyos
tupi	tupí
constituído	constituido
bordo	bordo
nossos	nuestros
colegas	colegas
maurício	mauricio
escudo	escudo
revelado	revelado
bbc	bbc
teologia	teología
project	project
howard	howard
explicar	explicar
cumprir	cumplir
lutas	peleas
lutas	luchas
herdeiro	heredero
certas	ciertas
system	system
macau	macao
macau	macau
endémica	endémica
iluminação	iluminación
iluminação	alumbrado
sobrinho	sobrino
indicada	indicada
câncer	cáncer
foz	desembocadura
foz	foz
abc	abc
menina	señorita
menina	chica
menina	niña
menina	muchacha
teriam	habrían
teriam	tendrían
relacionado	relacionado
apresentador	presentador
ministros	ministros
sueco	sueco
republicano	republicano
ryan	ryan
violão	guitarra
jaime	jaime
dizem	dicen
recebendo	recibiendo
definida	definida
correspondente	corresponsal
correspondente	correspondiente
aparente	aparente
more	more
separação	separación
compostos	compuestos
aventuras	aventuras
cristina	cristina
cristina	christine
sofia	sofia
sofia	sofía
moura	moura
património	patrimonio
absoluta	absoluta
pau	pau
pau	palo
indiana	indiana
clássicos	clásicas
clássicos	clásicos
ips	ips
adultos	adultos
movie	movie
entidades	entidades
jane	jane
glória	gloria
ritmo	ritmo
estilos	estilos
municipais	municipales
atacar	atacar
cerimônia	ceremonia
gigante	gigante
vias	vías
habitat	habitat
habitat	hábitat
munique	múnich
munique	munich
vírus	virus
ganha	gana
chuva	lluvia
raízes	raíces
raízes	raices
allen	allen
corporation	corporation
símbolos	símbolos
ditadura	dictadura
restante	restante
soul	soul
encontrava	encontraba
estradas	carreteras
estradas	caminos
esquerdo	izquierdo
transformação	transformación
infelizmente	desafortunadamente
infelizmente	desgraciadamente
infelizmente	lamentablemente
infelizmente	tristemente
atmosfera	atmósfera
play	play
xadrez	ajedrez
africano	africano
médica	médica
tendência	tendencia
andar	piso
óleo	aceite
levaram	llevaron
about	about
chinesa	china
nomeação	nominación
nomeação	nombramiento
amplamente	ampliamente
itens	elementos
fred	fred
especialista	experto
especialista	especialista
mac	mac
fachada	fachada
talk	talk
science	science
deram	dieron
capítulos	capítulos
other	other
filósofo	filosofo
filósofo	filósofo
wikimedia	wikimedia
aeronave	aeronave
nativa	nativa
nativa	nativo
confronto	confrontación
confronto	enfrentamiento
pudesse	pudiera
pudesse	pudiese
fale	hable
defende	defiende
defende	aboga
estaria	estaría
circulação	circulación
correia	correa
jeff	jeff
sal	sal
xiv	xiv
relevo	relieve
fonseca	fonseca
piauí	piauí
sétimo	séptimo
idh	idh
psicologia	psicologia
psicologia	psicología
graus	grados
moçambique	mozambique
polo	polo
autonomia	autonomía
bulgária	bulgaria
laura	laura
operacional	operacional
operacional	operativo
operacional	operativa
tóquio	tokio
constitui	constituye
faça	hágalo
faça	haga
definitivamente	definitivamente
cerco	asedio
cerco	cerco
capazes	capaces
ondas	olas
ondas	ondas
percussão	percusión
francis	francis
permanece	permanece
iraque	irak
iraque	iraq
legenda	subtítulos
legenda	subtítulo
fenômeno	fenómeno
morro	cerro
morro	muero
morro	morro
road	road
cientistas	científicos
gato	gato
bandeirantes	bandeirantes
estatística	estadística
finlândia	finlandia
desconhecido	desconocido
supremo	supremo
supremo	suprema
humor	humor
interface	interfaz
estabelecimento	establecimiento
produções	producciones
extinto	extinguido
extinto	extinta
extinto	extinto
populações	poblaciones
sabia	sabía
sabia	sabías
poema	poema
determinar	determinar
determinar	determinarse
great	great
necessidades	necesidades
substituir	sustituir
substituir	reemplazar
filhas	hijas
espera	espera
sons	sonidos
recurso	recurso
destruir	destruir
fronteiras	fronteras
remoção	remoción
aluno	alumno
pagar	pagar
tentativas	intentos
tentativas	tentativas
tarefas	tareas
envolve	involucra
envolve	implica
envolve	envuelve
ensaio	ensayo
eletrônico	electrónico
receita	receta
sorte	suerte
escritas	escritas
objectos	objetos
parar	detener
parar	parar
quinze	quince
quinze	quinze
lixo	basura
cônsul	consul
cônsul	cónsul
tabelas	tablas
coloca	pone
gregos	griegos
pires	pires
cross	cross
escolher	elegir
escolher	escoger
datas	fechas
youtube	youtube
videoclipe	videoclip
dna	adn
dna	dna
causou	causó
causou	provocó
causou	causo
value	value
indiano	indio
indiano	hindú
exerceu	ejerció
australian	australiano
casar	casarse
casar	casar
contava	contaba
dor	dolor
colega	colega
ocupou	ocupó
negócio	negocio
hino	himno
africana	africana
diogo	diego
diogo	diogo
convite	invitación
frio	frío
gravar	grabar
gravar	guardar
adicional	adicional
leonard	leonard
italianos	italianos
may	may
inauguração	inauguración
impossível	imposible
clientes	clientes
aranha	araña
anel	anillo
hop	hop
constituída	constituida
evolution	evolution
instrumental	instrumental
action	action
rádios	radios
have	have
contando	contando
jamais	jamás
viana	viana
bulbophyllum	bulbophyllum
formal	formal
girls	girls
ocupa	ocupa
causar	causar
cedo	temprano
marte	marte
convidados	huéspedes
convidados	invitados
iniciais	iniciales
terminar	terminar
criadas	criadas
criadas	sirvientas
criadas	creadas
batalhas	batallas
estabelecido	establecido
dedicada	dedicada
beach	beach
cobre	cobre
lúcio	lucio
quadros	cuadros
enfrentou	enfrentó
ida	ida
commons	commons
equilíbrio	equilibrio
acabar	acabar
espiritual	espiritual
camada	capa
defensor	defensor
armada	armada
católico	católico
consideradas	consideradas
relevantes	relevantes
relevantes	pertinentes
afiliações	afiliaciones
católicos	católicos
morre	muere
próximas	próximas
limpeza	limpieza
hip	hip
testamento	testamento
avô	abuelito
avô	abuelo
partículas	partículas
tribos	tribus
traduzido	traducido
democrata	demócrata
indústrias	industrias
fator	factor
transformar	transformar
illinois	illinois
envolvidos	implicados
envolvidos	involucrados
mariana	mariana
gordon	gordon
santuário	santuario
cantar	cantar
hard	hard
planejamento	planificación
gray	gray
restauração	restauración
fugir	escapar
fugir	huir
impressão	imprimir
impressão	impresión
bloqueios	bloqueos
derrotar	derrotar
confusão	confusión
now	now
catarinense	catarinense
ligada	conectada
ligada	ligada
ligada	encendida
dimensão	dimensión
luso	luso
tensão	tensión
causas	causas
mhz	mhz
cordas	cuerdas
implantação	despliegue
implantação	implantación
when	when
assinado	firmado
receberam	recibieron
depende	depende
lemos	leemos
siqueira	siqueira
desafio	reto
desafio	desafío
free	free
books	books
aço	acero
morais	morales
alchemilla	alchemilla
leon	leon
vencedores	ganadores
concertos	conciertos
pontuação	puntaje
pontuação	puntuación
pontuação	puntuaciones
tirar	sacar
pesca	pescar
pesca	pesca
cópia	copia
produtora	productora
wild	wild
inclusão	inclusión
memórias	memorias
eliminada	eliminada
precedente	precedente
pdf	pdf
joana	juana
adversário	oponente
adversário	adversario
margarida	margarita
estátua	estatua
fire	fire
recuperar	recuperar
rolling	rolling
ernesto	ernesto
placa	placa
designado	designado
christopher	christopher
ganhando	ganando
jornalismo	periodismo
retorna	devuelve
similares	similares
basicamente	básicamente
colocados	colocados
recuperação	recuperación
celular	celular
variações	variaciones
pmdb	pmdb
trechos	fragmentos
externos	externos
editado	editado
décima	décima
moore	moore
historiadores	historiadores
lake	lake
atuando	actuando
estranho	raro
votações	votaciones
html	html
mexicano	mejicano
mexicano	mexicano
seca	seca
seca	sequía
endereço	dirección
defendeu	defendió
defendeu	abogó
minhas	mías
milão	milán
sintomas	síntomas
álvaro	álvaro
custos	costos
custos	costes
let	let
perspectiva	perspectiva
maddox	maddox
dama	dama
trio	trío
marcha	marcha
inspirado	inspirada
inspirado	inspirado
composições	composiciones
boys	boys
exercício	ejercicio
navegação	navegación
culturas	culturas
culturas	cultivos
citar	citar
manual	manual
clã	clan
clã	aquelarre
var	var
adicionais	adicionales
classificou	clasificó
espanhóis	españoles
progresso	progreso
dragão	dragón
dragão	dragon
começam	empiezan
começam	comienzan
parede	pared
parede	muro
toneladas	toneladas
assume	asume
combustível	combustible
combustível	carburante
sic	sic
sic	lic
mecanismo	mecanismo
hitler	hitler
evidências	evidencias
congo	congo
significativa	significativa
desenvolvida	desarrollada
norma	norma
europe	europe
conjuntos	conjuntos
profundidade	profundidad
substituição	reemplazo
substituição	sustitución
nobreza	nobleza
cadeira	silla
fight	fight
interpretar	interpretar
ocidente	occidente
over	over
come	come
ivan	iván
ivan	ivan
mexicana	mexicana
françois	francois
françois	françois
old	old
umas	unas
explica	explica
restos	sobras
restos	restos
governos	gobiernos
lesão	lesión
resulta	resulta
combinação	combinación
vegetação	vegetación
hong	hong
monarquia	monarquía
johann	johann
batalhão	batallón
começando	comenzando
começando	empezando
vozes	voces
perseguição	persecución
existia	existía
veneza	venecia
channel	channel
proposto	propuesto
asas	alas
conselheiro	asesor
conselheiro	consejero
tradições	tradiciones
comunicações	comunicaciones
almirante	almirante
escritora	escritora
limitada	limitada
envolvido	implicado
envolvido	involucrado
envolvido	envuelto
montes	montes
caio	cayo
caio	caigo
zagueiro	quarterback
equação	ecuación
identificação	identificación
alfred	alfred
bolívia	bolivia
mello	mello
ligados	vinculados
ligados	conectados
memorial	memorial
memorial	conmemorativa
memorial	conmemorativo
varia	varía
varia	varia
vasconcelos	vasconcelos
enviar	enviar
queen	queen
vinho	vino
carbono	carbono
cujas	cuyas
virgem	virgo
virgem	virgen
conto	cuento
borges	borges
aragão	aragón
away	away
dirigida	dirigida
mudo	mudo
sarah	sarah
ocidentais	occidentales
olimpíadas	olimpiadas
napoleão	napoleón
bomba	bomba
machine	machine
dezenas	docenas
dezenas	decenas
dream	dream
friedrich	friedrich
just	just
subfamília	subfamilia
companhias	compañias
companhias	compañías
publicadas	publicadas
adquiriu	adquirió
escritório	oficina
escritório	despacho
mini	mini
magia	magia
alimentação	alimentación
válido	válida
válido	válido
postal	postal
quebra	rompe
treze	trece
nicolau	nicolás
consigo	consigo
financeira	financiera
place	place
administrativo	administrativo
brancos	blancos
ingleses	ingleses
segredo	secreto
della	della
family	family
decidir	decidir
fuga	fuga
fuga	huida
vir	venir
finalidade	finalidad
finalidade	propósito
integrado	integrado
rick	rick
garoto	chico
ball	ball
land	land
side	side
miami	miami
representado	representado
graves	graves
pares	pares
florianópolis	florianópolis
sports	sports
east	east
temperaturas	temperaturas
moon	moon
define	define
exposições	exposiciones
deserto	desierto
portuguesas	portuguesas
bônus	bonos
bônus	bonus
bônus	bono
bônus	primas
bônus	bonificación
associada	asociada
construiu	construyó
aéreo	aéreo
tênis	tenis
soma	soma
soma	suma
cem	cem
cem	cien
baviera	baviera
baviera	bavaria
geográfica	geográfica
pastor	pastor
aviação	aviación
ventos	vientos
comumente	comúnmente
candidatura	candidatura
deusa	diosa
pobres	pobres
irã	irán
mestrado	máster
mestrado	maestría
manaus	manaos
literária	literaria
representam	representan
ora	ora
alternativo	alternativo
escreve	escribe
penso	pienso
revelação	revelación
revelação	revelado
descreveu	describió
patente	patente
reconhecida	reconocida
causando	causando
filipinas	filipinas
reformas	reformas
parcialmente	parcialmente
anne	anne
batman	batman
afluente	afluente
mostram	muestran
ocorreram	ocurrieron
manchester	manchester
acervo	acervo
torneios	torneos
libertação	liberación
gilberto	gilberto
atribuído	atribuido
atribuído	asignado
automaticamente	automáticamente
inspiração	inspiración
precisam	necesitan
ucrânia	ucrania
uniforme	uniforme
intitulada	titulada
especializada	especializada
mesorregião	mesorregión
estrangeiro	extranjero
condados	condados
type	type
concílio	concilio
falecido	difunto
falecido	fallecido
abuso	abuso
abuso	maltrato
supostamente	supuestamente
andy	andy
constantino	constantino
magazine	magazine
moraes	moraes
marketing	mercadeo
marketing	marketing
marketing	mercadotecnia
marketing	comercialización
raul	raul
raul	raúl
some	some
ativa	activa
variável	variable
ouvir	oír
ouvir	escuchar
perigo	peligro
brilhante	brillante
bytes	octetos
bytes	bytes
constantemente	constantemente
prorrogação	prórroga
aprovado	aprobado
cuidado	cuidado
cuidado	precaución
baixista	bajista
lutador	peleador
lutador	luchador
paralelo	paralelo
equipamento	equipamiento
visitantes	visitantes
certamente	ciertamente
certamente	seguramente
sydney	sídney
sydney	sydney
incluído	incluido
humanas	humanas
age	age
age	actúa
eletrônicos	electrónicos
cientista	científico
cientista	científica
democrático	democrática
democrático	democrático
ohio	ohio
leia	lea
leia	leer
leia	lee
deriva	deriva
justamente	justamente
acompanhado	acompañado
saga	saga
jerry	jerry
específicos	específicos
estúdios	estudios
enciclopédica	enciclopédica
soluções	soluciones
soluções	disoluciones
vapor	vapor
cover	cover
album	album
pagamento	pago
necessários	necesarios
acusado	acusado
virtude	virtud
cabelo	cabello
cabelo	pelo
tecnologias	tecnologías
companheiros	compañeros
encerramento	clausura
brazil	argentina
amaral	amaral
vieram	vinieron
nobel	nobel
conter	contener
indonésia	indonesia
ruínas	ruinas
vencedora	ganadora
vencedora	vencedora
iniciada	iniciada
querer	querer
marechal	mariscal
marechal	marshal
aloe	aloe
instalado	instalado
territorial	territorial
territorial	territoriales
coro	coro
aceitou	aceptó
parceiro	compañero
parceiro	socio
particulares	particulares
devia	debía
imperatriz	emperatriz
grammy	grammy
neve	nieve
mortes	muertes
publicidade	publicidad
platina	platino
ducado	ducado
sporting	sporting
retrato	retrato
olhar	mirar
olhar	mirada
indicar	indicar
dispositivo	dispositivo
fruto	fruto
presidentes	presidentes
acontecer	ocurrir
acontecer	suceder
nasce	nace
iniciar	iniciar
player	player
basílica	basílica
coloque	ponga
coloque	coloque
específica	específica
incêndio	incendio
essencialmente	esencialmente
cidadão	ciudadano
vendidos	vendidos
sampaio	sampaio
perde	pierdes
perde	pierde
marcar	marcar
caro	costoso
caro	caro
brancas	blancas
executiva	ejecutiva
destacou	destacó
raios	rayos
permitem	permiten
reality	reality
completar	completar
completar	completarse
integral	integro
integral	integral
note	note
percurso	recorrido
altar	altar
andrea	andrea
visível	visible
visível	visibles
policiais	policías
mit	mit
jonathan	jonathan
latns	latns
colocando	poniendo
colocando	colocando
tradicionalmente	tradicionalmente
religiões	religiones
legislatura	legislatura
mencionado	mencionado
pequim	pekín
pequim	beijing
bispos	obispos
falha	falla
falha	fallo
gráfico	gráfica
gráfico	gráfico
iniciado	iniciado
paraíso	paraiso
paraíso	paraíso
responder	contestar
responder	responder
lisa	lisa
reduzir	reducir
madonna	madonna
húmidas	húmedas
esr	esr
colonização	colonización
muçulmanos	musulmanes
cirurgia	cirugía
proporção	proporción
hamilton	hamilton
exame	examen
lost	lost
sujeito	sujeto
heavy	heavy
personalidades	personalidades
fantasia	fantasía
preparação	preparación
ensaios	ensayos
modos	modos
fabricante	fabricante
longm	longm
exemplares	ejemplares
requisitos	requisitos
turma	clase
post	puesto
post	post
juntar	ensamblar
ian	ian
querem	quieren
aplicada	aplicada
index	index
seções	secciones
gales	gales
avanço	avanzo
avanço	avance
soldado	soldado
madalena	magdalena
esperar	esperar
abordagem	abordaje
abordagem	planteamiento
hit	hit
básico	básica
básico	básico
belga	belga
bell	bell
transferido	transferido
transferido	trasladado
wagner	wagner
planalto	meseta
tripulação	tripulación
identificar	identificar
benjamin	benjamin
benjamin	benjamín
nobres	nobles
wayne	wayne
golfo	golfo
civilização	civilización
baseados	basados
rochas	rocas
alfabeto	alfabeto
alfabeto	abecedario
afirmando	afirmando
vereador	concejal
ciclismo	ciclismo
líquido	líquido
anjos	ángeles
anjos	angeles
construções	construcciones
jay	jay
ordenou	ordenó
podiam	podían
merece	merece
merece	mereces
regente	regente
soviético	soviético
substituindo	sustituyendo
secundário	secundaria
secundário	secundario
people	people
demo	demo
vivos	vivos
ala	ala
cliente	clienta
cliente	cliente
toca	toca
cabral	cabral
dispositivos	dispositivos
orlando	orlando
seleções	selecciones
descendente	descendiente
descendente	descendente
here	here
potter	potter
surgiram	surgieron
surgiram	emergieron
adolescente	adolescente
cortes	cortes
montreal	montreal
notório	notorio
vera	vera
módulo	módulo
módulo	modulo
oliver	oliver
socos	puñetazos
sugere	sugiere
quaisquer	cualesquiera
especialistas	expertos
especialistas	especialistas
geraldo	geraldo
acusações	cargos
acusações	acusaciones
partiu	rompió
partiu	partió
den	den
predefinições	predefinidos
predefinições	predeterminados
british	british
there	there
vilão	villano
vilão	pícaros
botânica	botánica
parecem	parecen
elétrico	eléctrico
espiral	espiral
considerável	considerable
vegas	vegas
transmitido	transmitido
jardins	jardines
jon	jon
cia	cia
hóquei	hockey
relatos	relatos
albuquerque	alburquerque
albuquerque	albuquerque
manifestações	manifestaciones
dedicou	dedicó
rosto	rostro
entregue	entregada
entregue	entregado
experimental	experimental
pokémon	pokémon
etapas	etapas
watson	watson
entrega	entrega
una	uan
how	how
classificados	clasificados
cavalos	caballos
ocasiões	ocasiones
observar	observar
atração	atracción
leo	leo
latitude	latitud
frei	fray
riqueza	riquezas
riqueza	riqueza
union	union
robin	robín
robin	robin
escapar	escapar
utilizam	utilizan
tomás	tomás
aparições	apariciones
administrativas	administrativas
rendimento	rédito
only	only
históricas	históricas
fundos	fondos
resolveu	resolvió
adequado	adecuado
remover	quitar
talento	talento
steven	steven
ross	ross
intensidade	intensidad
concluiu	concluyó
aprender	aprender
goiânia	goiânia
integrar	integrar
sério	serio
vinha	viña
vinha	viñedo
eva	eva
provar	degustar
exércitos	ejércitos
escultura	escultura
áudio	audio
quadrados	cuadrados
pesado	pesado
rapper	rapero
mandou	mandó
shift	shift
construídos	construidos
construídos	construidas
pio	pío
pio	pio
amazônia	amazon
amazônia	amazonas
amazônia	amazonía
amazônia	amazonia
condenado	condenado
fechado	cerrado
estatísticas	estadísticas
limitado	limitado
repórter	reportero
repórter	reportera
mental	mental
laterais	laterales
mesquita	mezquita
barco	bote
simultaneamente	simultáneamente
russell	russel
russell	russell
roupa	ropa
longas	largas
bolsa	bolso
bolsa	beca
literário	literario
transformou	convirtió
transformou	transformó
rossi	rossi
financeiro	financiero
explicação	explicación
mostrado	mostrado
infinito	infinito
privado	privado
carmo	carmo
seminário	seminario
marrocos	marruecos
leitor	lector
harris	harris
fornecer	suministrar
crédito	crédito
luísa	luisa
bancos	bancos
espectadores	espectadores
eds	eds
thiago	thiago
opcional	optativo
opcional	opcional
filtro	filtro
estágio	etapa
estágio	pasantía
perry	perry
carneiro	carnero
duquesa	duquesa
jornada	jornada
abandonou	abandonó
row	row
guy	guy
dura	dura
organizar	organizarse
organizar	organizar
teclados	teclados
marinho	marino
tornado	tornado
biologia	biología
assassinado	asesinado
linux	linux
colunas	columnas
colunas	altavoces
diálogo	diálogo
diálogo	dialogo
intelectual	intelectual
toledo	toledo
nasa	nasa
brito	brito
artur	arturo
party	party
verdes	verdes
legend	legend
sofre	padece
sofre	sufre
cai	cai
cai	cae
colorado	colorado
móveis	móviles
atender	atender
compilação	compilación
pensilvânia	pennsylvania
pensilvânia	pensilvania
cooperação	cooperación
variáveis	variables
cérebro	cerebro
arquidiocese	arquidiócesis
arquidiocese	archidiócesis
olá	hola
percebe	percibe
aliado	aliado
clipe	clip
desenvolve	desarrolla
amante	amante
paciente	paciente
avaliar	evaluar
goleada	goleada
benfica	benfica
stanley	stanley
exílio	exilio
exílio	destierro
químico	químico
aumenta	aumenta
conexão	conexión
documentação	documentación
síndrome	síndrome
gene	gene
gene	gen
luciano	luciano
radiação	radiación
orientais	orientales
fórum	foro
ultimate	ultimate
precisamente	precisamente
une	une
anjo	angel
anjo	ángel
afro	afroamericano
afro	afro
positivo	positivos
positivo	positivo
positivo	positiva
holandês	neerlandés
holandês	holandés
legislativo	legislativo
furacão	huracán
federais	federales
jun	jun
nba	nba
compreensão	comprensión
carlo	carlo
milton	milton
item	item
item	ítem
resultando	resultando
necessárias	necesarias
eddie	eddie
lula	calamar
lula	lula
lula	calamares
organismos	organismos
sant	sant
longew	longew
inteiramente	enteramente
cineasta	cineasta
impostos	impuestos
fabricação	fabricación
god	god
inferno	infierno
obtido	obtenido
sugestão	sugestión
sugestão	sugerencia
perceber	percibir
abre	abre
preferência	preferencia
distante	lejano
distante	distante
distante	lejana
investimentos	inversiones
aprovada	aprobada
golden	golden
dario	dario
previsto	predicho
oferta	oferta
confirmou	confirmó
paisagem	paisaje
stewart	stewart
relacionada	relacionada
onu	onu
comprar	comprar
esquema	esquema
forçado	forzado
leitores	lectores
silent	silent
correntes	corrientes
correntes	cadenas
gerar	generar
apresentadora	presentadora
nogueira	nogal
nogueira	nogueira
chegam	llegan
prússia	prusia
sock	sock
wilhelm	wilhelm
cálculo	cálculo
pobre	pobre
créditos	créditos
sábado	sábado
sábado	sabado
donald	donald
semifinais	semifinales
barreto	barreto
normandia	normandia
normandia	normandía
rebeldes	rebeldes
rebeldes	insurgentes
subespécie	subespecie
permanecer	permanecer
disposição	disposición
explosão	explosión
explosão	estallido
explosão	ráfaga
atlas	atlas
parecer	dictamen
parecer	parecer
laranja	naranja
iguais	iguales
quarenta	cuarenta
quarenta	quarenta
organismo	organismo
otto	otto
demonstra	demuestra
seguro	seguro
investimento	inversion
investimento	inversión
preços	precios
procedimento	procedimiento
oferecer	ofrecer
havendo	habiendo
descrever	describir
constantes	constantes
mantida	mantenida
mantida	sostenida
comida	comida
destinado	destinado
conduta	conducta
conduta	conducto
town	town
marcando	marcando
instrução	instrucción
mai	mai
delta	delta
kennedy	kennedy
adição	adición
figueiredo	figueiredo
sagrado	sagrado
sagrado	sagrada
amador	amateur
amador	aficionado
raiz	root
raiz	raíz
für	für
achei	pensé
achei	encontré
linda	hermosa
concessão	concesión
camponotus	camponotus
braços	brazos
tecido	tela
tecido	tejido
marcus	marcus
substância	sustancia
substância	substancia
bárbara	bárbara
sétima	séptima
espetáculo	espectáculo
empregados	empleados
asa	asa
asa	ala
centenário	centenario
presidencial	presidenciales
presidencial	presidencial
sofrer	sufrir
domínios	dominios
aplicado	aplicado
segmento	segmento
confirmado	confirmado
confirmado	confirmada
henri	henri
otomano	otomano
arts	arts
continuidade	continuidad
mapas	mapas
newton	newton
meta	meta
atp	atp
ovos	huevos
sigla	sigla
coutinho	coutinho
nativos	nativos
corrupção	corrupción
teorema	teorema
autorização	autorización
praga	praga
praga	plaga
monarca	monarca
virgínia	virginia
triângulo	triángulo
triângulo	triangulo
embaixador	embajador
blocos	bloques
acção	accion
porção	porción
resumo	resumen
negociações	negociaciones
pão	pan
roll	roll
marcação	marcaje
marcação	marcado
franquia	franqueo
franquia	franquicia
viola	viola
vingança	venganza
divino	divino
niterói	niterói
fernanda	felix
fernanda	fernanda
gary	gary
acreditava	creía
continuação	continuación
massachusetts	massachusetts
reprodução	reproducción
integrou	integró
estudiosos	estudiosos
estudiosos	eruditos
abriga	alberga
rap	rap
vazio	vacío
vazio	vacio
jordan	jordan
century	century
curtas	cortas
box	box
cair	caer
cair	caerse
transferiu	transfirió
unesco	unesco
contribuir	contribuir
orig	orig
coordenação	coordinación
trânsito	tránsito
viajou	viajó
permissão	permiso
argélia	argelia
prisioneiros	prisioneros
prisioneiros	presos
artificial	artificial
físicas	físicas
claude	claude
placas	planchas
placas	placas
marc	marc
infante	infante
câmera	cámara
atualização	actualización
costuma	suele
falou	habló
semifinal	semifinal
desconhecida	desconocida
instruções	instrucciones
fantasma	fantasma
interação	interacción
acadêmico	académico
concepção	concepción
fria	fría
horror	horror
lorena	lorena
points	points
take	take
baiano	bahiano
lutou	luchó
implementação	implementación
rosário	rosario
austríaco	austriaco
austríaco	austríaco
matou	mató
comarca	comarca
lidar	lidiar
tratados	tratados
iso	iso
aquisição	adquisición
xbox	xbox
lawrence	lawrence
antecessor	predecesor
antecessor	antecesor
franklin	franklin
gold	gold
faziam	hacían
viúva	viuda
viúva	widow
consulado	consulado
setores	sectores
adicionar	agregar
adicionar	añadir
compreende	comprende
compreende	entiende
contribuiu	contribuido
contribuiu	contribuyó
sky	sky
mel	mel
mel	miel
escolhida	elegida
escolhida	escogida
vigor	vigor
alias	alias
ferroviário	ferroviario
torcedores	hinchas
barry	barry
formiga	hormiga
cauda	rabo
cauda	cola
leal	leal
estabelecida	establecida
vence	gana
vence	vence
esconder	ocultar
esconder	esconderse
esconder	esconder
ibérica	ibérica
intervalo	intervalo
intervalo	rango
antiguidade	antigüedad
sentimentos	sentimientos
dizia	decía
dizia	decia
perfeito	perfecto
interpreta	interpreta
cantores	cantantes
cantores	cantores
discografia	discografía
pertencia	pertenecía
variedades	variedades
consideram	consideran
substituída	reemplazada
substituída	sustituida
force	force
dentes	dientes
executado	ejecutado
diana	diana
demanda	demanda
tocou	tocó
franz	franz
adotado	adoptado
morta	muerta
coleophora	coleophora
est	est
congregação	congregación
circular	circular
wright	wright
cirílico	cirílico
rogério	rogério
incidente	incidente
ética	ética
ética	etica
provincial	provincial
cura	curación
cura	cura
acabaram	terminaron
acabaram	acabaron
pesquisadores	investigadores
eleita	electa
marcados	marcados
marcados	etiquetados
digitais	digitales
alegria	alegría
alegria	gozo
ocupado	ocupado
austin	austin
alexandria	alexandria
alexandria	alejandría
palma	palma
bros	bros
roda	rueda
preocupação	preocupación
estreito	angosto
estreito	estrecho
chart	chart
conversa	conversación
conversa	charla
deixado	dejado
freire	freire
conquistas	logros
conquistas	conquistas
ameaçada	amenazada
passagens	pasajes
canta	canta
morreram	murieron
entrevistas	entrevistas
morgan	morgan
sacerdote	sacerdote
vender	vender
code	code
preservação	preservación
essencial	esencial
típico	típico
vidro	cristal
vidro	vidrio
mega	mega
disputas	controversias
disputas	disputas
alagoas	alagoas
voluntários	voluntarios
evidente	evidente
estocolmo	estocolmo
pensa	piensa
conquistando	conquistando
cita	cotiza
aparelho	aparejo
aparelho	aparato
earth	earth
necessariamente	necesariamente
carter	carretero
carter	carter
variante	variante
menção	mención
genética	genética
declínio	declive
declínio	declinación
theory	theory
camadas	capas
rangers	rangers
battle	battle
rumo	rumbo
reuniu	reunió
aquelas	aquellas
camargo	camargo
válida	válida
relativa	relativa
reta	recta
esperado	esperado
europeias	europeas
basquetebol	básquetbol
basquetebol	baloncesto
entendi	entendí
entendi	entendido
entendi	entiendo
cachoeira	cascada
surpresa	sorpresa
kid	kid
cabe	cabe
herbert	herbert
moedas	monedas
moedas	divisas
afluentes	afluentes
cantando	cantando
jurídica	jurídico
jurídica	jurídica
vagas	vacantes
vagas	vagas
borgonha	borgoña
radical	radical
roy	roy
favorável	favorable
continuaram	continuaron
luxemburgo	luxemburgo
abandonar	abandonar
inteligente	inteligente
incluiu	incluyó
beatriz	beatrice
beatriz	beatriz
inédita	inédita
futura	futura
conseguindo	logrando
pontes	puentes
relógio	reloj
mediterrâneo	mediterráneo
monstro	monstruo
macedo	macedo
law	law
jonas	jonas
jonas	jonás
executar	ejecute
executar	ejecutar
dean	dean
armando	armando
entraram	entraron
phil	phil
phil	phill
pernas	patas
pernas	piernas
three	three
fome	hambruna
fome	hambre
fome	hambriento
seguem	siguen
namorada	novia
acreditam	creen
inscrição	inscripción
larry	larry
desenvolvidos	desarrollados
diversidade	diversidad
pura	pura
introduzido	introducido
chuvas	lluvias
concedido	concedido
concedido	otorgado
arcos	arcos
amplo	amplio
veiga	veiga
usp	usp
milhas	millas
baptista	baptista
respostas	respuestas
ativos	activos
bernard	bernard
festivais	festivales
aumentou	aumentó
continuam	continúan
respondeu	contestó
respondeu	respondió
wars	wars
ken	ken
ocupar	ocupar
vladimir	vladímir
vladimir	vladimir
martinho	martín
tráfego	tráfico
anglo	anglo
parâmetros	parámetros
parâmetros	parametros
teles	teles
quilómetros	kilometros
residências	residencias
numerosos	numerosos
official	official
milho	maíz
agostinho	agustín
intérprete	intérprete
prado	prado
lançaram	lanzaron
proteínas	proteínas
encontrei	encontré
getúlio	getúlio
massacre	masacre
romances	novelas
romances	romances
atlanta	atlanta
combater	combatir
bond	bond
afirmação	afirmación
apple	apple
guerreiro	guerrero
internas	internas
fortuna	fortuna
heroísmo	heroísmo
janela	ventana
profunda	profunda
sonic	sonic
industriais	industriales
caracteres	caracteres
days	days
fornece	suministra
fornece	proporciona
fornece	provee
blood	blood
menezes	menezes
captura	captura
raw	raw
sonhos	sueños
nazista	nazi
adulto	adulto
russos	rusos
esboço	boceto
esboço	bosquejo
esboço	esbozo
corrigir	corregir
sound	sound
rodas	ruedas
novelas	telenovelas
novelas	novelas
reservas	reservaciones
reservas	reservas
substâncias	substancias
substâncias	sustancias
cães	perros
coral	coral
uai	daa
sente	siente
juntas	juntas
marciais	marciales
isaac	isaac
herança	herencia
decorrer	transcurrir
compositores	compositores
mauro	mauro
metropolitano	metropolitano
guarani	guaraní
abertos	abiertos
incluía	incluía
regina	regina
márcio	marcio
inter	ínter
inter	inter
fiel	fiel
persa	persa
observações	observaciones
dirigir	dirigir
lazer	ocio
lazer	recreación
verificação	verificación
verificação	comprobación
verificação	cheque
parlamentar	parlamentario
parlamentar	parlamentaria
bay	bay
florestal	forestal
resgate	rescate
fátima	fátima
fátima	fatima
capitania	capitanía
ocorrência	ocurrencia
indicam	indican
propôs	proponía
propôs	propuso
nomeou	nombró
wood	wood
hectares	hectáreas
representada	representada
redação	redacción
configuração	configuración
vistos	visados
vistos	visas
recorrente	recurrente
decidiram	decidieron
vendidas	vendidas
adriano	adriano
rob	rob
oportunidades	oportunidades
tecidos	telas
tecidos	tejidos
elevação	elevación
liderado	liderado
but	but
automóveis	automóviles
automóveis	automoviles
recordes	récords
futsal	futsal
dominante	dominante
conversão	conversión
case	case
entendo	entiendo
tvi	tvi
ficava	quedaba
longos	largos
colônias	colonias
consequências	consecuencias
múltiplas	múltiples
selvagens	silvestres
selvagens	salvajes
convocado	convocado
class	class
divididos	divididos
australiano	australiano
empréstimo	préstamo
teatral	teatral
adams	adams
again	again
deixaram	dejaron
distinção	distinción
nevada	nevada
álcool	alcohol
prince	prince
arranjos	arreglos
sobreviventes	sobrevivientes
sobreviventes	supervivientes
missa	misa
panamá	panamá
panamá	panama
ótimo	genial
seguidores	seguidores
tipicamente	típicamente
crença	creencia
franca	franca
salvo	salvo
lópez	lópez
tailândia	tailandia
aguiar	aguiar
praias	playas
cento	ciento
apresentados	presentados
literalmente	literalmente
non	non
instalada	instalada
processamento	procesamiento
gerou	generó
gerou	engendró
rangel	rangel
esfera	orbe
esfera	esfera
vivia	vivía
cabeças	cabezas
jornalistas	periodistas
justin	justin
modificações	modificaciones
flash	flash
flash	destello
after	after
florença	florencia
precisão	precisión
pesados	pesados
evidência	evidencia
nomeada	nombrada
nomeada	nominada
michigan	michigan
nigéria	nigeria
danny	danny
foundation	foundation
mora	vive
aplicar	aplicar
algoritmo	algoritmo
josh	josh
legião	legión
somos	somos
dourada	dorada
mortal	mortal
escuro	oscuro
falso	falso
coreano	coreano
falecimento	fallecimiento
afeganistão	afganistán
apresentava	presentaba
sociedades	sociedades
integra	integra
tree	tree
assassino	asesino
entretenimento	entretenimiento
senhores	señores
twitter	twitter
twitter	gorjeo
evangelho	evangelio
eliminatórias	eliminatorias
iguaçu	iguazú
lincoln	lincoln
costumes	costumbres
considerou	consideró
obviamente	obviamente
gay	gay
operador	operador
bits	bits
galiza	galicia
marshall	marshall
reinos	reinos
brigada	brigada
brigada	brigadas
under	under
turco	turco
sobrenome	apellidos
sobrenome	apellido
derivado	derivado
meninas	muchachas
meninas	niñas
meninas	chicas
trazendo	trayendo
trazendo	traer
tocando	sonando
tocando	tocando
leopoldo	leopoldo
baseadas	basadas
caracteriza	caracteriza
rosaceae	rosaceae
peito	pechuga
peito	pecho
into	into
abrange	abarca
kansas	kansas
frutos	frutos
formalmente	formalmente
matthew	matthew
sicília	sicilia
special	special
barbara	barbara
gov	gov
studio	studio
rebelião	rebelión
cearense	cearense
abu	abu
facilitar	facilitar
adolescentes	adolescentes
gráficos	gráficos
gráficos	gráficas
arroz	arroz
enterro	entierro
board	board
she	she
intensa	intensa
sentir	sentir
elaboração	elaboración
restaurante	restaurante
centrais	centrales
planetas	planetas
desportivo	deportivo
know	know
iron	iron
publishing	publishing
suspensão	suspension
suspensão	suspensión
montagem	montaje
recusa	denegación
félix	félix
emergência	emergencia
hélio	helios
hélio	helio
see	see
construídas	construidas
summer	summer
montenegro	montenegro
sombra	sombra
woman	woman
vaticano	vaticano
botão	botón
matos	matos
baker	baker
escolheu	eligió
escolheu	escogió
vda	vda
beta	beta
permitido	permitido
dinâmica	dinámica
sentimento	sentimiento
contagem	recuento
contagem	conteo
acessado	accedido
psdb	psdb
heinrich	heinrich
dava	daba
compositora	compositora
parâmetro	parámetro
violino	violín
ligadas	enlazadas
patriarca	patriarca
ambientes	entornos
ambientes	ambientes
granada	granada
narrativa	narrativa
extrema	extrema
emprestado	prestado
assunção	asunción
transforma	transforma
cristóvão	cristóbal
distintos	distinguidos
grant	grant
autora	autora
rendeu	rindió
ocasionalmente	ocasionalmente
genebra	ginebra
sementes	semillas
guanabara	guanabara
parker	parker
repertório	repertorio
separados	separados
avisos	avisos
certificado	certificado
chefes	jefes
produzidas	producidas
estima	estima
shakespeare	shakespeare
parecia	parecía
poderosa	poderosa
voltando	volviendo
classificada	clasificada
escrevendo	escribiendo
bobby	bobby
exteriores	exteriores
liderou	encabezó
liderou	lideró
ocupada	ocupada
cantou	cantó
perguntas	preguntas
fighter	fighter
vereadores	concejales
funcionar	funcionar
diagnóstico	diagnostico
diagnóstico	diagnosis
diagnóstico	diagnóstico
estável	estable
lusófona	lusófona
imediato	inmediato
imediato	inmediata
entendimento	entendimiento
curva	curva
feridos	heridos
tesouro	tesoro
edgar	edgar
designar	designar
baltimore	baltimore
superliga	superliga
descobertas	descubrimientos
ronaldo	ronaldo
participando	participando
seco	seco
parques	parques
harmonia	armonía
harmonia	harmonia
substituiu	sustituyó
substituiu	reemplazó
síntese	síntesis
aposentado	jubilados
aposentado	retirado
aposentado	jubilado
versos	versos
taxas	tasas
dedicar	dedicar
externo	externo
érico	erico
outono	otoño
hamburgo	hamburgo
oração	oración
numerosas	numerosas
fita	listón
fita	cinta
componente	componente
irrelevante	irrelevante
divina	divina
fotografias	fotografías
cronologia	cronología
cronologia	biografía
popularmente	popularmente
mma	mma
reputação	reputación
férias	vacaciones
físicos	físicos
júpiter	júpiter
júpiter	jupiter
projetado	diseñado
vascular	vasculares
vascular	vascular
isótopo	isótopo
significativo	significativo
acadêmicos	académicos
emissão	emisión
paquistão	pakistán
procurando	buscando
joel	joel
suicídio	suicidarse
suicídio	suicidio
adaptado	adaptado
abraços	abrazos
ibn	ibn
lutadores	combatientes
lutadores	luchadores
lutadores	peleadores
alô	aló
euros	euros
jennifer	jenifer
jennifer	jennifer
finanças	hacienda
finanças	finanzas
close	close
sergipe	sergipe
pioneiro	pionero
want	want
bottom	bottom
tennessee	tennessee
diminuição	disminución
sugiro	sugiero
compromisso	compromiso
baden	baden
complexidade	complejidad
sean	sean
voos	vuelos
turistas	turistas
propor	proponer
comprou	compró
plataformas	plataformas
reference	reference
lembra	recuerdas
lembra	recuerda
alegando	alegando
brothers	brothers
collection	collection
condessa	condesa
mercados	mercados
tia	tía
tia	tia
américas	américas
pôde	pudo
falantes	hablantes
houston	houston
dennis	dennis
frases	frases
prix	prix
foguete	cohete
coordenadas	coordinadas
coordenadas	coordenadas
infraestrutura	infraestructura
infraestrutura	infraestructuras
formaram	formaron
stuart	estuardo
stuart	stuart
kate	kate
corre	corre
nápoles	nápoles
decidido	decidido
cantão	cantón
nossas	nuestras
pessoalmente	personalmente
francesco	francesco
barroco	barroco
declarado	declarado
lusitana	lusitana
uss	uss
publica	publica
itunes	itunes
manda	manda
christmas	christmas
rivalidade	rivalidad
cinemas	cines
húngaro	húngaro
agrícolas	agrícolas
ortodoxa	ortodoxa
gravidade	gravedad
otavio	octaviano
pobreza	pobreza
aprendizagem	aprendizaje
philip	philip
oitava	octava
anúncio	anuncio
reconstrução	reconstrucción
afirmar	afirmar
tocantins	tocantins
servem	sirven
servindo	sirviendo
aproximação	acercamiento
aproximação	aproximación
levada	llevada
distribuídos	distribuidos
ermida	ermita
robô	robot
educacional	educativo
educacional	educativa
aceito	aceptado
aceito	acepto
pink	pink
benefícios	beneficios
janelas	ventanillas
janelas	ventanas
janelas	ventana
alterado	cambiado
alterado	alterado
vietnã	vietnam
