que	che
uma	una
com	con
para	per
foi	fu
foi	era
como	come
não	non
dos	dei
dos	degli
dos	dos
mais	più
sua	sua
utc	utc
são	sono
seu	suo
min	min
das	delle
das	das
também	anche
the	the
ser	essere
pela	dalla
pelo	dal
ele	lui
mas	ma
discussão	discussione
entre	tra
entre	fra
anos	anni
era	era
sobre	circa
sobre	su
tem	ha
nos	ci
até	fino
cidade	città
quando	quando
seus	vostri
foram	furono
janeiro	gennaio
onde	dove
brasil	brasile
rio	fiume
está	sta
depois	dopo
depois	poi
estado	stato
ano	anno
nas	nelle
primeiro	primo
primeiro	prima
pode	può
durante	durante
ligações	collegamenti
parte	parte
este	questo
nome	nome
ainda	ancora
outros	altri
esta	questa
sem	senza
ela	lei
dia	giorno
dois	due
muito	molto
região	regione
suas	vostre
segundo	secondo
artigo	articolo
aos	ai
aos	agli
apenas	solo
ter	avere
msg	msg
julho	luglio
área	area
agosto	agosto
lista	lista
lista	elenco
maio	maggio
março	marzo
norte	nord
família	famiglia
abril	aprile
sul	sud
grupo	gruppo
setembro	settembre
paulo	paolo
ver	vedere
outubro	ottobre
isso	questo
maior	maggiore
todos	tutti
nova	nuova
nova	nova
álbum	album
junho	giugno
contra	contro
tempo	tempo
dezembro	dicembre
fevereiro	febbraio
forma	forma
novembro	novembre
assim	così
então	quindi
então	allora
principal	principale
três	tre
série	serie
além	oltre
align	align
final	finale
história	storia
filme	film
melhor	migliore
melhor	meglio
duas	due
guerra	guerra
população	popolazione
estados	stati
bem	bene
mundo	mondo
banda	banda
outras	altre
km²	km²
gols	gol
nacional	nazionale
jogos	giochi
qual	quale
brasileiro	brasiliano
alguns	alcuni
center	center
vida	vita
possui	possiede
país	paese
cada	ogni
eles	loro
música	musica
página	pagina
dias	giorni
campeonato	campionato
josé	giuseppe
futebol	calcio
espécie	specie
portugal	portogallo
joão	giovanni
tinha	aveva
clube	club
clube	clube
unidos	uniti
novo	nuovo
partir	partire
tendo	avendo
segunda	seconda
pessoas	persone
presidente	presidente
caso	caso
jogo	gioco
sistema	sistema
americano	americano
período	periodo
século	secolo
título	titolo
casa	casa
enquanto	mentre
lugar	posto
seja	sia
oficial	ufficiale
vezes	volte
filho	figlio
governo	governo
artigos	articoli
distrito	distretto
local	luogo
trabalho	lavoro
acordo	accordo
número	numero
através	attraverso
maria	maria
vários	vari
terra	terra
gênero	genere
igreja	chiesa
universidade	università
qualquer	qualsiasi
podem	possono
centro	centro
início	inizio
tipo	tipo
santa	santa
conhecido	noto
conhecido	conosciuto
canção	canzone
edição	edizione
mundial	mondiale
todas	tutte
português	portoghese
lançado	lanciato
rei	re
algumas	alcune
quem	chi
água	acqua
quatro	quattro
exemplo	esempio
morte	morte
devido	dovuto
eram	erano
brasileira	brasiliana
produção	produzione
temporada	stagione
for	for
seguinte	seguente
muitos	molti
wikipédia	wikipedia
time	time
faz	fa
geral	generale
meio	mezzo
aqui	qui
style	style
versão	versione
fim	fine
carlos	carlos
menos	meno
programa	programma
porto	porto
fontes	fonti
deve	dovrebbe
deve	deve
seria	sarebbe
sempre	sempre
site	sito
livro	libro
lado	lato
atualmente	attualmente
equipe	squadra
equipe	team
escola	scuola
dados	dati
quais	quali
apesar	nonostante
apesar	malgrado
copa	coppa
internacional	internazionale
hoje	oggi
província	provincia
países	paesi
embora	sebbene
inglês	inglese
pouco	poco
porque	perché
projeto	progetto
atual	attuale
john	john
ordem	ordine
pai	padre
pai	papà
localizada	localizzata
estádio	stadio
partido	partito
começou	iniziato
mesma	stessa
ilha	isola
carreira	carriera
campo	campo
uso	uso
linha	linea
poder	potere
reino	regno
muitas	molte
grandes	grandi
principais	principali
conta	conto
tarde	pomeriggio
volta	ritorna
política	politica
pertencente	appartenente
base	base
frança	francia
direito	diritto
nem	né
real	real
real	reale
rede	rete
jpg	jpg
chamado	chiamato
público	pubblico
fase	fase
pedro	pietro
lisboa	lisbona
capital	capitale
isbn	isbn
ponto	punto
empresa	azienda
corpo	corpo
década	decennio
divisão	divisione
república	repubblica
votação	votazione
data	data
agora	ora
condado	contea
desenvolvimento	sviluppo
mil	mille
logo	presto
diretor	direttore
toda	tutta
categoria	categoria
militar	militare
campeão	campione
new	new
diz	dice
sucesso	successo
francisco	francesco
original	originale
fora	fuori
comunidade	comunità
idade	età
cinco	cinque
maioria	maggioranza
alemanha	germania
tudo	tutto
média	media
departamento	dipartimento
tal	tale
vai	vai
quase	quasi
boa	buona
dentro	dentro
processo	processo
último	ultimo
bom	buon
bom	buono
milhões	milioni
rock	rock
arte	arte
total	totale
lei	legge
importante	importante
obras	opere
presente	regalo
ficou	rimase
feito	fatto
central	centrale
língua	lingua
sede	sete
tanto	tanto
pontos	punti
costa	costa
origem	origine
exército	esercito
santo	santo
incluindo	compreso
incluindo	compresa
incluindo	compresi
ouro	oro
federal	federale
quanto	quanto
texto	testo
los	los
membros	membri
altura	altezza
nada	nulla
nada	niente
longo	lungo
cor	colore
direção	direzione
isto	questo
nível	livello
imagem	immagine
usuário	utente
diferentes	differenti
diferentes	diversi
homem	uomo
conhecida	conosciuta
criação	creazione
border	border
silva	silva
construção	costruzione
jogador	giocatore
televisão	televisione
social	sociale
social	social
revista	rivista
vitória	vittoria
união	unione
cultura	cultura
canal	canale
http	http
color	color
força	forza
principalmente	soprattutto
lançamento	lancio
personagem	personaggio
estilo	stile
prêmio	premio
território	territorio
world	world
será	sarà
mãe	mamma
primeiros	primi
europa	europa
existe	esiste
nunca	mai
movimento	movimento
santos	santi
you	you
pessoa	persona
cruz	croce
espanha	spagna
possível	possibile
fonte	fonte
bairro	quartiere
acima	sopra
filha	figlia
liga	lega
vice	vice
diversos	varie
from	from
sim	sì
sociedade	società
império	impero
episódio	episodio
batalha	battaglia
metros	metri
seed	seed
cidades	citta
americana	americana
espaço	spazio
único	unico
baixo	basso
deus	dio
paris	parigi
professor	insegnante
professor	professore
modelo	modello
alemão	tedesco
administrativa	amministrativa
musical	musical
meu	mio
cobertos	coperti
localizado	localizzato
páginas	pagine
oeste	ovest
informações	informazioni
chamada	chiamata
seguintes	seguenti
ator	attore
popular	popolare
novamente	nuovamente
última	ultima
luta	lotta
disco	disco
estes	questi
criado	creato
estende	estende
francês	francese
festival	festival
especial	speciale
algum	alcuno
teatro	teatro
seis	sei
considerado	considerato
minha	mia
problemas	problemi
superior	superiore
serviço	servizio
cinema	cinema
disse	detto
nossa	nostra
participação	partecipazione
membro	membro
filhos	figli
modo	modalità
grupos	gruppi
usado	usato
antigo	antico
resultado	risultato
atriz	attrice
existem	esistono
meses	mesi
estúdio	monolocale
código	codice
momento	momento
iii	iii
antiga	antica
instituto	istituto
autor	autore
chegou	arrivato
chegou	arrivata
forte	forte
única	unica
david	david
amor	amore
terceiro	terzo
descoberto	scoperto
alto	alto
termo	termine
geralmente	generalmente
san	san
mulher	donna
parece	sembra
densidade	densità
luís	luigi
fica	rimani
fica	resta
edições	edizioni
itália	italia
irmão	fratello
conteúdo	contenuto
causa	causa
elenco	cast
japão	giappone
terceira	terza
personagens	personaggi
vista	vista
formação	formazione
apoio	sostegno
rádio	radio
favor	favore
torneio	torneo
organização	organizzazione
museu	museo
educação	istruzione
histórico	storico
peso	peso
alta	alta
participou	partecipato
áreas	aree
homens	uomini
valor	valore
velocidade	velocità
profissional	professionale
problema	problema
jovem	giovane
forças	forze
livre	libero
tema	tema
novos	nuovi
associação	associazione
vivo	vivo
minas	mine
natural	naturale
sete	sette
tenha	abbia
estudos	studi
cantora	cantante
zona	zona
votos	voti
ganhou	vinto
criar	creare
parque	parco
castelo	castello
representa	rappresenta
tais	tali
próximo	vicino
sentido	senso
função	funzione
etc	etc
etc	ecc
nenhum	nessun
algo	qualcosa
ambos	entrambi
jorge	giorgio
jornal	giornale
manuel	manuel
poderia	potrebbe
james	james
show	spettacolo
show	show
inglaterra	inghilterra
life	life
branco	bianco
acesso	accesso
fernando	fernando
york	york
conselho	consiglio
guitarra	chitarra
roma	roma
verão	estate
manter	mantenere
manter	mantieni
fosse	fosse
interior	interno
dar	dare
livros	libri
love	love
asteróide	asteroide
olímpicos	olimpici
londres	londra
anterior	precedente
classe	classe
acho	credo
acho	penso
fazendo	facendo
importantes	importanti
evento	evento
companhia	compagnia
united	united
capacidade	capacità
novas	nuove
governador	governatore
leste	est
noite	notte
energia	energia
casos	casi
contém	contiene
senhora	signora
nomes	nomi
ministro	ministro
simples	semplice
fala	parla
luz	luce
horas	ore
unido	unito
imperador	imperatore
competição	competizione
príncipe	principe
william	william
civil	civile
serviços	servizi
vale	vale
ação	azione
bastante	abbastanza
futebolista	calciatore
apresenta	presenta
paul	paul
michael	michael
escrito	scritto
eleito	eletto
saúde	salute
teria	avrebbe
produtor	produttore
conseguiu	riuscito
fundação	fondazione
faixa	traccia
faixa	fascia
group	group
verdade	verissimo
verdade	vero
estas	queste
criada	creata
melhores	migliori
menor	minore
internet	internet
decisão	decisione
estrutura	struttura
abaixo	sotto
abaixo	abbasso
der	der
conde	conte
ajuda	aiuto
bandeira	bandiera
ensino	insegnamento
inclinação	inclinazione
music	music
escritor	scrittore
ngc	ngc
pedido	richiesta
semana	settimana
pesquisa	ricerca
excentricidade	eccentricità
teoria	teoria
méxico	messico
jesus	gesù
robert	robert
locais	luoghi
oliveira	oliveira
black	black
top	top
madeira	legno
medalha	medaglia
paulista	paulista
solo	suolo
trabalhos	lavori
china	cina
passa	passa
mulheres	donne
questão	questione
globo	globo
campos	campi
esposa	moglie
demais	troppo
cultural	culturale
alguém	qualcuno
wiki	wiki
objetivo	obiettivo
verde	verde
luiz	luiz
destaque	evidenziazione
destaque	evidenza
eua	usa
pessoal	personale
sub	sub
técnico	tecnico
nenhuma	nessuna
pequena	piccola
direitos	diritti
with	with
eventos	eventi
argentina	argentina
editor	editore
editor	editor
usar	usare
áfrica	africa
chefe	capo
flora	flora
set	set
palácio	palazzo
quer	vuoi
quer	vuole
qualidade	qualità
referências	riferimenti
solid	solid
regras	regole
metal	metallo
regiões	regioni
proposta	proposta
vocal	vocale
dizer	dire
mercado	mercato
aparece	compare
referência	riferimento
via	via
voz	voce
títulos	titoli
canções	canzoni
bateria	batteria
empresas	aziende
empresas	imprese
records	records
letras	lettere
feminino	femminile
padrão	predefinito
padrão	standard
dez	dieci
miguel	michele
resultados	risultati
responsável	responsabile
tinham	avevano
usuários	utenti
defesa	difesa
episódios	episodi
von	von
ilhas	isole
minutos	minuti
administração	amministrazione
pequeno	piccolo
campanha	campagna
atividades	attività
red	red
prefeito	sindaco
prefeito	prefetto
duque	duca
bgcolor	bgcolor
escrita	scrittura
povo	popolo
material	materiale
imagens	immagini
segurança	sicurezza
especialmente	specialmente
situação	situazione
presença	presenza
equipes	squadre
jogadores	giocatori
nomeado	nominato
partida	partenza
realizado	realizzato
artista	artista
classificação	classificazione
cantor	cantante
pop	pop
global	global
global	globale
eliminação	eliminazione
seguida	seguita
ataque	attacco
papa	papa
missão	missione
raio	raggio
devem	devono
devem	dovrebbero
termos	termini
antónio	antonio
palavra	parola
henrique	enrico
compositor	compositore
significa	significa
plano	piano
interesse	interesse
cabo	cavo
left	left
voto	voto
economia	economia
curso	corso
baixa	bassa
programas	programmi
ferro	ferro
des	des
masculino	maschile
armas	armi
deixar	lasciare
álbuns	album
comando	comando
produtos	prodotti
científica	scientifica
inicialmente	inizialmente
dado	dato
sistemas	sistemi
website	website
marca	marca
nacionalidade	nazionalità
nacionalidade	cittadinanza
volume	volume
italiano	italiano
médio	medio
estudo	studio
faixas	tracce
fronteira	confine
vem	vieni
super	super
relatório	relazione
predefinição	predefinito
estrada	strada
caminho	percorso
serra	serra
rainha	regina
faculdade	college
características	caratteristiche
casamento	matrimonio
mal	male
mal	mal
primeiras	prime
usando	utilizzando
usando	usando
formato	formato
relevância	pertinenza
lima	lima
polícia	polizia
unidade	unità
levou	portò
nascimento	nascita
pré	pre
romano	romano
states	states
mês	mese
charles	charles
opinião	opinione
van	van
crianças	bambini
claro	chiaro
quarto	camera
quarto	stanza
espírito	spirito
publicado	pubblicato
saber	sapere
jean	jean
sexo	sesso
baseado	basato
artistas	artisti
carvalho	quercia
espanhol	spagnolo
oito	otto
azul	blu
ocidental	occidentale
diferente	diverso
species	species
ficar	stare
palavras	parole
fundada	fondata
conhecimento	conoscenza
prata	argento
digital	digitale
city	city
usada	usata
paz	pace
animais	animali
voltou	tornato
tornar	rendere
eduardo	edoardo
amigo	amico
alegre	allegro
nascido	nato
monte	monte
praia	spiaggia
necessário	necessario
importância	importanza
rússia	russia
natal	natale
pereira	pereira
últimos	ultimi
eleições	elezioni
provavelmente	probabilmente
romance	romanzo
entrou	entrato
entrou	entrò
deveria	dovrebbe
britânico	britannico
atenção	attenzione
razão	ragione
disputa	disputa
amigos	amici
press	press
distribuição	distribuzione
velho	vecchio
políticas	politiche
senhor	signore
crítica	critica
roberto	roberto
aumento	aumento
católica	cattolica
condições	condizioni
nice	nizza
comunicação	comunicazione
cabeça	testa
jardim	giardino
sabe	sai
sabe	sa
lançada	lanciata
estimada	stimata
web	web
ciências	scienze
entrada	ingresso
realizada	realizzata
tempos	tempi
terras	terre
tom	tom
independente	indipendente
técnica	tecnica
comercial	commerciale
#aaa	#aaa
sol	sole
biodiversity	biodiversity
mestre	maestro
mestre	padrone
las	las
online	online
tipos	tipi
abertura	apertura
andré	andré
critérios	criteri
bispo	vescovo
all	all
prática	pratica
ministério	ministero
ana	ana
contrário	contrario
capitão	capitano
ambiente	ambiente
futuro	futuro
física	fisica
aeroporto	aeroporto
tornando	rendendo
peter	peter
quantidade	quantità
originalmente	originariamente
mandato	mandato
diagrama	diagramma
militares	militari
tamanho	dimensione
tamanho	dimensioni
link	link
inclui	include
encontrar	trovare
praça	piazza
considerada	considerata
normalmente	normalmente
terminou	finito
bahia	bahia
estrela	stella
finalmente	finalmente
richard	richard
justiça	giustizia
mostra	mostra
atrás	dietro
americanos	americani
indústria	industria
thomas	thomas
existência	esistenza
xix	xix
mapa	mappa
mudou	cambiato
italiana	italiana
possuem	possiedono
massa	massa
domínio	dominio
recursos	risorse
tecnologia	tecnologia
austrália	australia
som	suono
talvez	forse
man	man
nota	nota
comércio	commercio
autoridade	autorità
estou	sto
natureza	natura
formas	forme
respeito	rispetto
linhas	linee
linhas	righe
califórnia	california
deputado	deputato
ponte	ponte
fundo	sfondo
international	international
combate	combattimento
humanos	umani
roteiro	sceneggiatura
altitude	altitudine
bureau	bureau
passado	passato
pais	genitori
saint	saint
literatura	letteratura
treinador	allenatore
salvador	salvatore
vermelho	rosso
nós	noi
org	org
vol	vol
brasileiros	brasiliani
escolas	scuole
https	https
tropas	truppe
trabalhar	lavorare
homenagem	omaggio
canadá	canada
ciência	scienza
revolução	rivoluzione
engenharia	ingegneria
fogo	fuoco
naturais	naturali
oficiais	ufficiali
daniel	daniel
ferreira	ferreira
funções	funzioni
live	live
catarina	caterina
colocar	mettere
comentários	commenti
distância	distanza
tratado	trattato
ninguém	nessuno
comissão	commissione
poucos	pochi
composta	composta
corte	taglio
irmãos	fratelli
preto	nero
contrato	contratto
prêmios	premi
passar	passare
realmente	veramente
realmente	davvero
transporte	trasporto
one	one
dom	dono
dom	dom
motivo	motivo
motivo	movente
tradução	traduzione
federação	federazione
administrador	amministratore
permite	permette
banco	banca
rosa	rosa
faço	faccio
irmã	sorella
longa	lunga
mudança	cambiamento
regional	regionale
crescimento	crescita
metade	metà
religião	religione
trabalhou	lavorato
paraná	paraná
veio	venuto
cristo	cristo
jornalista	giornalista
análise	analisi
sejam	siate
editores	editori
mensagem	messaggio
festa	festa
cena	scena
capela	cappella
médico	medico
ligação	collegamento
angeles	angeles
resposta	risposta
comandante	comandante
categorias	categorie
edifício	edificio
pedra	pietra
planeta	pianeta
comprimento	lunghezza
índia	india
tiveram	ebbero
jovens	giovani
leão	leone
projetos	progetti
nordeste	nordest
versões	versioni
independência	indipendenza
tenho	ho
operação	operazione
tentativa	tentativo
sei	so
certo	giusto
avenida	viale
augusto	augusto
fazem	fanno
russo	russo
veja	vedi
liberdade	libertà
conceito	concetto
anteriores	precedenti
torre	torre
localização	ubicazione
localização	posizione
asteroides	asteroidi
alexandre	alessandro
feira	fiera
chegar	arrivare
times	times
composto	composto
princesa	principessa
açores	azzorre
partidas	partenze
simplesmente	semplicemente
ribeiro	ribeiro
hospital	ospedale
don	don
nações	nazioni
histórias	storie
mão	mano
filosofia	filosofia
pertence	appartiene
efeito	effetto
www	www
viagem	viaggio
sousa	sousa
construído	costruito
esquerda	sinistra
leandro	leandro
martin	martin
peças	tessere
peças	pezzi
castro	castro
europeia	europea
coração	cuore
ricardo	riccardo
tradicional	tradizionale
sou	sono
ffffff	ffffff
american	american
colégio	collegio
guarda	guardia
motor	motore
desempenho	prestazioni
línguas	lingue
efeitos	effetti
colspan	colspan
visão	visione
especiais	speciali
cores	colori
guilherme	guglielmo
ajudar	aiutare
humano	umano
conflito	conflitto
dinheiro	denaro
dinheiro	soldi
imprensa	stampa
dvd	dvd
tour	tour
finais	finali
inicial	iniziale
rapidamente	rapidamente
fundado	fondato
porta	porta
relacionados	correlati
oficialmente	ufficialmente
that	that
superfície	superficie
ações	azioni
comentário	commento
medida	misura
jack	jack
national	national
oriental	orientale
constituição	costituzione
memória	memoria
biblioteca	biblioteca
medicina	medicina
peça	pezzo
vão	andate
semanas	settimane
fundador	fondatore
regra	regola
tratamento	trattamento
europeu	europeo
google	google
temas	temi
passando	passando
rodrigues	rodrigues
perdeu	perso
aberto	aperto
passagem	passaggio
falar	parlare
notas	note
dando	dando
proteção	protezione
sonora	sonora
max	max
japonês	giapponese
geração	generazione
necessidade	necessità
fortaleza	fortezza
internacionais	internazionali
conheço	conosco
bronze	bronzo
romana	romana
áustria	austria
incluem	includono
descoberta	scoperta
rowspan	rowspan
satélite	satellite
svg	svg
participar	partecipare
botânico	botanico
miss	miss
mata	uccide
mata	uccidi
imperial	imperiale
imperial	imperial
vou	vado
gestão	gestione
marcos	marcos
luis	luis
lago	lago
arena	arena
henry	henry
comédia	commedia
relevante	rilevante
pequenas	piccole
extensão	estensione
smith	smith
números	numeri
direita	destra
isabel	elisabetta
anteriormente	precedentemente
completamente	completamente
candidato	candidato
morto	morto
padre	prete
evitar	evitare
rocha	roccia
king	king
madrid	madrid
alberto	alberto
history	history
difícil	difficile
casas	case
assembleia	assemblea
césar	cesare
utilizada	utilizzata
portugueses	portoghesi
gomes	gomes
mudanças	cambiamenti
afonso	alfonso
fórmula	formula
experiência	esperienza
awards	awards
curta	breve
composição	composizione
método	metodo
capaz	capace
obrigado	grazie
semelhante	simile
expressão	espressione
templo	tempio
tribunal	corte
tribunal	tribunale
escrever	scrivere
encontram	trovano
conhecidos	conosciuti
conhecidos	conoscenti
famoso	famoso
lee	lee
soldados	soldati
quarta	quarta
prefeitura	prefettura
continua	continua
soviética	sovietica
vencedor	vincitore
estrelas	stelle
famílias	famiglie
políticos	politici
disponível	disponibile
desenvolvido	sviluppato
programação	programmazione
bandas	bande
eleição	elezione
letra	lettera
software	software
white	white
tradição	tradizione
pequenos	piccoli
grego	greco
decreto	decreto
flores	fiori
star	star
encontrada	trovata
autores	autori
rios	fiumi
taxa	tasso
doença	malattia
entrar	entrare
valores	valori
navio	nave
nove	nove
alex	alex
singles	singles
singles	singole
águas	acque
princípio	principio
suficiente	sufficiente
washington	washington
comportamento	comportamento
perfil	profilo
universo	universo
juan	juan
secretário	segretario
humana	umana
piloto	pilota
mãos	mani
descrita	descritta
meia	mezza
horizonte	orizzonte
till	till
feitas	fatte
completo	completo
tentar	provare
aconteceu	accadde
próxima	prossima
tropical	tropicale
anunciou	annunciato
contexto	contesto
corrida	corsa
linguagem	linguaggio
sangue	sangue
lucas	luca
pena	piuma
image	image
park	park
matemática	matematica
regime	regime
universal	universal
universal	universale
diretamente	direttamente
les	les
conquista	conquista
almeida	almeida
die	die
apareceu	apparve
apareceu	apparso
caixa	scatola
moderna	moderna
produto	prodotto
gol	gol
atlético	atletico
marido	marito
temos	abbiamo
operações	operazioni
cópias	copie
temperatura	temperatura
bruno	bruno
plantas	piante
publicação	pubblicazione
joseph	joseph
transmissão	trasmissione
acaba	finisci
mínimo	minimo
suécia	svezia
sequência	sequenza
máximo	massimo
night	night
ataques	attacchi
poeta	poeta
instituição	istituzione
participantes	partecipanti
reúne	riunisce
individual	individuale
inverno	inverno
walter	walter
desenho	disegno
portal	portale
can	can
ambas	entrambe
técnicas	tecniche
exposição	esposizione
perda	perdita
declaro	dichiaro
pintura	dipinto
pintura	pittura
enciclopédia	enciclopedia
carioca	carioca
congresso	congresso
bibliografia	bibliografia
drama	dramma
this	this
brasília	brasilia
criança	bambino
recentemente	recentemente
realizar	realizzare
receber	ricevere
modelos	modelli
espacial	spaziale
séculos	secoli
apresentação	presentazione
linear	lineare
bairros	quartieri
links	link
mark	mark
marcelo	marcelo
prisão	prigione
art	art
igual	uguale
derrota	sconfitta
evolução	evoluzione
concurso	concorso
planta	pianta
suíça	svizzera
realidade	realtà
piano	pianoforte
clima	clima
entrevista	intervista
jones	jones
normal	normale
administradores	amministratori
construída	costruita
gravação	registrazione
segue	segui
version	version
ascensão	ascensione
martins	martins
engenheiro	ingegnere
vandalismo	vandalismo
dizendo	dicendo
israel	israele
alves	alves
big	big
exemplos	esempi
gravado	registrato
gravado	inciso
baixos	bassi
shows	spettacoli
figura	figura
pressão	pressione
aérea	aerea
escala	scala
cursos	corsi
chris	chris
mato	uccido
poderes	poteri
grau	grado
erro	errore
fifa	fifa
chega	arriva
consiste	consiste
mudar	cambiare
billboard	billboard
your	your
house	house
tabela	tabella
complexo	complesso
arquitetura	architettura
chave	chiave
muita	molta
vinte	venti
ponta	punta
iucn	iucn
barra	barra
manutenção	manutenzione
louis	louis
frank	frank
joaquim	joaquim
fusão	fusione
out	out
und	und
saída	uscita
gente	gente
mortos	morti
duração	durata
samba	samba
parceria	partenariato
mário	mario
best	best
navios	navi
ásia	asia
olímpico	olimpico
usados	usati
diferença	differenza
aqueles	quelli
harry	harry
deixa	lascia
filipe	filippo
profissionais	professionisti
encontro	appuntamento
permaneceu	rimasto
coronel	colonnello
velha	vecchia
galáxia	galassia
dança	danza
deixando	lasciando
completa	completa
movimentos	movimenti
sinal	segno
league	league
olhos	occhi
reforma	riforma
voltar	tornare
solução	soluzione
processos	processi
inferior	inferiore
apresentado	presentato
contato	contatto
escolha	scegli
críticas	critiche
diocese	diocesi
reais	reali
disney	disney
setor	settore
gabriel	gabriele
presentes	regali
trono	trono
ben	ben
queda	caduta
santiago	santiago
braga	braga
crise	crisi
obter	ottenere
royal	royal
encontrado	trovato
quinto	quinto
wilson	wilson
terá	avrà
latina	latina
hall	hall
nosso	nostro
record	record
biografia	biografia
apagar	cancellare
química	chimica
casal	coppia
núcleo	nucleo
grécia	grecia
neto	nipote
podemos	possiamo
fazenda	fattoria
band	band
dólares	dollari
sérvia	serbia
ato	atto
ato	ato
queria	voleva
queria	volevo
resistência	resistenza
acidente	incidente
indivíduos	individui
conclusão	conclusione
instituições	istituzioni
torres	torres
menores	minorenni
menores	minori
décadas	decenni
recebe	riceve
barcelona	barcellona
células	celle
antigas	antiche
antigas	vecchie
game	game
apresentar	presentare
oscar	oscar
respectivamente	rispettivamente
crime	crimine
hot	hot
possibilidade	possibilità
grand	grand
infantaria	fanteria
retorno	ritorno
scott	scott
seriam	sarebbero
estudantes	studenti
pesquisas	ricerche
ramos	rami
machado	ascia
brown	brown
rodrigo	rodrigo
definição	definizione
músico	musicista
xvi	xvi
realização	realizzazione
aquele	quello
rótulo	etichetta
pan	pan
solar	solare
expansão	espansione
praticamente	praticamente
tomar	prendere
ufc	ufc
serão	saranno
chegada	arrivo
segundos	secondi
chile	cile
medalhas	medaglie
sudeste	sudest
jackson	jackson
berlim	berlino
agricultura	agricoltura
souza	souza
questões	questioni
fotografia	fotografia
concordo	concordo
dinastia	dinastia
gelo	ghiaccio
coimbra	coimbra
design	design
fauna	fauna
materiais	materiali
franco	franco
xviii	xviii
texas	texas
cenas	scene
chamados	chiamati
disputou	disputato
west	west
vendas	vendite
martinez	martinez
símbolo	simbolo
tony	tony
fãs	tifosi
rafael	raffaele
oceano	oceano
negócios	affari
taxonomy	taxonomy
joe	joe
posse	possesso
destino	destinazione
wrestling	wrestling
produzida	prodotta
coroa	corona
introdução	introduzione
motivos	motivi
consultado	consultato
aldeia	villaggio
coleção	collezione
day	day
turno	turno
ceará	ceará
catedral	cattedrale
exterior	esterno
formar	formare
infantil	infantile
acontece	succede
acontece	accade
mídia	media
flor	fiore
lopes	lopes
christian	christian
troca	scambio
ficção	fiction
mike	mike
risco	rischio
juntos	insieme
jogar	giocare
reconhecimento	riconoscimento
afirma	afferma
oposição	opposizione
heritage	heritage
clássico	classico
fácil	facile
passo	passo
carga	carico
fortes	forti
felipe	felipe
noroeste	nordovest
vontade	volontà
honra	onore
romanos	romani
orchidaceae	orchidaceae
aires	aires
oriente	oriente
meios	mezzi
diego	diego
avaliação	valutazione
barão	barone
chicago	chicago
zero	zero
tentou	provato
conhecer	conoscere
níveis	livelli
pernambuco	pernambuco
populares	popolari
advogado	avvocato
orquestra	orchestra
rural	rurale
pista	pista
threatened	threatened
viver	vivere
anti	anti
carnaval	carnevale
estações	stazioni
veículos	veicoli
are	are
ganhar	vincere
erros	errori
condição	condizione
gama	gamma
chama	chiama
sérgio	sergio
egito	egitto
windows	windows
continental	continentale
continental	continental
brian	brian
indicado	indicato
saiu	uscito
saiu	uscì
executivo	esecutivo
editar	modifica
capa	copertina
atacante	attaccante
arquipélago	arcipelago
peru	perù
steve	steve
prorrogada	prorogata
competições	concorsi
podendo	potendo
cavaleiro	cavaliere
diário	diario
voo	volo
horário	orario
chegando	arrivando
plataforma	piattaforma
ciclo	ciclo
serve	serve
etapa	tappa
ncbi	ncbi
árabe	arabo
aplicação	applicazione
senado	senato
golpe	colpo
parlamento	parlamento
povos	popoli
indicações	indicazioni
dito	detto
constante	costante
notícias	notizie
jogou	giocato
igrejas	chiese
turismo	turismo
cobertura	copertura
enorme	enorme
pierre	pierre
geografia	geografia
mtv	mtv
continuar	continuare
europaea	europaea
trabalhadores	lavoratori
pintor	pittore
poesia	poesia
floresta	foresta
gostaria	vorrei
eric	eric
lua	luna
arthur	arthur
disciplina	disciplina
company	company
utilizados	utilizzati
young	young
vitórias	vittorie
árvore	albero
invasão	invasione
fox	fox
casado	sposato
intitulado	intitolato
pinto	pinto
sofreu	sofferto
fotos	foto
vermelha	rossa
relativamente	relativamente
construir	costruire
península	penisola
fazia	faceva
poucas	poche
juventude	gioventù
propriedades	proprietà
café	caffè
físico	fisico
irlanda	irlanda
elemento	elemento
pro	pro
deputados	deputati
imediatamente	immediatamente
territórios	territori
venda	vendita
boas	buone
juiz	giudice
vejo	vedo
matéria	materia
face	face
planos	piani
presidência	presidenza
infância	infanzia
williams	williams
arquivo	archivio
corrente	corrente
curitiba	curitiba
edward	edward
title	title
melhorar	migliorare
determinado	determinato
residência	residenza
fabiano	fabiano
sair	uscire
cristã	cristiana
imdb	imdb
aparentemente	apparentemente
posições	posizioni
discos	dischi
direcção	direzione
victor	victor
boca	bocca
independentes	indipendenti
teste	test
designação	designazione
santana	santana
not	not
bola	palla
exibido	visualizzato
levando	portando
bob	bob
organizações	organizzazioni
buenos	buenos
extremamente	estremamente
alexander	alexander
arco	arco
interpretação	interpretazione
autoria	authoring
blue	blue
preso	arrestato
distritos	distretti
entertainment	entertainment
limite	limite
órgão	organo
alemães	tedeschi
matriz	matrice
colocação	collocamento
empresário	imprenditore
viu	visto
viu	vide
frase	frase
urbana	urbana
anual	annuale
carolina	carolina
detalhes	dettagli
oxford	oxford
ocasião	occasione
graduação	graduazione
produzir	produrre
london	london
eliminado	eliminato
girl	girl
críticos	critici
princípios	principi
vasco	vasco
passageiros	passeggeri
performance	performance
guitarrista	chitarrista
bélgica	belgio
agência	agenzia
back	back
pico	picco
famosa	famosa
desenvolver	sviluppare
latim	latino
leite	latte
recente	recente
what	what
sucessor	successore
senador	senatore
angola	angola
alterações	modifiche
dinamarca	danimarca
divulgação	divulgazione
will	will
bill	bill
doze	dodici
arma	arma
servidor	server
south	south
custo	costo
intenção	intenzione
peixe	pesce
substituído	sostituito
longe	lontano
coreia	corea
existentes	esistenti
margem	margine
exceto	tranne
meias	calze
execução	esecuzione
fluminense	fluminense
representante	rappresentante
sudoeste	sudovest
palco	palco
palco	palcoscenico
estruturas	strutture
apresentam	presentano
músicos	musicisti
doce	dolce
paraíba	paraíba
ferramentas	strumenti
ferramentas	attrezzi
gonçalves	gonçalves
florestas	foreste
alvo	bersaglio
guerras	guerre
aliança	alleanza
fernandes	fernandes
céu	cielo
mendes	mendes
cenário	scenario
right	right
milhares	migliaia
descrição	descrizione
especificamente	specificamente
documentos	documenti
folhas	foglie
soares	soares
nuclear	nucleare
frederico	federico
bretanha	bretagna
nação	nazione
agente	agente
chamar	chiamare
domingo	domenica
sexual	sessuale
escolhido	scelto
considerados	considerati
tivesse	avesse
rápido	veloce
posso	posso
índice	indice
campeã	campionessa
tradicionais	tradizionali
selo	sigillo
redes	reti
constelação	costellazione
poderiam	potrebbero
nelson	nelson
criador	creatore
service	service
tropicais	tropicali
rico	ricco
similar	simile
high	high
promoção	promozione
alpes	alpi
promover	promuovere
identidade	identità
artístico	artistico
europeus	europei
johnson	johnson
anexo	allegato
característica	caratteristica
rica	ricca
representação	rappresentazione
representação	rappresentanza
insetos	insetti
judeus	ebrei
atlântico	atlantico
caráter	carattere
variedade	varietà
realizadas	realizzate
state	state
propaganda	propaganda
contas	conti
cruzeiro	crociera
taylor	taylor
possivelmente	possibilmente
votar	votare
medidas	misure
suporte	supporto
cartas	carte
gás	gas
vieira	vieira
leitura	lettura
recebido	ricevuto
possuía	possedeva
galeria	galleria
colônia	colonia
nobre	nobile
encontrados	trovati
decide	decidi
decide	decide
long	long
expedição	spedizione
esperança	speranza
indica	indica
circuito	circuito
audiência	udienza
astronomia	astronomia
missões	missioni
alma	anima
particularmente	particolarmente
opção	opzione
titular	titolare
melo	melo
revolta	rivolta
dance	dance
significado	significato
sam	sam
leonardo	leonardo
discussões	discussioni
street	street
aberta	aperta
fossem	fossero
mosteiro	monastero
profissão	professione
atletas	atleti
órbita	orbita
limites	limiti
cara	faccia
critério	criterio
franceses	francesi
atores	attori
unidas	unite
jornais	giornali
kim	kim
perder	perdere
potencial	potenziale
legal	legale
canto	canto
roger	roger
diâmetro	diametro
júlio	giulio
entra	entra
andrade	andrade
econômico	economico
rui	rui
capítulo	capitolo
mineiro	minatore
dúvida	dubbio
métodos	metodi
elétrica	elettrica
defender	difensore
defender	difendere
goiás	goiás
marcado	segnato
marcado	marcato
entidade	entità
dicionário	dizionario
estréia	debutto
originais	originali
php	php
líderes	leader
jazz	jazz
little	little
batista	batista
png	png
seres	esseri
urbano	urbano
pele	pelle
podia	poteva
podia	potevo
reunião	riunione
colômbia	colombia
was	was
miranda	miranda
society	society
dividida	divisa
frequência	frequenza
quadrinhos	fumetti
quadrinhos	fumetto
pensamento	pensiero
mail	mail
revistas	riviste
tenente	tenente
paróquia	parrocchia
noruega	norvegia
indicação	indicazione
parada	parata
power	power
paula	paola
paula	paula
montanha	montagna
escócia	scozia
war	war
quero	voglio
aparição	apparizione
montanhas	montagne
chico	chico
aumentar	aumentare
colaboração	collaborazione
adaptação	adattamento
transformada	trasformata
denominação	denominazione
major	major
conflitos	conflitti
ácido	acido
hugo	hugo
impacto	impatto
classes	classi
acacia	acacia
sebastião	sebastiano
gêneros	generi
extra	extra
mistura	miscela
herói	eroe
recentes	recenti
províncias	province
frota	flotta
possuir	possedere
inimigos	nemici
home	home
xvii	xvii
diga	dite
diga	dica
continente	continente
punk	punk
anthony	anthony
centros	centri
lógica	logica
dona	dona
dona	proprietaria
dona	padrona
anderson	anderson
personalidade	personalità
manhã	mattinata
manhã	mattina
representantes	rappresentanti
notável	notevole
aniversário	compleanno
hungria	ungheria
começar	iniziare
edifícios	edifici
doutor	dottore
matar	uccidere
moderno	moderno
liderança	leadership
lança	lancia
troféu	trofeo
faria	farebbe
convidado	ospite
convidado	invitato
hill	hill
mesa	tavolo
revisão	revisione
inimigo	nemico
aquela	quella
citação	citazione
conceição	conceição
simon	simon
cristãos	cristiani
aves	uccelli
fábrica	fabbrica
visita	visita
stone	stone
escritos	scritti
flag	flag
assistente	assistente
existir	esistere
sur	sur
flamengo	fiammingo
silveira	silveira
contendo	contenente
âmbito	ambito
boy	boy
villa	villa
green	green
chinês	cinese
proprietário	proprietario
trabalha	lavora
cunha	cuneo
razões	motivi
facilmente	facilmente
aviso	avvertimento
aviso	avviso
doenças	malattie
ribeira	ribeira
competiu	gareggiato
ray	ray
participações	partecipazioni
bloqueado	bloccato
remix	remix
visual	visivo
visual	visual
fama	fama
conferência	conferenza
oferece	offre
útil	utile
coluna	colonna
teixeira	teixeira
disputada	disputata
indo	andando
aliados	alleati
exatamente	esattamente
vii	vii
comunista	comunista
reação	reazione
protagonista	protagonista
fatos	fatti
disponíveis	disponibili
tempestade	tempesta
pedidos	richieste
estrangeiros	stranieri
oportunidade	opportunità
folha	foglio
bernardo	bernardo
situa	situa
series	series
atleta	atleta
criados	creati
teresa	teresa
terminal	terminale
medo	paura
domingos	domenico
domingos	domeniche
alice	alice
classificado	classificato
hollywood	hollywood
uruguai	uruguay
anime	anime
veículo	veicolo
desejo	desiderio
livres	liberi
onda	onda
inaugurado	inaugurato
derrotado	sconfitto
professores	insegnanti
who	who
documentário	documentario
ciclista	ciclista
garcia	garcia
canadense	canadese
terreno	terreno
animação	animazione
guia	guida
caça	caccia
arcebispo	arcivescovo
violência	violenza
dan	dan
contribuições	contributi
órgãos	organi
venezuela	venezuela
corinthians	corinthians
estudar	studiare
formando	formando
sbt	sbt
resolução	risoluzione
diferenças	differenze
eurovisão	eurovisione
apelido	cognome
ave	ave
responsabilidade	responsabilità
avião	aereo
sinais	segni
sinais	segnali
equivalente	equivalente
conhece	conosce
licença	licenza
aparecem	compaiono
aparecem	appaiono
mix	mix
formam	formano
cardoso	cardoso
dividido	diviso
pictures	pictures
pés	piedi
air	air
destacado	distaccato
pacífico	pacifico
relacionamento	rapporto
tópico	soggetto
name	name
part	part
alan	alan
bizantino	bizantino
festas	festeggiamenti
rtp	rtp
barbosa	barbosa
lojas	negozi
figuras	figure
like	like
albert	albert
tio	zio
atualizado	aggiornato
belém	betlemme
coelho	coniglio
proteger	proteggere
possam	possano
errado	sbagliato
cardeal	cardinale
bens	beni
braço	braccio
bloco	blocco
reconhecido	riconosciuto
junta	giunta
religioso	religioso
way	way
notáveis	notevoli
viena	vienna
first	first
clássica	classica
ópera	opera
possíveis	possibili
marie	marie
salão	salone
bragança	braganza
amazonas	amazzoni
situações	situazioni
volumes	volumi
france	france
voleibol	pallavolo
legislação	legislazione
semelhantes	simili
chaves	chiavi
peço	chiedo
exceção	eccezione
direto	diretto
darwin	darwin
end	end
round	round
mateus	matteo
consumo	consumi
consumo	consumo
listas	liste
listas	elenchi
tim	tim
motores	motori
portas	porte
canais	canali
campinas	campinas
tiago	giacomo
camisa	camicia
iniciativa	iniziativa
north	north
últimas	ultime
redução	riduzione
funcionamento	funzionamento
helena	elena
cônjuge	coniuge
cavalo	cavallo
tiro	tiro
guimarães	guimarães
pior	peggio
largo	largo
goleiro	portiere
prima	cugina
contos	racconti
trinta	trenta
mensagens	messaggi
baía	baia
atos	atti
last	last
hans	hans
rita	rita
jim	jim
comics	comics
death	death
maranhão	maranhão
trabalhando	lavorare
marquês	marchese
publicações	pubblicazioni
índios	indiani
catálogo	catalogo
civis	civili
proponente	proponente
proponente	offerente
playstation	playstation
barros	barros
tribo	tribù
alimentos	alimenti
escravos	schiavi
castela	castiglia
sites	siti
corpos	corpi
candidatos	candidati
milhão	milione
concerto	concerto
existente	esistente
vento	vento
skin	skin
resolver	risolvere
turquia	turchia
ferramenta	strumento
momentos	momenti
menino	ragazzo
promovido	promosso
assassinato	omicidio
altos	alti
grave	grave
lewis	lewis
fatores	fattori
convento	convento
permanente	permanente
instalação	installazione
karl	karl
socialista	socialista
argentino	argentino
exclusivamente	esclusivamente
anna	anna
carl	carl
status	status
interessante	interessante
mor	mor
davis	davis
lagoa	lagoa
zonas	zone
contratado	assunto
lados	lati
association	association
galáxias	galassie
secção	sezione
catalogue	catalogue
moths	moths
representou	rappresentava
crítico	critico
enciclopédico	enciclopedica
marques	marques
brasão	stemma
rugby	rugby
preta	nera
representando	rappresentando
ajudou	aiutato
regionais	regionali
responsáveis	responsabili
jan	jan
amarelo	giallo
guiné	guinea
considerando	considerando
mister	mister
interpretada	interpretata
nascida	nata
aux	aux
descendentes	discendenti
inc	inc
cidadãos	cittadini
salvar	salvare
gravações	registrazioni
árbitro	arbitro
duarte	duarte
cadeia	catena
orientação	orientamento
adam	adam
hits	hits
opções	opzioni
gustavo	gustavo
sir	sir
funcionários	dipendenti
checa	ceca
pib	pil
documento	documento
bons	bravi
bacia	bacino
paraguai	paraguay
margens	margini
ausência	assenza
destruição	distruzione
douglas	douglas
permitindo	permettendo
permitindo	consentendo
ativo	attivo
country	country
usam	usano
casada	sposata
abreu	abreu
descrito	descritto
próximos	prossimi
salto	salto
tela	schermo
raça	razza
bilhões	miliardi
contar	contare
papéis	ruoli
cambridge	cambridge
carne	carne
propostas	proposte
baixas	basse
direta	diretta
lord	lord
marcada	marcata
tag	tag
medieval	medievale
servir	servire
lutar	lottare
lutar	combattere
indígenas	indigeni
palmeiras	palme
potência	potenza
imigrantes	immigrati
espada	spada
lançados	lanciati
funciona	funziona
vertical	verticale
árvores	alberi
sonho	sogno
assinatura	firma
certeza	certezza
organizado	organizzato
metrô	metropolitana
partidos	partiti
alternativa	alternativa
xavier	xavier
two	two
men	men
treinamento	addestramento
ficam	restano
wwe	wwe
lateral	laterale
mitologia	mitologia
renato	renato
necessária	necessaria
kevin	kevin
deveriam	dovrebbero
extremo	estremo
individuais	individuali
elite	elite
jong	jong
emprego	occupazione
científico	scientifico
maia	maya
vendido	venduto
divisões	divisioni
recepção	ricevimento
recepção	ricezione
recepção	reception
open	open
aviões	aerei
zelândia	zelanda
largura	larghezza
bruce	bruce
available	available
componentes	componenti
cemitério	cimitero
gonçalo	gonçalo
consequência	conseguenza
centenas	centinaia
monteiro	monteiro
petróleo	petrolio
permitir	permetti
paixão	passione
humanidade	umanità
song	song
lady	lady
aeronaves	aeromobili
atuar	recitare
basta	basta
citado	citato
correio	posta
superiores	superiori
orçamento	bilancio
específico	specifico
concentração	concentrazione
campus	campus
pinheiro	pino
caiu	caduto
mente	mente
botafogo	botafogo
artilharia	artiglieria
transferência	trasferimento
viva	viva
associado	associato
boston	boston
extinta	estinta
intervenção	intervento
heart	heart
missouri	missouri
altas	alte
famosos	famosi
mecânica	meccanica
arquiteto	architetto
fluxo	flusso
kelly	kelly
esforço	sforzo
vocês	voi
termina	termina
indivíduo	individuo
passos	passi
sexto	sesto
produtores	produttori
influências	influenze
vizinhos	vicini
atenas	atene
integração	integrazione
names	names
vargas	vargas
transportes	trasporti
crimes	crimini
cresceu	cresciuto
alcançar	raggiungimento
confederação	confederazione
décimo	decimo
pouca	poca
monumento	monumento
gil	gil
down	down
discurso	discorso
colonial	coloniale
telefone	telefono
paredes	muri
paredes	pareti
conservação	conservazione
ameaça	minaccia
bíblia	bibbia
pergunta	domanda
tese	tesi
declaração	dichiarazione
primo	cugino
holanda	olanda
lenda	leggenda
vítimas	vittime
ideal	ideale
chamadas	chiamate
aventura	avventura
pedras	pietre
araújo	araújo
plant	plant
desenhos	disegni
sucessão	successione
download	scaricare
aparência	aspetto
apresentações	presentazioni
garden	garden
observação	osservazione
enfrentar	affrontare
excelente	eccellente
descobrir	scoprire
chão	pavimento
lagos	lagos
valign	valign
johnny	johnny
nick	nick
definido	definito
confiança	fiducia
habilidade	abilità
árabes	arabi
finalizado	finalizzato
constituem	costituiscono
ginástica	ginnastica
his	his
blog	blog
açúcar	zucchero
angra	insenatura
laboratório	laboratorio
drogas	droghe
fases	fasi
jerusalém	gerusalemme
moda	moda
lançar	lanciare
doutrina	dottrina
povoado	popolato
samuel	samuel
samuel	samuele
determinada	determinata
eixo	asse
inteligência	intelligenza
space	space
escritores	scrittori
carregado	caricato
ford	ford
claramente	chiaramente
good	good
olho	occhio
jacques	jacques
blues	blues
dificuldade	difficoltà
costas	schiena
opiniões	recensioni
instalações	impianti
objetivos	obiettivi
ligado	connesso
ligado	acceso
alfredo	alfredo
passam	passano
parcial	parziale
aplicações	applicazioni
graça	grazia
inteiro	intero
descreve	descrive
descobriu	scoperto
protegida	protetta
stephen	stephen
marcas	marchi
cuba	cuba
tarefa	compito
círculo	cerchio
alcance	portata
universitário	universitario
consciência	coscienza
preço	prezzo
viii	viii
caminhos	percorsi
dedicado	dedicato
shopping	shopping
tavares	tavares
constitucional	costituzionale
bases	basi
andrew	andrew
story	story
vivem	vivono
empate	pareggio
ginásio	palestra
font	font
facebook	facebook
períodos	periodi
jason	jason
aprovação	approvazione
inaugurada	inaugurata
estrelado	stellato
teclado	tastiera
cavalaria	cavalleria
tomada	presa
aceita	accetta
extinção	estinzione
lobo	lupo
patrick	patrick
dead	dead
vídeos	video
convenção	convenzione
regimento	reggimento
perdendo	perdendo
espaços	spazi
editorial	editoriale
xiii	xiii
culto	culto
democracia	democrazia
billy	billy
moral	morale
microrregião	microregione
organizada	organizzata
retirar	ritirare
flórida	florida
get	get
calor	calore
provável	probabile
atletismo	atletica
irmãs	sorelle
constantinopla	costantinopoli
vítima	vittima
pede	chiede
mantido	mantenuto
nunes	nunes
polónia	polonia
discutir	discutere
liberal	liberale
mérito	merito
rival	rivale
práticas	pratiche
depressão	depressione
moreira	moreira
compra	acquisto
computadores	informatica
computadores	computer
leve	leggero
conceitos	concetti
dark	dark
designada	designata
nintendo	nintendo
artilheiro	artigliere
raimundo	raimondo
representar	rappresentare
rota	rota
rota	rotta
elizabeth	elizabeth
microsoft	microsoft
sun	sun
cristianismo	cristianesimo
aparecer	apparire
aparecer	comparire
desambiguação	disambigua
uefa	uefa
revela	rivela
ruy	ruy
their	their
pensar	pensare
trama	trama
foco	focus
sucessos	successi
molecular	molecolare
dimensões	dimensioni
warner	warner
year	year
estudante	studente
amizade	amicizia
gaúcho	gaucho
amiga	amica
mostrando	mostrando
descendência	discendenza
vantagem	vantaggio
peixes	pesci
goethe	goethe
médicos	medici
sanderson	sanderson
disputar	disputare
modalidade	modo
transição	transizione
terror	terrore
cri	cri
eleitos	eletti
poemas	poesie
baterista	batterista
jimmy	jimmy
religiosas	religiose
bad	bad
net	net
river	river
fundadores	fondatori
clark	clark
conquistar	conquistare
experiências	esperimenti
apresentando	presentando
privada	privata
moeda	valuta
visconde	visconte
interpretado	interpretato
cavaleiros	cavalieri
paranaense	paranaense
crescente	crescente
atitude	atteggiamento
feliz	felice
síria	siria
primavera	primavera
vitor	vitor
popularidade	popolarità
dave	dave
xii	xii
variação	variazione
ribeirão	ribeirão
azevedo	azevedo
realiza	realizza
meus	miei
assistência	assistenza
dúvidas	dubbi
altamente	altamente
book	book
spam	spam
calendário	calendario
origens	origini
esforços	sforzi
contribuição	contributo
decisões	decisioni
baby	baby
charlie	charlie
marvel	marvel
definir	imposta
definir	impostare
ocorrem	avvengono
jogando	giocando
garantir	garantire
equador	ecuador
chance	chance
subsp	subsp
terrestre	terrestre
contemporânea	contemporanea
técnicos	tecnici
page	page
miller	miller
libertadores	liberatori
teorias	teorie
julgamento	giudizio
games	games
sessão	sessione
toronto	toronto
assis	assisi
manoel	manoel
mantendo	mantenendo
columbia	columbia
falando	parlando
heróis	eroi
onze	undici
off	off
estratégia	strategia
aceitar	accettare
britânicos	britannici
campanhas	campagne
modernos	moderni
kong	kong
idéia	idea
eletrônica	elettronica
fortemente	fortemente
light	light
religiosos	religiosi
morrer	morire
grêmio	grêmio
viagens	viaggi
journal	journal
integrante	integrante
magalhães	magellano
subtropicais	subtropicali
virtual	virtuale
neves	neves
agentes	agenti
anualmente	annualmente
associados	associati
pilotos	piloti
geórgia	georgia
impedir	impedire
verificar	verificare
produz	produce
quente	caldo
danos	danni
ampla	ampia
sony	sony
michel	michel
junior	junior
ibge	ibge
matt	matt
freitas	freitas
superman	superman
professora	maestra
comparação	confronto
tupi	tupi
bordo	bordo
nossos	nostri
colegas	colleghi
maurício	maurizio
escudo	scudo
revelado	svelato
revelado	rivelato
bbc	bbc
teologia	teologia
project	project
pinturas	dipinti
howard	howard
explicar	spiegare
herdeiro	erede
system	system
macau	macao
endémica	endemica
iluminação	illuminazione
indicada	indicata
câncer	cancro
foz	foce
abc	abc
declinação	declinazione
menina	ragazza
teriam	avrebbero
relacionado	correlati
apresentador	presentatore
ministros	ministri
sueco	svedese
republicano	repubblicano
ryan	ryan
jaime	jaime
dizem	dicono
recebendo	ricevendo
definida	definita
correspondente	corrispondente
aparente	apparente
more	more
separação	separazione
compostos	composti
aventuras	avventure
cristina	cristina
sofia	sofia
moura	moura
inúmeros	innumerevoli
património	patrimonio
absoluta	assoluta
indiana	indiana
clássicos	classici
ips	ips
adultos	adulti
movie	movie
jane	jane
glória	gloria
ritmo	ritmo
estilos	stili
municipais	comunali
atacar	attaccare
cerimônia	cerimonia
gigante	gigante
vias	vie
habitat	habitat
vírus	virus
ganha	vince
chuva	pioggia
raízes	radici
allen	allen
corporation	corporation
símbolos	simboli
ditadura	dittatura
restante	rimanente
soul	soul
encontrava	trovava
esquerdo	sinistro
transformação	trasformazione
infelizmente	purtroppo
atmosfera	atmosfera
play	play
xadrez	scacchi
africano	africano
tendência	tendenza
andar	camminare
óleo	olio
about	about
nomeação	nomina
amplamente	ampiamente
fred	fred
especialista	specialista
mac	mac
fachada	facciata
talk	talk
science	science
capítulos	capitoli
other	other
filósofo	filosofo
wikimedia	wikimedia
aeronave	aeromobile
familiares	familiari
fale	parli
defende	difende
circulação	circolazione
correia	cinghia
jeff	jeff
sal	sale
xiv	xiv
relevo	rilievo
fonseca	fonseca
piauí	piauí
sétimo	settimo
idh	hdi
psicologia	psicologia
graus	gradi
moçambique	mozambico
polo	polo
autonomia	autonomia
bulgária	bulgaria
laura	laura
operacional	operativa
tóquio	tokyo
constitui	costituisce
faça	faccia
emissoras	emittenti
cerco	assedio
capazes	capaci
ondas	onde
percussão	percussioni
francis	francis
permanece	rimane
iraque	iraq
legenda	didascalia
fenômeno	fenomeno
morro	muoio
road	road
cientistas	scienziati
gato	gatto
bandeirantes	bandeirantes
estatística	statistica
finlândia	finlandia
desconhecido	sconosciuto
supremo	supremo
humor	umore
interface	interfaccia
estabelecimento	stabilimento
produções	produzioni
extinto	estinto
populações	popolazioni
sabia	sapevo
sabia	sapeva
determinar	determinare
great	great
necessidades	bisogni
substituir	sostituisci
substituir	sostituire
filhas	figlie
espera	aspetta
sons	suoni
recurso	risorsa
destruir	distruggere
fronteiras	frontiere
fronteiras	confini
remoção	rimozione
pagar	pagare
tentativas	tentativi
tarefas	compiti
envolve	coinvolge
ensaio	prova
receita	ricetta
sorte	fortuna
escritas	scritte
objectos	oggetti
parar	fermata
parar	stop
quinze	quindici
lixo	spazzatura
tabelas	tabelle
coloca	mette
gregos	greci
pires	pires
cross	cross
escolher	scegliere
datas	date
youtube	youtube
dna	dna
value	value
exerceu	esercitato
australian	australian
casar	sposarsi
contava	contava
contava	raccontava
dor	dolore
colega	collega
duplo	doppio
duplo	doppia
negócio	business
hino	inno
africana	africana
diogo	diogo
convite	invito
corridas	corse
frio	freddo
gravar	registrare
gravar	salva
adicional	addizionale
leonard	leonard
italianos	italiani
mover	sposta
may	may
inauguração	inaugurazione
impossível	impossibile
clientes	clienti
aranha	ragno
anel	anello
hop	hop
constituída	costituita
evolution	evolution
instrumental	strumentale
action	action
have	have
viana	viana
bulbophyllum	bulbophyllum
formal	formale
girls	girls
ocupa	occupa
causar	causare
marte	marte
convidados	invitati
convidados	ospiti
iniciais	iniziali
gosta	gradisce
terminar	termina
criadas	create
batalhas	battaglie
estabelecido	stabilito
beach	beach
cobre	rame
quadros	quadri
enfrentou	affrontato
ida	ida
commons	commons
equilíbrio	equilibrio
espiritual	spirituale
camada	strato
armada	armata
católico	cattolico
relevantes	pertinenti
afiliações	affiliazioni
católicos	cattolici
morre	muori
próximas	prossime
limpeza	pulizia
hip	hip
testamento	testamento
avô	nonno
partículas	particolato
partículas	particelle
traduzido	tradotto
democrata	democratico
indústrias	industrie
fator	fattore
transformar	trasformare
illinois	illinois
envolvidos	coinvolti
mariana	mariana
gordon	gordon
santuário	santuario
cantar	cantare
hard	hard
planejamento	pianificazione
gray	gray
restauração	restauro
fugir	scappare
derrotar	sconfiggere
confusão	confusione
caxias	caxias
now	now
catarinense	catarinense
ligada	collegata
luso	luso
tensão	tensione
causas	cause
mhz	mhz
cordas	stringhe
when	when
assinado	firmato
depende	dipende
lemos	leggiamo
siqueira	siqueira
desafio	sfida
free	free
books	books
aço	acciaio
morais	morali
leon	leon
vencedores	vincitori
concertos	concerti
pontuação	punteggio
pesca	pesca
wild	wild
inclusão	inclusione
memórias	memorie
eliminada	eliminata
pdf	pdf
joana	giovanna
adversário	avversario
margarida	margherita
estátua	statua
fire	fire
recuperar	recuperare
rolling	rolling
ernesto	ernesto
designado	designato
christopher	christopher
ganhando	vincente
jornalismo	giornalismo
mau	cattivo
retorna	restituisce
similares	simili
basicamente	fondamentalmente
recuperação	recupero
celular	cellulare
variações	variazioni
trechos	frammenti
décima	decima
moore	moore
historiadores	storici
lake	lake
edition	edition
estranho	strano
votações	votazioni
html	html
mexicano	messicano
seca	secca
endereço	indirizzo
defendeu	difeso
minhas	mie
milão	milano
sintomas	sintomi
álvaro	álvaro
custos	costi
let	let
perspectiva	prospettiva
maddox	maddox
trio	trio
inspirado	ispirato
composições	composizioni
boys	boys
exercício	esercizio
navegação	navigazione
culturas	colture
citar	citare
manual	manuale
clã	clan
var	var
progresso	progresso
dragão	drago
começam	iniziano
parede	muro
toneladas	tonnellate
combustível	carburante
sic	sic
espero	spero
mecanismo	meccanismo
hitler	hitler
congo	congo
significativa	significativa
norma	norma
europe	europe
conjuntos	insiemi
profundidade	profondità
substituição	sostituzione
nobreza	nobiltà
cão	cane
cadeira	sedia
fight	fight
interpretar	interpretare
over	over
come	mangia
ivan	ivan
françois	françois
old	old
explica	spiega
restos	resti
governos	governi
lesão	lesione
lesão	infortunio
combinação	combinazione
vegetação	vegetazione
hong	hong
monarquia	monarchia
johann	johann
batalhão	battaglione
começando	iniziando
vozes	voci
perseguição	inseguimento
existia	esisteva
veneza	venezia
channel	channel
asas	ali
conselheiro	consigliere
tradições	tradizioni
comunicações	comunicazioni
almirante	ammiraglio
escritora	scrittrice
limitada	limitata
envolvido	coinvolto
caio	gaio
zagueiro	terzino
equação	equazione
identificação	identificazione
alfred	alfred
bolívia	bolivia
mello	mello
ligados	collegati
memorial	memoriale
memorial	commemorativo
varia	varia
vasconcelos	vasconcelos
enviar	invia
enviar	inviare
queen	queen
vinho	vino
carbono	carbonio
virgem	vergine
conto	racconto
borges	borges
aragão	aragona
away	away
mudo	muto
sarah	sarah
ocidentais	occidentali
olimpíadas	olimpiadi
napoleão	napoleone
indígena	indigena
bomba	pompa
japoneses	giapponesi
machine	machine
dezenas	decine
dream	dream
friedrich	friedrich
just	just
subfamília	sottofamiglia
companhias	compagnie
publicadas	pubblicate
escritório	ufficio
mini	mini
magia	magia
alimentação	alimentazione
válido	valido
postal	cartolina
treze	tredici
nicolau	nicola
place	place
administrativo	amministrativo
brancos	bianchi
ingleses	inglesi
segredo	segreto
family	family
decidir	decidere
fuga	fuga
vir	venire
finalidade	scopo
finalidade	finalità
integrado	integrato
rick	rick
ball	ball
land	land
side	side
miami	miami
representado	rappresentato
dragon	dragon
graves	graves
east	east
temperaturas	temperature
moon	moon
exposições	esposizioni
deserto	deserto
bônus	bonus
associada	associata
soma	somma
cem	cento
baviera	baviera
geográfica	geografica
pastor	pastore
aviação	aviazione
comumente	comunemente
candidatura	candidatura
deusa	dea
pobres	poveri
irã	iran
manaus	manaus
literária	letteraria
representam	rappresentano
penso	penso
revelação	rivelazione
patente	brevetto
reconhecida	riconosciuta
causando	causando
filipinas	filippine
reformas	riforme
parcialmente	parzialmente
anne	anne
batman	batman
afluente	affluente
mostram	mostrano
manchester	manchester
acervo	acquis
torneios	tornei
libertação	liberazione
gilberto	gilberto
atribuído	attribuito
atribuído	assegnato
marina	marina
institute	institute
roteirista	sceneggiatore
automaticamente	automaticamente
inspiração	ispirazione
ucrânia	ucraina
uniforme	uniforme
especializada	specializzata
mesorregião	mesoregione
estrangeiro	straniero
condados	contee
type	type
falecido	deceduto
abuso	abuso
andy	andy
constantino	costantino
magazine	magazine
moraes	moraes
marketing	marketing
raul	raul
some	some
variável	variabile
ouvir	ascoltare
perigo	pericolo
brilhante	brillante
bytes	byte
constantemente	costantemente
prorrogação	proroga
aprovado	approvato
cuidado	attenti
baixista	bassista
lutador	combattente
paralelo	parallelo
equipamento	attrezzature
visitantes	visitatori
certamente	certamente
sydney	sydney
incluído	incluso
humanas	umane
age	age
cientista	scienziato
ohio	ohio
victoria	victoria
leia	leggi
deriva	deriva
pró	pro
acompanhado	corredata
acompanhado	accompagnato
saga	saga
jerry	jerry
específicos	specifici
soluções	soluzioni
vapor	vapore
cover	cover
pagamento	pagamento
necessários	necessari
acusado	accusato
cabelo	capelli
tecnologias	tecnologie
companheiros	compagni
brazil	brazil
amaral	amaral
nobel	nobel
conter	contenere
indonésia	indonesia
ruínas	rovine
vencedora	vincitrice
iniciada	iniziata
querer	volere
marechal	maresciallo
aloe	aloe
instalado	installato
territorial	territoriale
coro	coro
aceitou	accettò
devia	doveva
devia	dovrei
primária	primaria
imperatriz	imperatrice
grammy	grammy
neve	neve
publicidade	pubblicità
platina	platino
ducado	ducato
sporting	sporting
retrato	ritratto
olhar	sguardo
olhar	guardare
indicar	indicare
dispositivo	dispositivo
fruto	frutto
presidentes	presidenti
acontecer	accadere
nasce	nasce
iniciar	avvia
player	player
basílica	basilica
coloque	metti
incêndio	incendio
essencialmente	essenzialmente
cidadão	cittadino
vendidos	venduti
sampaio	sampaio
perde	perde
perde	perdi
marcar	segna
caro	costoso
brancas	bianche
raios	raggi
permitem	permettono
permitem	consentono
pablo	pablo
reality	reality
completar	completare
integral	integrale
altar	altare
japan	japan
andrea	andrea
visível	visibile
policiais	poliziotti
mit	mit
jonathan	jonathan
latns	latns
colocando	mettendo
tradicionalmente	tradizionalmente
religiões	religioni
legislatura	legislatura
mencionado	menzionato
pequim	pechino
bispos	vescovi
falha	guasto
gráfico	grafico
iniciado	avviato
paraíso	paradiso
responder	rispondi
responder	rispondere
lisa	lisa
reduzir	ridurre
madonna	madonna
húmidas	umide
colonização	colonizzazione
muçulmanos	musulmani
cirurgia	chirurgia
proporção	proporzione
hamilton	hamilton
exame	esame
lost	lost
sujeito	soggetto
heavy	heavy
fantasia	fantasia
preparação	preparazione
ensaios	prove
then	then
requisitos	requisiti
post	post
ian	ian
querem	vogliono
aplicada	applicata
index	index
gales	galles
soldado	soldato
madalena	maddalena
esperar	aspettare
abordagem	approccio
hit	hit
belga	belga
bell	bell
transferido	trasferito
wagner	wagner
planalto	altopiano
tripulação	equipaggio
identificar	identificare
benjamin	benjamin
nobres	nobili
wayne	wayne
satélites	satelliti
larga	larga
retirado	ritirato
golfo	golfo
civilização	civiltà
baseados	basati
rochas	rocce
alfabeto	alfabeto
afirmando	affermando
vereador	assessore
líquido	liquido
anjos	angeli
jay	jay
podiam	potevano
merece	merita
regente	reggente
soviético	sovietico
substituindo	sostituendo
secundário	secondario
people	people
demo	demo
vivos	vivi
longitude	longitudine
cliente	client
cliente	cliente
cabral	cabral
dispositivos	dispositivi
raramente	raramente
orlando	orlando
descendente	discendente
here	here
potter	potter
adolescente	adolescente
cortes	tagli
montreal	montreal
vera	vera
oliver	oliver
sugere	suggerisce
especialistas	specialisti
geraldo	geraldo
acusações	accuse
partiu	rotto
partiu	partì
den	den
predefinições	preset
british	british
there	there
botânica	botanica
parecem	sembrano
irão	iran
elétrico	elettrico
espiral	spirale
considerável	considerevole
vegas	vegas
transmitido	trasmesso
jardins	giardini
jon	jon
cia	cia
hóquei	hockey
albuquerque	albuquerque
afinal	dopotutto
manifestações	manifestazioni
rosto	viso
entregue	consegnato
experimental	sperimentale
pokémon	pokémon
etapas	tappe
watson	watson
entrega	consegna
classificados	classificati
cavalos	cavalli
ocasiões	occasioni
observar	osservare
atração	attrazione
leo	leo
latitude	latitudine
frei	frate
riqueza	ricchezza
union	union
robin	robin
utilizam	utilizzano
aparições	apparizioni
administrativas	amministrative
rendimento	reddito
only	only
fundos	fondi
adequado	adatto
remover	rimuovere
remover	rimuovi
talento	talento
steven	steven
ross	ross
intensidade	intensità
aprender	imparare
goiânia	goiânia
integrar	integrare
sério	serio
vinha	veniva
angel	angel
eva	eva
exércitos	eserciti
escultura	scultura
áudio	audio
quadrados	quadrati
pesado	pesante
rapper	rapper
shift	shift
construídos	costruiti
pio	pio
amazônia	amazon
condenado	condannato
fechado	chiuso
estatísticas	statistiche
limitado	limitato
repórter	reporter
mental	mentale
laterais	laterali
mesquita	moschea
simultaneamente	simultaneamente
russell	russell
longas	lunghe
bolsa	borsa
literário	letterario
rossi	rossi
financeiro	finanziario
explicação	spiegazione
mostrado	mostrato
infinito	infinito
privado	privato
seminário	seminario
marrocos	marocco
leitor	lettore
harris	harris
penal	penale
fornecer	fornire
luísa	luisa
bancos	banche
espectadores	spettatori
gado	bestiame
thiago	thiago
opcional	opzionale
filtro	filtro
estágio	stage
perry	perry
carneiro	ariete
duquesa	duchessa
row	row
guy	guy
dura	dura
organizar	organizzare
teclados	tastiere
marinho	marino
tornado	tornado
biologia	biologia
conhecimentos	conoscenze
assassinado	assassinato
linux	linux
colunas	colonne
diálogo	dialogo
intelectual	intellettuale
toledo	toledo
nasa	nasa
brito	brito
artur	artù
party	party
verdes	verdi
legend	legend
sofre	soffre
colorado	colorado
compilação	compilazione
pensilvânia	pennsylvania
cooperação	cooperazione
variáveis	variabili
cérebro	cervello
arquidiocese	arcidiocesi
olá	ciao
aliado	alleato
clipe	clip
desenvolve	sviluppa
amante	amante
paciente	paziente
goleada	goleada
benfica	benfica
stanley	stanley
exílio	esilio
químico	chimico
aumenta	aumenta
conexão	connessione
documentação	documentazione
síndrome	sindrome
gene	gene
luciano	luciano
radiação	radiazione
radiação	radiazioni
orientais	orientali
fórum	forum
ultimate	ultimate
precisamente	appunto
une	unisce
anjo	angelo
afro	afro
positivo	positivo
holandês	olandese
legislativo	legislativo
furacão	uragano
federais	federali
jun	jun
nba	nba
compreensão	comprensione
tornam	rendono
carlo	carlo
milton	milton
necessárias	necessarie
eddie	eddie
lula	lula
organismos	organismi
sant	sant
longew	longew
inteiramente	interamente
toma	prende
impostos	tasse
impostos	imposte
fabricação	fabbricazione
never	never
god	god
inferno	inferno
obtido	ottenuto
sugestão	suggerimento
abre	apri
preferência	preferenza
investimentos	investimenti
aprovada	approvata
golden	golden
dario	dario
previsto	previsto
pronto	pronto
oferta	offerta
paisagem	paesaggio
stewart	stewart
onu	onu
comprar	comprare
esquema	schema
forçado	forzato
leitores	lettori
pertencentes	appartenenti
silent	silent
correntes	catene
gerar	generare
nogueira	nogueira
chegam	arrivano
prússia	prussia
sock	sock
wilhelm	wilhelm
cálculo	calcolo
pobre	povero
créditos	crediti
sábado	sabato
donald	donald
barreto	barreto
normandia	normandia
rebeldes	ribelli
subespécie	sottospecie
sócio	socio
disposição	disposizione
explosão	esplosione
atlas	atlas
atlas	atlante
parecer	parere
laranja	arancio
laranja	arancione
iguais	uguali
quarenta	quaranta
organismo	organismo
otto	otto
demonstra	dimostra
investimento	investimento
preços	prezzi
procedimento	procedura
oferecer	offrire
descrever	descrivere
constantes	costanti
mantida	mantenuta
comida	cibo
conduta	condotta
town	town
marcando	segnando
delta	delta
kennedy	kennedy
adição	addizione
figueiredo	figueiredo
sagrado	sacro
amador	dilettante
songs	songs
raiz	radice
für	für
linda	bellissima
concessão	concessione
camponotus	camponotus
braços	braccia
tecido	tessuto
célula	cella
marcus	marcus
substância	sostanza
sétima	settima
filmagens	riprese
empregados	impiegati
asa	ala
associações	associazioni
centenário	centenario
presidencial	presidenziale
sofrer	soffrire
domínios	domini
atinge	raggiunge
aplicado	applicato
segmento	segmento
confirmado	confermato
henri	henri
otomano	ottomano
arts	arts
continuidade	continuità
mapas	mappe
newton	newton
atp	atp
ovos	uova
sigla	acronimo
sigla	sigla
coutinho	coutinho
nativos	nativi
corrupção	corruzione
teorema	teorema
autorização	autorizzazione
praga	praga
monarca	monarca
virgínia	virginia
triângulo	triangolo
embaixador	ambasciatore
blocos	blocchi
acção	azione
porção	porzione
resumo	riassunto
negociações	negoziati
pão	pane
roll	roll
marcação	marcatura
franquia	franchising
viola	viola
vingança	vendetta
divino	divino
niterói	niterói
fernanda	fernanda
gary	gary
acreditava	credeva
continuação	continuazione
massachusetts	massachusetts
reprodução	riproduzione
estudiosos	studiosi
rap	rap
vazio	vuoto
jordan	jordan
century	century
box	box
cair	cadere
unesco	unesco
contribuir	contribuire
orig	orig
coordenação	coordinamento
trânsito	transito
viajou	viaggiato
permissão	permesso
argélia	algeria
prisioneiros	prigionieri
artificial	artificiale
claude	claude
placas	piastre
marc	marc
infante	infante
câmera	fotocamera
atualização	aggiornamento
falou	parlato
desconhecida	sconosciuta
instruções	istruzioni
fantasma	fantasma
interação	interazione
acadêmico	accademico
fria	fredda
generic	generic
horror	orrore
lorena	lorena
points	points
take	take
baiano	baiano
lutou	combattuto
implementação	implementazione
rosário	rosario
austríaco	austriaco
comarca	comarca
lidar	trattare
tratados	trattati
iso	iso
aquisição	acquisizione
xbox	xbox
lawrence	lawrence
antecessor	predecessore
franklin	franklin
gold	gold
faziam	facevano
viúva	vedova
setores	settori
adicionar	aggiungi
contribuiu	contribuito
sky	sky
vigor	vigore
alias	alias
barry	barry
formiga	formica
cauda	coda
leal	leale
esconder	nascondere
esconder	nascondi
ibérica	iberica
intervalo	intervallo
antiguidade	anzianità
sentimentos	sentimenti
dizia	diceva
perfeito	perfetto
interpreta	interpreta
cantores	cantanti
discografia	discografia
pertencia	apparteneva
consideram	considerano
substituída	sostituita
force	force
dentes	denti
executado	eseguito
diana	diana
tocou	toccato
franz	franz
adotado	adottato
morta	morta
congregação	congregazione
circular	circolare
racing	racing
wright	wright
cirílico	cirillico
rogério	ruggero
ética	etica
provincial	provinciale
cura	guarigione
cura	cura
pesquisadores	ricercatori
eleita	eletta
marcados	contrassegnati
alegria	gioia
ocupado	occupato
austin	austin
alexandria	alessandria
palma	palma
bros	bros
roda	ruota
preocupação	preoccupazione
estreito	stretto
chart	chart
conversa	conversazione
deixado	lasciato
freire	freire
ameaçada	minacciata
canta	canta
entrevistas	interviste
morgan	morgan
sacerdote	sacerdote
vender	vendere
code	code
essencial	essenziale
típico	tipico
vidro	vetro
mega	mega
alagoas	alagoas
voluntários	volontari
evidente	evidente
estocolmo	stoccolma
pensa	pensa
conquistando	conquistando
cita	cita
aparelho	apparecchio
earth	earth
necessariamente	necessariamente
carter	carter
variante	variante
menção	menzione
gregório	gregorio
ocupações	occupazioni
genética	genetica
declínio	declino
camadas	strati
rangers	rangers
battle	battle
aquelas	quelle
camargo	camargo
relativa	relativa
esperado	atteso
basquetebol	pallacanestro
entendi	capito
cachoeira	cascata
surpresa	sorpresa
kid	kid
cabe	cabe
herbert	herbert
moedas	monete
moedas	valute
afluentes	affluenti
cantando	cantando
jurídica	giuridica
borgonha	borgogna
radical	radicale
roy	roy
favorável	favorevole
luxemburgo	lussemburgo
abandonar	abbandonare
inteligente	intelligente
beatriz	beatrice
inédita	inedita
futura	futura
pontes	ponti
relógio	orologio
mediterrâneo	mediterraneo
monstro	mostro
macedo	macedo
law	law
jonas	jonas
executar	esegui
dean	dean
armando	armando
phil	phil
pernas	gambe
three	three
fome	fame
seguem	seguono
namorada	fidanzata
acreditam	credono
inscrição	iscrizione
larry	larry
desenvolvidos	sviluppati
diversidade	diversità
pura	pura
introduzido	introdotto
concedido	concesso
arcos	archi
amplo	ampio
veiga	veiga
usp	usp
milhas	miglia
respostas	risposte
ativos	attivi
bernard	bernard
aumentou	aumentato
continuam	continuano
respondeu	rispose
wars	wars
ken	ken
ocupar	occupare
vladimir	vladimir
tráfego	traffico
anglo	anglo
parâmetros	parametri
teles	teles
quilómetros	chilometri
residências	residenze
numerosos	numerosi
lembrar	ricordare
official	official
milho	granturco
agostinho	agostino
intérprete	interprete
encontrei	trovato
getúlio	getúlio
massacre	massacro
romances	romanzi
atlanta	atlanta
bond	bond
afirmação	affermazione
apple	apple
guerreiro	guerriero
fortuna	fortuna
heroísmo	eroismo
janela	finestra
sonic	sonic
industriais	industriali
caracteres	caratteri
days	days
fornece	fornisce
blood	blood
menezes	menezes
captura	cattura
divide	divide
raw	raw
sonhos	sogni
nazista	nazista
adulto	adulto
russos	russi
esboço	schizzo
sound	sound
rodas	ruote
reservas	prenotazioni
substâncias	sostanze
cães	cani
coral	corallo
uai	isu
sente	sente
return	return
isaac	isaac
herança	eredità
compositores	compositori
mauro	mauro
guarani	guarani
abertos	aperti
relato	resoconto
incluía	comprendeva
incluía	includeva
márcio	marzio
inter	inter
fiel	fedele
persa	persiano
observações	osservazioni
dirigir	dirigere
verificação	verifica
bay	bay
resgate	riscatto
capitania	capitaneria
jacob	jacob
indicam	indicano
propôs	proposto
wood	wood
hectares	ettari
representada	rappresentata
redação	redazione
configuração	configurazione
vistos	visti
recorrente	ricorrente
adriano	adriano
rob	rob
tecidos	tessuti
elevação	sollevamento
but	but
recordes	classifiche
futsal	futsal
atingido	raggiunto
dominante	dominante
conversão	conversione
tvi	tvi
consequências	conseguenze
múltiplas	multiple
selvagens	selvatici
selvagens	selvaggi
convocado	convocato
class	class
divididos	divisi
australiano	australiano
empréstimo	prestito
adams	adams
again	again
deixaram	lasciarono
distinção	distinzione
nevada	nevada
álcool	alcol
prince	prince
sobreviventes	sopravvissuti
missa	messa
panamá	panama
seguidores	follower
seguidores	seguaci
tipicamente	tipicamente
crença	credenza
franca	franca
salvo	salvo
lópez	lópez
tailândia	thailandia
aguiar	aguiar
praias	spiagge
apresentados	presentati
literalmente	letteralmente
instalada	installata
processamento	elaborazione
gerou	generò
rangel	rangel
esfera	sfera
vivia	viveva
cabeças	teste
jornalistas	giornalisti
justin	justin
flash	flash
after	after
florença	firenze
precisão	precisione
pesados	pesanti
nomeada	nominata
michigan	michigan
nigéria	nigeria
danny	danny
gen	gen
aplicar	applicare
algoritmo	algoritmo
josh	josh
legião	legione
somos	siamo
dourada	dorata
rey	rey
mortal	mortale
falso	falso
envolvimento	coinvolgimento
coreano	coreano
afeganistão	afghanistan
apresentava	presentava
integra	integra
assassino	assassino
entretenimento	intrattenimento
senhores	signori
garcía	garcía
twitter	twitter
evangelho	vangelo
iguaçu	iguaçu
lincoln	lincoln
mestres	padroni
mestres	maestri
gay	gay
operador	operatore
bits	bit
galiza	galizia
marshall	marshall
reinos	regni
brigada	brigata
under	under
turco	turco
monumentos	monumenti
derivado	derivato
meninas	ragazze
tocando	suonando
tocando	toccando
leopoldo	leopoldo
baseadas	basate
caracteriza	caratterizza
rosaceae	rosaceae
peito	petto
into	into
kansas	kansas
frutos	frutti
formalmente	formalmente
matthew	matthew
selecção	selezione
sicília	sicilia
special	special
barbara	barbara
conseguem	riescono
gov	gov
rebelião	ribellione
cearense	cearense
abu	abu
facilitar	facilitare
adolescentes	adolescenti
gráficos	grafici
gráficos	grafica
arroz	riso
enterro	sepoltura
board	board
she	she
stuttgart	stuttgart
intensa	intensa
sentir	sentire
restaurante	ristorante
centrais	centrali
planetas	pianeti
know	know
iron	iron
únicos	unici
suspensão	sospensione
montagem	montaggio
félix	félix
emergência	emergenza
hélio	elio
construídas	costruite
summer	summer
montenegro	montenegro
sombra	ombra
woman	woman
vaticano	vaticano
botão	pulsante
matos	matos
baker	baker
vda	vda
beta	beta
permitido	consentito
anastácio	anastasio
dinâmica	dinamica
sentimento	sentimento
contagem	conteggio
heinrich	heinrich
dava	dava
compositora	cantautrice
parâmetro	parametro
violino	violino
ligadas	legate
patriarca	patriarca
ambientes	ambienti
cristal	cristallo
granada	granada
extrema	estrema
emprestado	prestato
transforma	trasforma
cristóvão	cristoforo
distintos	distinti
grant	grant
autora	autrice
rendeu	arrese
ocasionalmente	occasionalmente
genebra	ginevra
sementes	sementi
sementes	semi
guanabara	guanabara
parker	parker
repertório	repertorio
separados	separati
avisos	avvisi
avisos	avvertimenti
certificado	certificato
shakespeare	shakespeare
parecia	sembrava
poderosa	potente
voltando	tornando
classificada	classificata
escrevendo	scrivendo
bobby	bobby
ocupada	occupata
cantou	cantato
perguntas	domande
fighter	fighter
funcionar	funzionare
has	has
diagnóstico	diagnosi
estável	stabile
imediato	immediato
entendimento	comprensione
curva	curva
feridos	feriti
edgar	edgar
baltimore	baltimora
superliga	superliga
descobertas	scoperte
ronaldo	ronaldo
participando	partecipando
seco	secco
parques	parchi
harmonia	armonia
aposentado	pensionato
versos	versi
taxas	tasse
dedicar	dedicare
outono	autunno
hamburgo	amburgo
oração	preghiera
numerosas	numerose
fita	nastro
componente	componente
irrelevante	irrilevante
divina	divina
fotografias	fotografie
popularmente	popolarmente
mma	mma
reputação	reputazione
férias	vacanze
físicos	fisici
júpiter	giove
projetado	progettato
vascular	vascolare
isótopo	isotopo
significativo	significativo
emissão	emissione
paquistão	pakistan
joel	joel
suicídio	suicidio
adaptado	adattato
abraços	abbracci
ibn	ibn
lutadores	combattenti
jennifer	jennifer
finanças	finanza
close	close
sergipe	sergipe
pioneiro	pioniere
want	want
bottom	bottom
tennessee	tennessee
diminuição	diminuzione
sugiro	suggerisco
compromisso	impegno
baden	baden
complexidade	complessità
sean	sean
voos	voli
turistas	turisti
propor	proporre
comprou	acquistato
plataformas	piattaforme
reference	reference
brothers	brothers
collection	collection
condessa	contessa
mercados	mercati
cat	cat
tia	zia
américas	americhe
pôde	potuto
houston	houston
dennis	dennis
frases	frasi
prix	prix
foguete	razzo
coordenadas	coordinate
formaram	formarono
stuart	stuart
kate	kate
corre	corri
nápoles	napoli
decidido	deciso
cantão	cantone
nossas	nostre
pessoalmente	personalmente
barroco	barocco
declarado	dichiarato
lusitana	lusitana
uss	uss
apresentadas	presentate
itunes	itunes
manda	manda
christmas	christmas
rivalidade	rivalità
jurídico	giuridico
húngaro	ungherese
ortodoxa	ortodossa
gravidade	gravità
otavio	otavio
pobreza	povertà
aprendizagem	apprendimento
philip	philip
oitava	ottava
anúncio	inserzione
reconstrução	ricostruzione
afirmar	affermare
tocantins	tocantins
servem	servono
servindo	servendo
aproximação	avvicinamento
distribuídos	distribuiti
robô	robot
educacional	educativo
aceito	accetto
pink	pink
benefícios	benefici
janelas	finestre
alterado	alterato
head	head
harvard	harvard
tomando	prendendo
citada	citata
cheio	pieno
ann	ann
orquídea	orchidea
trindade	trinità
telenovelas	telenovele
probabilidade	probabilità
volante	volante
engenheiros	ingegneri
évora	évora
bloquear	blocca
biodiversidade	biodiversità
contraste	contrasto
kiss	kiss
natação	nuoto
cheia	piena
minissérie	miniserie
utilidade	utilità
sessões	sessioni
poderão	potranno
templos	templi
polonês	polacco
oitavo	ottavo
years	years
fair	fair
point	point
passava	passava
knight	knight
vendo	vendo
vinicius	vinicius
trabalhava	lavorava
cooper	cooper
chase	chase
celeste	celeste
levam	portano
bryan	bryan
devemos	dovremmo
devemos	dobbiamo
true	true
modern	modern
walker	walker
sea	sea
clínica	clinica
ossos	ossa
vincent	vincent
ordenado	ordinato
destruído	distrutto
mendonça	mendonça
influenciado	influenzato
english	english
seguiram	seguirono
expressões	espressioni
gonzález	gonzález
protestos	proteste
guerreiros	guerrieri
acabam	finiscono
greg	greg
queiroz	queiroz
mistério	mistero
revolucionário	rivoluzionario
excesso	eccesso
croácia	croazia
variantes	varianti
amy	amy
eficiente	efficiente
hierarquia	gerarchia
demonstrar	dimostrare
premiação	premiazione
abadia	abbazia
walt	walt
complexos	complessi
destacando	evidenziando
caldas	caldas
spencer	spencer
terry	terry
crescer	crescere
mágico	magico
protocolo	protocollo
cristiano	cristiano
animado	animato
lema	motto
stars	stars
clemente	clemente
localizados	situati
localizados	localizzati
son	son
germânico	germanico
order	order
ângulo	angolo
procedimentos	procedure
noção	nozione
típica	tipica
johannes	johannes
destinada	destinata
vivendo	vivendo
beatles	beatles
murray	murray
famosas	famose
gonzaga	gonzaga
fantasy	fantasy
tommy	tommy
metais	metalli
four	four
abandonado	abbandonato
carey	carey
existiam	esistevano
broadway	broadway
dick	dick
africanos	africani
testemunhas	testimoni
guitarras	chitarre
determinação	determinazione
falam	parlano
nicolas	nicolas
fighting	fighting
minerais	minerali
dictionary	dictionary
separado	separato
decoração	decorazione
secret	secret
herschel	herschel
nucleares	nucleari
analisar	analizzare
moléculas	molecole
previsão	previsione
comentou	commentato
tentam	provano
julio	julio
acre	acri
melhoria	miglioramento
oral	orale
carmen	carmen
estimado	stimato
comendador	commendatore
modernas	moderne
resolve	risolve
censura	censura
velhos	vecchi
assembléia	assemblea
movido	spostato
agir	agire
jersey	jersey
pugliesi	pugliesi
hell	hell
chineses	cinesi
supervisor	supervisore
renascimento	rinascita
viviam	vivevano
colonos	coloni
campbell	campbell
cultivo	coltivazione
galo	gallo
namorado	fidanzato
determinados	determinati
reuniões	riunioni
gerações	generazioni
sabendo	sapendo
capitais	capitali
minnesota	minnesota
leme	timone
liberais	liberali
selvagem	selvaggio
transmitida	trasmessa
formatos	formati
aceitação	accettazione
recebem	ricevono
evans	evans
bandeiras	bandiere
túmulo	tomba
leonor	eleonora
causada	causata
acampamento	accampamento
graham	graham
fabaceae	fabaceae
publicar	pubblicare
port	port
pedindo	chiedendo
atribuída	assegnata
imigração	immigrazione
celso	celso
maurice	maurice
roman	roman
aumentando	aumentando
coloração	colorazione
semelhança	somiglianza
expressa	espressa
mars	mars
map	map
proprietários	proprietari
ava	ava
actividades	attività
irlandês	irlandese
combates	combattimenti
enviados	inviati
célebre	celebre
reunir	riunire
sonda	sonda
guatemala	guatemala
kent	kent
terrestres	terrestri
ofensiva	offensiva
mancha	macchia
quartel	caserma
mamíferos	mammiferi
fracasso	fallimento
armazenamento	stoccaggio
got	got
códigos	codici
thompson	thompson
acompanhar	accompagnare
citados	citate
citados	citati
distribuído	distribuito
wolf	wolf
variam	variano
danilo	danilo
ricos	ricchi
tópicos	argomenti
colaboradores	collaboratori
rotação	rotazione
catolicismo	cattolicesimo
perfeitamente	perfettamente
destruída	distrutta
ciclone	ciclone
magno	magno
terrenos	terreni
our	our
mandatos	mandati
júri	giuria
lançamentos	lanci
roque	roque
matérias	materie
dita	detta
palestina	palestina
taiwan	taiwan
sara	sara
aldeias	villaggi
choque	shock
restrições	restrizioni
neil	neil
noronha	noronha
cândido	cândido
regularmente	regolarmente
pesos	pesi
douro	douro
inserção	inserimento
diminuir	diminuire
fischer	fischer
evil	evil
premiado	premiato
igualdade	uguaglianza
rubens	rubens
they	they
run	run
capturado	catturato
reno	reno
oposto	opposto
edit	edit
primário	primario
valley	valley
traduções	traduzioni
neo	neo
defensores	difensori
heitor	ettore
facilidade	facilità
vasta	vasta
mecanismos	meccanismi
acreditar	credere
concluída	completata
eleitores	elettori
august	august
bizantinos	bizantini
qualificação	qualificazione
luke	luke
deep	deep
concluído	completato
robinson	robinson
pátio	cortile
fortificações	fortificazioni
western	western
culpa	colpa
holmes	holmes
zool	zool
kurt	kurt
emancipação	emancipazione
mina	miniera
circunstâncias	circostanze
orange	orange
xxi	xxi
abastecimento	approvvigionamento
residentes	residenti
derrotas	sconfitte
tito	tito
museus	musei
ferido	ferito
dallas	dallas
plástico	plastica
malásia	malesia
card	card
positivas	positive
cartão	carta
violação	stupro
violação	violazione
fort	fort
cargas	carichi
diretores	direttori
susan	susan
sex	sex
alcançando	raggiungendo
cerâmica	ceramica
falsa	falsa
idéias	idee
manifestação	manifestazione
pianista	pianista
postura	postura
melbourne	melbourne
edwards	edwards
prof	prof
melhorias	miglioramenti
exige	richiede
java	java
controlo	controllo
eficiência	efficienza
rebelde	ribelle
proibido	vietato
proibido	proibito
vêm	vengono
voivodia	voivodato
auge	apice
marine	marine
grace	grace
arizona	arizona
charlotte	charlotte
mito	mito
deseja	desidera
uhf	uhf
ênfase	enfasi
usava	usava
usava	indossava
consulta	consultazione
call	call
tornaria	renderebbe
verlag	verlag
dramática	drammatica
filmado	girato
matando	uccidendo
television	television
padres	preti
fique	rimanga
segmentos	segmenti
elias	elias
arábia	arabia
traços	trattini
soberano	sovrano
which	which
judeu	ebreo
bruxelas	bruxelles
bank	bank
divulgar	diffondere
divulgar	divulgare
alimento	alimento
observatório	osservatorio
esboços	schizzi
automóvel	macchina
cana	canna
emma	emma
cinquenta	cinquanta
couto	couto
profundamente	profondamente
estética	estetica
gradualmente	gradualmente
centre	centre
augusta	augusta
multi	multi
repercussão	ripercussione
massas	masse
marta	marta
botanical	botanical
reduzido	ridotto
gospel	gospel
compôs	compose
lorenzo	lorenzo
legais	legali
mineira	mineraria
lúcia	lucia
naturalmente	naturalmente
gustav	gustav
horta	orto
amostra	campione
cbs	cbs
vegetal	vegetale
estabelecimentos	stabilimenti
correr	correre
georges	georges
empregado	impiegato
reduzida	ridotta
keith	keith
funk	funk
entrando	entrando
ronald	ronald
estabilidade	stabilità
guitar	guitar
escultor	scultore
horizontal	orizzontale
magic	magic
sensação	sensazione
convidada	invitata
permanecendo	rimanendo
poetas	poeti
efetivamente	efficacemente
ludwig	ludwig
samurai	samurai
sertão	sertão
ron	ron
espectro	spettro
anunciada	annunciata
fósseis	fossili
catalunha	catalogna
puro	puro
lloyd	lloyd
currículo	curriculum
visuais	visivi
warren	warren
conquistado	conquistato
between	between
barras	barre
dispõe	dispone
slam	slam
mudando	cambiando
arsenal	arsenale
arsenal	arsenal
mirim	mirim
turcos	turchi
colina	collina
farol	proiettore
parou	smesso
bombas	pompe
nascidos	nati
visa	visa
equipas	squadre
escocês	scozzese
acusação	accusa
productions	productions
adequada	adeguata
misericórdia	misericordia
mínimos	minimi
válidos	validi
assumindo	assumendo
guiana	guyana
make	make
esquadrão	squadrone
piratas	pirati
kids	kids
corredor	corridoio
kingdom	kingdom
sandra	sandra
profundo	profondo
ideologia	ideologia
arnold	arnold
implica	implica
gerente	manager
urss	urss
reconhecer	riconoscere
atrações	attrazioni
prazer	piacere
avisado	avvertito
rené	rené
assinar	firmare
intelectuais	intellettuali
caridade	carità
integrada	integrata
goals	goals
carvão	carbone
pistas	piste
noites	notti
departamentos	dipartimenti
view	view
barcos	barche
arredores	dintorni
malta	malta
raymond	raymond
vinda	venuta
hunter	hunter
iniciando	avvio
forest	forest
consideração	considerazione
episcopal	episcopale
premier	premier
determinadas	determinate
her	her
anéis	anelli
humberto	humberto
átomos	atomi
ernst	ernst
vanessa	vanessa
comunistas	comunisti
transmitir	trasmettere
joan	joan
absurdo	assurdo
frankfurt	francoforte
lara	lara
inovação	innovazione
nbc	nbc
montana	montana
felicidade	felicità
suficientes	sufficienti
triunfo	trionfo
telescópio	telescopio
tenista	tennista
norman	norman
tronco	tronco
caverna	grotta
promessa	promessa
historicamente	storicamente
liverpool	liverpool
alternativas	alternative
dourado	dorato
harold	harold
chamava	chiamava
comparado	comparato
afirmam	affermano
terão	avranno
propõe	propone
transformado	trasformato
abertas	aperte
resultante	risultante
portos	porti
fixa	fissa
women	women
adversários	avversari
minuto	minuto
reitor	rettore
edge	edge
contemporâneo	contemporaneo
noiva	sposa
emi	emi
associadas	associate
spin	spin
proximidade	vicinanza
language	language
inserir	inserisci
insiste	insiste
car	car
wii	wii
sabem	sapete
sabem	sanno
its	its
funcionário	funzionario
percepção	percezione
ganho	guadagno
loire	loira
frequentes	comune
compõem	compongono
corrêa	corrêa
phoenix	phoenix
enviada	inviata
muralha	muraglia
linguagens	linguaggi
mercedes	mercedes
machos	maschi
difíceis	difficili
sargento	sergente
indicando	indicando
rachel	rachel
renovação	rinnovo
exclusivo	esclusiva
exclusivo	esclusivo
geometria	geometria
crônica	cronaca
telecomunicações	telecomunicazioni
eficaz	efficace
sweet	sweet
hopkins	hopkins
prestígio	prestigio
governadores	governatori
coletivo	collettivo
centímetros	centimetri
leipzig	lipsia
say	say
secundárias	secondarie
fenômenos	fenomeni
enterrado	sepolto
líbia	libia
issn	issn
confrontos	scontri
